"Record Date","Agency Bureau Indicator","Agency Name","Bureau Name","Total Eligible Debt Amount","Total Eligible Debt Count","Eligible Debt Referred Amount","Eligible Debt Referred Count","Eligible Debt Not Referred Amount","Eligible Debt Not Referred Count","Compliance Rate Amount","Compliance Rate Count","CFO Agency Indicator","Fiscal Year","Fiscal Quarter Number","Calendar Year","Calendar Quarter Number","Calendar Month Number","Calendar Day Number"
"2024-06-30","Agency","Agency for International Development","null","28276178","55","28275905","54","273","1","99.99903452298256","98.18181818181819","CFO","2024","3","2024","2","06","30"
"2024-06-30","Bureau","Agency for International Development","Agency for International Development","28276178","55","28275905","54","273","1","99.99903452298256","98.18181818181819","null","2024","3","2024","2","06","30"
"2024-06-30","Agency","American Battle Monuments Commission","null","0","0","0","0","0","0","0.0","0.0","Non-CFO","2024","3","2024","2","06","30"
"2024-06-30","Bureau","American Battle Monuments Commission","American Battle Monuments Commission","0","0","0","0","0","0","0.0","0.0","null","2024","3","2024","2","06","30"
"2024-06-30","Agency","Armed Forces Retirement Home","null","108119","91","108119","91","0","0","100.0","100.0","Non-CFO","2024","3","2024","2","06","30"
"2024-06-30","Bureau","Armed Forces Retirement Home","Armed Forces Retirement Home","108119","91","108119","91","0","0","100.0","100.0","null","2024","3","2024","2","06","30"
"2024-06-30","Agency","Commodity Futures Trading Commission","null","633205219","359","633205219","359","0","0","100.0","100.0","Non-CFO","2024","3","2024","2","06","30"
"2024-06-30","Bureau","Commodity Futures Trading Commission","Commodity Futures Trading Commission","633205219","359","633205219","359","0","0","100.0","100.0","null","2024","3","2024","2","06","30"
"2024-06-30","Agency","Consumer Product Safety Commission","null","425","2","425","2","0","0","100.0","100.0","Non-CFO","2024","3","2024","2","06","30"
"2024-06-30","Bureau","Consumer Product Safety Commission","Consumer Product Safety Commission","425","2","425","2","0","0","100.0","100.0","null","2024","3","2024","2","06","30"
"2024-06-30","Agency","Corp. for National and Community Service","null","3744232","311","3601320","148","142912","163","96.18314249758028","47.58842443729903","Non-CFO","2024","3","2024","2","06","30"
"2024-06-30","Bureau","Corp. for National and Community Service","Corp. for National and Community Service","3744232","311","3601320","148","142912","163","96.18314249758028","47.58842443729903","null","2024","3","2024","2","06","30"
"2024-06-30","Agency","Department of Agriculture","null","1146699505","47737","1136329278","43787","10370227","3950","99.09564563734594","91.72549594654042","CFO","2024","3","2024","2","06","30"
"2024-06-30","Bureau","Department of Agriculture","Agricultural Marketing Service","4646862","2017","3861474","1163","785388","854","83.09852971747385","57.659890927119484","null","2024","3","2024","2","06","30"
"2024-06-30","Bureau","Department of Agriculture","Commodity Credit Corporation","144444067","8621","140350932","8290","4093135","331","97.16628374912762","96.16053822062406","null","2024","3","2024","2","06","30"
"2024-06-30","Bureau","Department of Agriculture","Farm Service Agency","76678658","2191","76675080","1648","3578","543","99.99533377331669","75.21679598356914","null","2024","3","2024","2","06","30"
"2024-06-30","Bureau","Department of Agriculture","Federal Crop Insurance Corporation","13798","2","13798","2","0","0","100.0","100.0","null","2024","3","2024","2","06","30"
"2024-06-30","Bureau","Department of Agriculture","Food Safety and Inspection Service","1658267","2389","1564843","2334","93424","55","94.36616660646325","97.69778149853495","null","2024","3","2024","2","06","30"
"2024-06-30","Bureau","Department of Agriculture","Food and Nutrition Service","45871","19","38429","15","7442","4","83.77624207015326","78.94736842105263","null","2024","3","2024","2","06","30"
"2024-06-30","Bureau","Department of Agriculture","Forest Service","74117698","879","72278695","422","1839003","457","97.51880718151824","48.009101251422074","null","2024","3","2024","2","06","30"
"2024-06-30","Bureau","Department of Agriculture","Rural Development","820594143","27522","820587188","27517","6955","5","99.99915244337785","99.98183271564567","null","2024","3","2024","2","06","30"
"2024-06-30","Bureau","Department of Agriculture","U.S. Department of Agriculture","24500141","4097","20958839","2396","3541302","1701","85.54578930790643","58.48181596289968","null","2024","3","2024","2","06","30"
"2024-06-30","Agency","Department of Commerce","null","58831267","7126","58831267","7126","0","0","100.0","100.0","CFO","2024","3","2024","2","06","30"
"2024-06-30","Bureau","Department of Commerce","Bureau of Industry and Security","37545771","27","37545771","27","0","0","100.0","100.0","null","2024","3","2024","2","06","30"
"2024-06-30","Bureau","Department of Commerce","Bureau of the Census","1789388","5524","1789388","5524","0","0","100.0","100.0","null","2024","3","2024","2","06","30"
"2024-06-30","Bureau","Department of Commerce","Economic Development Administration","5120584","11","5120584","11","0","0","100.0","100.0","null","2024","3","2024","2","06","30"
"2024-06-30","Bureau","Department of Commerce","Economic and Statistical Analysis","0","0","0","0","0","0","0.0","0.0","null","2024","3","2024","2","06","30"
"2024-06-30","Bureau","Department of Commerce","General Administration","0","0","0","0","0","0","0.0","0.0","null","2024","3","2024","2","06","30"
"2024-06-30","Bureau","Department of Commerce","International Trade Administration","0","0","0","0","0","0","0.0","0.0","null","2024","3","2024","2","06","30"
"2024-06-30","Bureau","Department of Commerce","Minority Business Development Agency","0","0","0","0","0","0","0.0","0.0","null","2024","3","2024","2","06","30"
"2024-06-30","Bureau","Department of Commerce","NOAA","12517698","814","12517698","814","0","0","100.0","100.0","null","2024","3","2024","2","06","30"
"2024-06-30","Bureau","Department of Commerce","Nat'l Institute of Standards& Technology","992798","6","992798","6","0","0","100.0","100.0","null","2024","3","2024","2","06","30"
"2024-06-30","Bureau","Department of Commerce","Nat'l Telecomm & Information Admin.","296093","1","296093","1","0","0","100.0","100.0","null","2024","3","2024","2","06","30"
"2024-06-30","Bureau","Department of Commerce","National Technical Information Service","0","0","0","0","0","0","0.0","0.0","null","2024","3","2024","2","06","30"
"2024-06-30","Bureau","Department of Commerce","Office of the Inspector General","0","0","0","0","0","0","0.0","0.0","null","2024","3","2024","2","06","30"
"2024-06-30","Bureau","Department of Commerce","Patent and Trademark Office","568935","743","568935","743","0","0","100.0","100.0","null","2024","3","2024","2","06","30"
"2024-06-30","Agency","Department of Defense","null","2970422073","1433098","1070532525","288509","1899889548","1144589","36.03974447708058","20.131840250980744","CFO","2024","3","2024","2","06","30"
"2024-06-30","Bureau","Department of Defense","Consolidated Report","2970422073","1433098","1070532525","288509","1899889548","1144589","36.03974447708058","20.131840250980744","null","2024","3","2024","2","06","30"
"2024-06-30","Agency","Department of Education","null","114061515988","19127439","110714244793","18490664","3347271195","636775","97.06538075878971","96.6708820767903","CFO","2024","3","2024","2","06","30"
"2024-06-30","Bureau","Department of Education","Departmental Management","1217370438","2084","1213788431","2010","3582007","74","99.70575866735479","96.44913627639156","null","2024","3","2024","2","06","30"
"2024-06-30","Bureau","Department of Education","Federal Student Aid","112844145550","19125355","109500456362","18488654","3343689188","636701","97.03689617950234","96.67090623938745","null","2024","3","2024","2","06","30"
"2024-06-30","Bureau","Department of Education","Office of Postsecondary Education","0","0","0","0","0","0","0.0","0.0","null","2024","3","2024","2","06","30"
"2024-06-30","Agency","Department of Energy","null","13731228","99","13731228","99","0","0","100.0","100.0","CFO","2024","3","2024","2","06","30"
"2024-06-30","Bureau","Department of Energy","Bonneville Power Administration","1058471","28","1058471","28","0","0","100.0","100.0","null","2024","3","2024","2","06","30"
"2024-06-30","Bureau","Department of Energy","Energy Consolidated Reports","12672757","71","12672757","71","0","0","100.0","100.0","null","2024","3","2024","2","06","30"
"2024-06-30","Agency","Department of Health & Human Services","null","5180808770","1042206","4900440880","1012624","280367890","29582","94.58833741126485","97.16159761122081","CFO","2024","3","2024","2","06","30"
"2024-06-30","Bureau","Department of Health & Human Services","Administration for Children and Families","38911023","1779","38911023","1779","0","0","100.0","100.0","null","2024","3","2024","2","06","30"
"2024-06-30","Bureau","Department of Health & Human Services","Administration for Community Living","0","0","0","0","0","0","0.0","0.0","null","2024","3","2024","2","06","30"
"2024-06-30","Bureau","Department of Health & Human Services","Agency for Healthcare Research & Quality","0","0","0","0","0","0","0.0","0.0","null","2024","3","2024","2","06","30"
"2024-06-30","Bureau","Department of Health & Human Services","Centers for Disease Control","5310903","115","975244","17","4335659","98","18.363054267795892","14.782608695652174","null","2024","3","2024","2","06","30"
"2024-06-30","Bureau","Department of Health & Human Services","Centers for Medicare & Medicaid Services","4395687419","1006352","4298850921","997144","96836498","9208","97.79701128015991","99.08501200375217","null","2024","3","2024","2","06","30"
"2024-06-30","Bureau","Department of Health & Human Services","Food and Drug Administration","229557710","21949","71113530","2063","158444180","19886","30.978497738106903","9.3990614606588","null","2024","3","2024","2","06","30"
"2024-06-30","Bureau","Department of Health & Human Services","Health Resources and Services Admin","137731660","706","137731660","706","0","0","100.0","100.0","null","2024","3","2024","2","06","30"
"2024-06-30","Bureau","Department of Health & Human Services","Indian Health Services","101086798","4363","101086797","4363","1","0","99.99999901075114","100.0","null","2024","3","2024","2","06","30"
"2024-06-30","Bureau","Department of Health & Human Services","National Institutes of Health","28388751","518","7637199","128","20751552","390","26.90220150932318","24.71042471042471","null","2024","3","2024","2","06","30"
"2024-06-30","Bureau","Department of Health & Human Services","Office of the Inspector General","33600","1","33600","1","0","0","100.0","100.0","null","2024","3","2024","2","06","30"
"2024-06-30","Bureau","Department of Health & Human Services","Office of the Secretary","236352516","6167","236352516","6167","0","0","100.0","100.0","null","2024","3","2024","2","06","30"
"2024-06-30","Bureau","Department of Health & Human Services","Program Support Center","6638393","246","6638393","246","0","0","100.0","100.0","null","2024","3","2024","2","06","30"
"2024-06-30","Bureau","Department of Health & Human Services","Substance Abuse & Mental Health Admin.","1109997","10","1109997","10","0","0","100.0","100.0","null","2024","3","2024","2","06","30"
"2024-06-30","Agency","Department of Homeland Security","null","303327503","154956","275075651","79292","28251852","75664","90.6860236145484","51.17065489558326","CFO","2024","3","2024","2","06","30"
"2024-06-30","Bureau","Department of Homeland Security","Bureau of Customs & Border Protection","9499670","1010","9499670","1010","0","0","100.0","100.0","null","2024","3","2024","2","06","30"
"2024-06-30","Bureau","Department of Homeland Security","Citizenship and Immigration Services","1279189","1603","1279189","1603","0","0","100.0","100.0","null","2024","3","2024","2","06","30"
"2024-06-30","Bureau","Department of Homeland Security","Domestic Nuclear Detection Office","2272","24","0","0","2272","24","0.0","0.0","null","2024","3","2024","2","06","30"
"2024-06-30","Bureau","Department of Homeland Security","Emergency Preparedness & Resp","200177084","41962","200177084","41962","0","0","100.0","100.0","null","2024","3","2024","2","06","30"
"2024-06-30","Bureau","Department of Homeland Security","Federal Law Enforcement Training Ctr.","8562","1","8562","1","0","0","100.0","100.0","null","2024","3","2024","2","06","30"
"2024-06-30","Bureau","Department of Homeland Security","Immigration and Customs Enforcement","18547458","690","18547458","690","0","0","100.0","100.0","null","2024","3","2024","2","06","30"
"2024-06-30","Bureau","Department of Homeland Security","Info Analysis Infrastructure Prot-NPPD","0","0","0","0","0","0","0.0","0.0","null","2024","3","2024","2","06","30"
"2024-06-30","Bureau","Department of Homeland Security","Management Headquarters","0","0","0","0","0","0","0.0","0.0","null","2024","3","2024","2","06","30"
"2024-06-30","Bureau","Department of Homeland Security","Office of Biometric Identity Management","0","0","0","0","0","0","0.0","0.0","null","2024","3","2024","2","06","30"
"2024-06-30","Bureau","Department of Homeland Security","Office of the Inspector General DHS","100","1","100","1","0","0","100.0","100.0","null","2024","3","2024","2","06","30"
"2024-06-30","Bureau","Department of Homeland Security","Science and Technology","0","0","0","0","0","0","0.0","0.0","null","2024","3","2024","2","06","30"
"2024-06-30","Bureau","Department of Homeland Security","Transportation Safety Administration","44709558","32717","44709558","32717","0","0","100.0","100.0","null","2024","3","2024","2","06","30"
"2024-06-30","Bureau","Department of Homeland Security","U.S. Coast Guard","29103610","76948","854030","1308","28249580","75640","2.9344469637959003","1.6998492488433747","null","2024","3","2024","2","06","30"
"2024-06-30","Bureau","Department of Homeland Security","U.S. Secret Service","0","0","0","0","0","0","0.0","0.0","null","2024","3","2024","2","06","30"
"2024-06-30","Agency","Department of Housing and Urban Development","null","93028537","3956","92688488","3945","340049","11","99.63446807725246","99.72194135490395","CFO","2024","3","2024","2","06","30"
"2024-06-30","Bureau","Department of Housing and Urban Development","Community Planning and Development","102184","1","102184","1","0","0","100.0","100.0","null","2024","3","2024","2","06","30"
"2024-06-30","Bureau","Department of Housing and Urban Development","Government National Mortgage Association","221266","7","0","0","221266","7","0.0","0.0","null","2024","3","2024","2","06","30"
"2024-06-30","Bureau","Department of Housing and Urban Development","Housing Programs","91144384","3881","91025601","3877","118783","4","99.86967600768469","99.89693377995361","null","2024","3","2024","2","06","30"
"2024-06-30","Bureau","Department of Housing and Urban Development","Management and Administration","59759","59","59759","59","0","0","100.0","100.0","null","2024","3","2024","2","06","30"
"2024-06-30","Bureau","Department of Housing and Urban Development","Policy, Development and Research","0","0","0","0","0","0","0.0","0.0","null","2024","3","2024","2","06","30"
"2024-06-30","Bureau","Department of Housing and Urban Development","Public and Indian Housing Programs","1500944","8","1500944","8","0","0","100.0","100.0","null","2024","3","2024","2","06","30"
"2024-06-30","Agency","Department of Justice","null","94058786","39990","91498988","39484","2559798","506","97.27851261018827","98.73468367091773","CFO","2024","3","2024","2","06","30"
"2024-06-30","Bureau","Department of Justice","Bureau of ATF and Explosives","19881","1","19881","1","0","0","100.0","100.0","null","2024","3","2024","2","06","30"
"2024-06-30","Bureau","Department of Justice","Drug Enforcement Administration","339485","15","339485","15","0","0","100.0","100.0","null","2024","3","2024","2","06","30"
"2024-06-30","Bureau","Department of Justice","Federal Bureau of Investigation","488813","114","488813","114","0","0","100.0","100.0","null","2024","3","2024","2","06","30"
"2024-06-30","Bureau","Department of Justice","Federal Prison Industries","758742","175","0","0","758742","175","0.0","0.0","null","2024","3","2024","2","06","30"
"2024-06-30","Bureau","Department of Justice","Federal Prison System","0","0","0","0","0","0","0.0","0.0","null","2024","3","2024","2","06","30"
"2024-06-30","Bureau","Department of Justice","General Administration","0","0","0","0","0","0","0.0","0.0","null","2024","3","2024","2","06","30"
"2024-06-30","Bureau","Department of Justice","Legal Activities","92024897","39676","90231893","39351","1793004","325","98.05160988118249","99.18086500655308","null","2024","3","2024","2","06","30"
"2024-06-30","Bureau","Department of Justice","Office of Justice Assistance Programs","418916","3","418916","3","0","0","100.0","100.0","null","2024","3","2024","2","06","30"
"2024-06-30","Bureau","Department of Justice","U.S. Marshals Service","8052","6","0","0","8052","6","0.0","0.0","null","2024","3","2024","2","06","30"
"2024-06-30","Agency","Department of Labor","null","185111675","15193","166697313","11786","18414362","3407","90.05229572905112","77.57519910485092","CFO","2024","3","2024","2","06","30"
"2024-06-30","Bureau","Department of Labor","Bureau of Labor Statistics","4743","1","4743","1","0","0","100.0","100.0","null","2024","3","2024","2","06","30"
"2024-06-30","Bureau","Department of Labor","Departmental Management","206517","1729","0","0","206517","1729","0.0","0.0","null","2024","3","2024","2","06","30"
"2024-06-30","Bureau","Department of Labor","Employee Benefit Security Administration","22166455","478","22166455","478","0","0","100.0","100.0","null","2024","3","2024","2","06","30"
"2024-06-30","Bureau","Department of Labor","Employment Standards Administration","79315111","3805","68266551","3145","11048560","660","86.070044080251","82.65440210249672","null","2024","3","2024","2","06","30"
"2024-06-30","Bureau","Department of Labor","Employment and Training Administration","1226363","12","1226363","12","0","0","100.0","100.0","null","2024","3","2024","2","06","30"
"2024-06-30","Bureau","Department of Labor","Mine Safety and Health Administration","11969761","4623","10343304","4329","1626457","294","86.41195091531067","93.6404931862427","null","2024","3","2024","2","06","30"
"2024-06-30","Bureau","Department of Labor","Occupational Safety and Health Admin","70222725","4545","64689897","3821","5532828","724","92.12102919674507","84.07040704070407","null","2024","3","2024","2","06","30"
"2024-06-30","Agency","Department of State","null","22679388","20287","22596657","20248","82731","39","99.63521502432076","99.80775866318332","CFO","2024","3","2024","2","06","30"
"2024-06-30","Bureau","Department of State","Department of State","21030183","9711","20947452","9672","82731","39","99.60660827345154","99.59839357429719","null","2024","3","2024","2","06","30"
"2024-06-30","Bureau","Department of State","International Commissions","0","0","0","0","0","0","0.0","0.0","null","2024","3","2024","2","06","30"
"2024-06-30","Bureau","Department of State","Passport NSF","1649205","10576","1649205","10576","0","0","100.0","100.0","null","2024","3","2024","2","06","30"
"2024-06-30","Agency","Department of Transportation","null","91555362","9889","91547876","9888","7486","1","99.99182352640362","99.98988775407018","CFO","2024","3","2024","2","06","30"
"2024-06-30","Bureau","Department of Transportation","Federal Aviation Administration","4576202","519","4576202","519","0","0","100.0","100.0","null","2024","3","2024","2","06","30"
"2024-06-30","Bureau","Department of Transportation","Federal Highway Administration","9229","8","9229","8","0","0","100.0","100.0","null","2024","3","2024","2","06","30"
"2024-06-30","Bureau","Department of Transportation","Federal Motor Carrier Safety Admin","83307159","9207","83299673","9206","7486","1","99.99101397756225","99.98913869881612","null","2024","3","2024","2","06","30"
"2024-06-30","Bureau","Department of Transportation","Federal Railroad Administration","145009","11","145009","11","0","0","100.0","100.0","null","2024","3","2024","2","06","30"
"2024-06-30","Bureau","Department of Transportation","Federal Transit Administration","786477","2","786477","2","0","0","100.0","100.0","null","2024","3","2024","2","06","30"
"2024-06-30","Bureau","Department of Transportation","Maritime Administration","301146","17","301146","17","0","0","100.0","100.0","null","2024","3","2024","2","06","30"
"2024-06-30","Bureau","Department of Transportation","National Highway Traffic Safety Admin.","31918","7","31918","7","0","0","100.0","100.0","null","2024","3","2024","2","06","30"
"2024-06-30","Bureau","Department of Transportation","Office of the Inspector General","0","0","0","0","0","0","0.0","0.0","null","2024","3","2024","2","06","30"
"2024-06-30","Bureau","Department of Transportation","Office of the Secretary","1127150","14","1127150","14","0","0","100.0","100.0","null","2024","3","2024","2","06","30"
"2024-06-30","Bureau","Department of Transportation","Pipeline Hazardous Material Safety Admin","1264142","98","1264142","98","0","0","100.0","100.0","null","2024","3","2024","2","06","30"
"2024-06-30","Bureau","Department of Transportation","Research Innovative Technology Admin","2582","4","2582","4","0","0","100.0","100.0","null","2024","3","2024","2","06","30"
"2024-06-30","Bureau","Department of Transportation","St. Lawrence Seaway Development Corp.","4348","2","4348","2","0","0","100.0","100.0","null","2024","3","2024","2","06","30"
"2024-06-30","Agency","Department of Veterans Affairs","null","536284694","17124897","529466500","17120097","6818194","4800","98.72862416617842","99.97197063433433","CFO","2024","3","2024","2","06","30"
"2024-06-30","Bureau","Department of Veterans Affairs","Administration and Cemeteries","4962461","835","762834","312","4199627","523","15.372090581669054","37.365269461077844","null","2024","3","2024","2","06","30"
"2024-06-30","Bureau","Department of Veterans Affairs","Housing Credit Assistance","438768","7","30101","2","408667","5","6.860345330561937","28.571428571428573","null","2024","3","2024","2","06","30"
"2024-06-30","Bureau","Department of Veterans Affairs","Life Insurance","1266595","264","1266595","264","0","0","100.0","100.0","null","2024","3","2024","2","06","30"
"2024-06-30","Bureau","Department of Veterans Affairs","Medical and Construction","528386278","17122155","527406970","17119519","979308","2636","99.814660591924","99.98460474163446","null","2024","3","2024","2","06","30"
"2024-06-30","Bureau","Department of Veterans Affairs","Veterans Benefits","1230592","1636","0","0","1230592","1636","0.0","0.0","null","2024","3","2024","2","06","30"
"2024-06-30","Agency","Department of the Interior","null","76705282","30776","76699095","30700","6187","76","99.9919340626373","99.75305432804782","CFO","2024","3","2024","2","06","30"
"2024-06-30","Bureau","Department of the Interior","Bureau of Indian Affairs","20227742","26698","20221555","26622","6187","76","99.96941329388125","99.71533448198367","null","2024","3","2024","2","06","30"
"2024-06-30","Bureau","Department of the Interior","Bureau of Land Management","8891486","286","8891486","286","0","0","100.0","100.0","null","2024","3","2024","2","06","30"
"2024-06-30","Bureau","Department of the Interior","Bureau of Ocean Energy Mgmt., Reg & Enf","933","1","933","1","0","0","100.0","100.0","null","2024","3","2024","2","06","30"
"2024-06-30","Bureau","Department of the Interior","Bureau of Reclamation","7424984","72","7424984","72","0","0","100.0","100.0","null","2024","3","2024","2","06","30"
"2024-06-30","Bureau","Department of the Interior","Bureau of Safety and Environmental Enf.","13718","2","13718","2","0","0","100.0","100.0","null","2024","3","2024","2","06","30"
"2024-06-30","Bureau","Department of the Interior","Fish and Wildlife Service","864974","142","864974","142","0","0","100.0","100.0","null","2024","3","2024","2","06","30"
"2024-06-30","Bureau","Department of the Interior","Geological Survey","154550","563","154550","563","0","0","100.0","100.0","null","2024","3","2024","2","06","30"
"2024-06-30","Bureau","Department of the Interior","National Park Service","8854736","2057","8854736","2057","0","0","100.0","100.0","null","2024","3","2024","2","06","30"
"2024-06-30","Bureau","Department of the Interior","Office of Natural Resources Revenue","18448088","488","18448088","488","0","0","100.0","100.0","null","2024","3","2024","2","06","30"
"2024-06-30","Bureau","Department of the Interior","Office of Surface Mining","11820135","458","11820135","458","0","0","100.0","100.0","null","2024","3","2024","2","06","30"
"2024-06-30","Bureau","Department of the Interior","Office of the Secretary","3936","9","3936","9","0","0","100.0","100.0","null","2024","3","2024","2","06","30"
"2024-06-30","Agency","Department of the Treasury","null","44786881","4515","44619416","4506","167465","9","99.62608470100876","99.80066445182725","CFO","2024","3","2024","2","06","30"
"2024-06-30","Bureau","Department of the Treasury","Bureau of Engraving and Printing","38345","2","38345","2","0","0","100.0","100.0","null","2024","3","2024","2","06","30"
"2024-06-30","Bureau","Department of the Treasury","Bureau of the Fiscal Service","13852414","3067","13852414","3067","0","0","100.0","100.0","null","2024","3","2024","2","06","30"
"2024-06-30","Bureau","Department of the Treasury","Community Dev Financial Inst Fund","3617920","7","3617920","7","0","0","100.0","100.0","null","2024","3","2024","2","06","30"
"2024-06-30","Bureau","Department of the Treasury","Comptroller of the Currency","1201121","27","1199696","23","1425","4","99.88136082875913","85.18518518518519","null","2024","3","2024","2","06","30"
"2024-06-30","Bureau","Department of the Treasury","D.C. Pension Program","864124","16","864124","16","0","0","100.0","100.0","null","2024","3","2024","2","06","30"
"2024-06-30","Bureau","Department of the Treasury","Departmental Offices","20878456","1322","20858451","1321","20005","1","99.90418352774745","99.92435703479576","null","2024","3","2024","2","06","30"
"2024-06-30","Bureau","Department of the Treasury","Financial Crimes Enforcement Network","1544945","3","1544945","3","0","0","100.0","100.0","null","2024","3","2024","2","06","30"
"2024-06-30","Bureau","Department of the Treasury","Interest on Tax/Deposit of Earnings","0","0","0","0","0","0","0.0","0.0","null","2024","3","2024","2","06","30"
"2024-06-30","Bureau","Department of the Treasury","Internal Revenue Service","105781","40","105781","40","0","0","100.0","100.0","null","2024","3","2024","2","06","30"
"2024-06-30","Bureau","Department of the Treasury","International Monetary Funds","0","0","0","0","0","0","0.0","0.0","null","2024","3","2024","2","06","30"
"2024-06-30","Bureau","Department of the Treasury","Office of Financial Research","268","1","268","1","0","0","100.0","100.0","null","2024","3","2024","2","06","30"
"2024-06-30","Bureau","Department of the Treasury","Office of Sec International Affairs","0","0","0","0","0","0","0.0","0.0","null","2024","3","2024","2","06","30"
"2024-06-30","Bureau","Department of the Treasury","Office of the Secretary","0","0","0","0","0","0","0.0","0.0","null","2024","3","2024","2","06","30"
"2024-06-30","Bureau","Department of the Treasury","Pandemic Receivables","2514281","5","2514281","5","0","0","100.0","100.0","null","2024","3","2024","2","06","30"
"2024-06-30","Bureau","Department of the Treasury","Spec Insp Gen-Troubled Asset Rel Prog","0","0","0","0","0","0","0.0","0.0","null","2024","3","2024","2","06","30"
"2024-06-30","Bureau","Department of the Treasury","Tobacco Tax and Trade","1000","1","1000","1","0","0","100.0","100.0","null","2024","3","2024","2","06","30"
"2024-06-30","Bureau","Department of the Treasury","Treasury Forfeiture Fund","0","0","0","0","0","0","0.0","0.0","null","2024","3","2024","2","06","30"
"2024-06-30","Bureau","Department of the Treasury","Treasury Franchise Fund","0","0","0","0","0","0","0.0","0.0","null","2024","3","2024","2","06","30"
"2024-06-30","Bureau","Department of the Treasury","Treasury IG for Tax Admin","65","1","65","1","0","0","100.0","100.0","null","2024","3","2024","2","06","30"
"2024-06-30","Bureau","Department of the Treasury","U.S. Mint","168161","23","22126","19","146035","4","13.15762870106624","82.6086956521739","null","2024","3","2024","2","06","30"
"2024-06-30","Bureau","Department of the Treasury","U.S. Treasury IG Office","0","0","0","0","0","0","0.0","0.0","null","2024","3","2024","2","06","30"
"2024-06-30","Agency","Environmental Protection Agency","null","28860774","257","28860774","257","0","0","100.0","100.0","CFO","2024","3","2024","2","06","30"
"2024-06-30","Bureau","Environmental Protection Agency","Environmental Protection Agency","28860774","257","28860774","257","0","0","100.0","100.0","null","2024","3","2024","2","06","30"
"2024-06-30","Agency","Equal Employment Opportunity Commission","null","25460","22","25460","22","0","0","100.0","100.0","Non-CFO","2024","3","2024","2","06","30"
"2024-06-30","Bureau","Equal Employment Opportunity Commission","Equal Employment Opportunity Commission","25460","22","25460","22","0","0","100.0","100.0","null","2024","3","2024","2","06","30"
"2024-06-30","Agency","Export - Import  Bank","null","0","0","0","0","0","0","0.0","0.0","Non-CFO","2024","3","2024","2","06","30"
"2024-06-30","Bureau","Export - Import  Bank","Export-Import Bank","0","0","0","0","0","0","0.0","0.0","null","2024","3","2024","2","06","30"
"2024-06-30","Agency","Farm Credit Administration","null","630","1","630","1","0","0","100.0","100.0","Non-CFO","2024","3","2024","2","06","30"
"2024-06-30","Bureau","Farm Credit Administration","Farm Credit Administration","630","1","630","1","0","0","100.0","100.0","null","2024","3","2024","2","06","30"
"2024-06-30","Bureau","Farm Credit Administration","Farm Credit System Insurance Corporation","0","0","0","0","0","0","0.0","0.0","null","2024","3","2024","2","06","30"
"2024-06-30","Agency","Federal Communications Commission","null","309028435","16116","309028435","16116","0","0","100.0","100.0","Non-CFO","2024","3","2024","2","06","30"
"2024-06-30","Bureau","Federal Communications Commission","Federal Communications Commission","309028435","16116","309028435","16116","0","0","100.0","100.0","null","2024","3","2024","2","06","30"
"2024-06-30","Agency","Federal Deposit Insurance Corporation","null","0","0","0","0","0","0","0.0","0.0","Non-CFO","2024","3","2024","2","06","30"
"2024-06-30","Bureau","Federal Deposit Insurance Corporation","Federal Deposit Insurance Corporation","0","0","0","0","0","0","0.0","0.0","null","2024","3","2024","2","06","30"
"2024-06-30","Agency","Federal Election Commission","null","3293452","414","3293452","414","0","0","100.0","100.0","Non-CFO","2024","3","2024","2","06","30"
"2024-06-30","Bureau","Federal Election Commission","Federal Election Commission","3293452","414","3293452","414","0","0","100.0","100.0","null","2024","3","2024","2","06","30"
"2024-06-30","Agency","Federal Labor Relations Authority","null","0","0","0","0","0","0","0.0","0.0","Non-CFO","2024","3","2024","2","06","30"
"2024-06-30","Bureau","Federal Labor Relations Authority","Federal Labor Relations Authority","0","0","0","0","0","0","0.0","0.0","null","2024","3","2024","2","06","30"
"2024-06-30","Agency","Federal Maritime Commission","null","2441954","10","459298","7","1982656","3","18.808626206718063","70.0","Non-CFO","2024","3","2024","2","06","30"
"2024-06-30","Bureau","Federal Maritime Commission","Salaries and Expenses","2441954","10","459298","7","1982656","3","18.808626206718063","70.0","null","2024","3","2024","2","06","30"
"2024-06-30","Agency","Federal Mediation/Conciliation Service","null","0","0","0","0","0","0","0.0","0.0","Non-CFO","2024","3","2024","2","06","30"
"2024-06-30","Bureau","Federal Mediation/Conciliation Service","Federal Mediation/Conciliation Service","0","0","0","0","0","0","0.0","0.0","null","2024","3","2024","2","06","30"
"2024-06-30","Agency","Federal Trade Commission","null","731122916","90","731122916","90","0","0","100.0","100.0","Non-CFO","2024","3","2024","2","06","30"
"2024-06-30","Bureau","Federal Trade Commission","Federal Trade Commission","731122916","90","731122916","90","0","0","100.0","100.0","null","2024","3","2024","2","06","30"
"2024-06-30","Agency","Funds Appropriated to the President","null","1236060","7","0","0","1236060","7","0.0","0.0","Non-CFO","2024","3","2024","2","06","30"
"2024-06-30","Bureau","Funds Appropriated to the President","African Development Foundation","0","0","0","0","0","0","0.0","0.0","null","2024","3","2024","2","06","30"
"2024-06-30","Bureau","Funds Appropriated to the President","Defense Security Assistance Agency","0","0","0","0","0","0","0.0","0.0","null","2024","3","2024","2","06","30"
"2024-06-30","Bureau","Funds Appropriated to the President","Executive Branch","0","0","0","0","0","0","0.0","0.0","null","2024","3","2024","2","06","30"
"2024-06-30","Bureau","Funds Appropriated to the President","Inter-American Foundation","0","0","0","0","0","0","0.0","0.0","null","2024","3","2024","2","06","30"
"2024-06-30","Bureau","Funds Appropriated to the President","Peace Corps","0","0","0","0","0","0","0.0","0.0","null","2024","3","2024","2","06","30"
"2024-06-30","Bureau","Funds Appropriated to the President","Trade and Development Agency","1236060","7","0","0","1236060","7","0.0","0.0","null","2024","3","2024","2","06","30"
"2024-06-30","Agency","General Services Administration","null","10836356","380","10836356","380","0","0","100.0","100.0","CFO","2024","3","2024","2","06","30"
"2024-06-30","Bureau","General Services Administration","General Services Administration","10836356","380","10836356","380","0","0","100.0","100.0","null","2024","3","2024","2","06","30"
"2024-06-30","Agency","Legis Branch-Library of Congress","null","0","0","0","0","0","0","0.0","0.0","Non-CFO","2024","3","2024","2","06","30"
"2024-06-30","Bureau","Legis Branch-Library of Congress","Library of Congress","0","0","0","0","0","0","0.0","0.0","null","2024","3","2024","2","06","30"
"2024-06-30","Agency","Legislative Branch - U.S. House/Senate","null","339405","224","0","0","339405","224","0.0","0.0","Non-CFO","2024","3","2024","2","06","30"
"2024-06-30","Bureau","Legislative Branch - U.S. House/Senate","U.S. House of Representatives","339405","224","0","0","339405","224","0.0","0.0","null","2024","3","2024","2","06","30"
"2024-06-30","Agency","Legislative Branch-CBO","null","0","0","0","0","0","0","0.0","0.0","Non-CFO","2024","3","2024","2","06","30"
"2024-06-30","Bureau","Legislative Branch-CBO","Congressional Budget Office","0","0","0","0","0","0","0.0","0.0","null","2024","3","2024","2","06","30"
"2024-06-30","Agency","Legislative Branch-GAO","null","0","0","0","0","0","0","0.0","0.0","Non-CFO","2024","3","2024","2","06","30"
"2024-06-30","Bureau","Legislative Branch-GAO","Government Accountability Office","0","0","0","0","0","0","0.0","0.0","null","2024","3","2024","2","06","30"
"2024-06-30","Agency","Legislative Branch-GPO","null","0","0","0","0","0","0","0.0","0.0","Non-CFO","2024","3","2024","2","06","30"
"2024-06-30","Bureau","Legislative Branch-GPO","Government Publishing Office","0","0","0","0","0","0","0.0","0.0","null","2024","3","2024","2","06","30"
"2024-06-30","Agency","Legislative Branch-Office of Tech.","null","0","0","0","0","0","0","0.0","0.0","Non-CFO","2024","3","2024","2","06","30"
"2024-06-30","Bureau","Legislative Branch-Office of Tech.","Medicaid & CHIP Payment & Access Comm.","0","0","0","0","0","0","0.0","0.0","null","2024","3","2024","2","06","30"
"2024-06-30","Bureau","Legislative Branch-Office of Tech.","Open World Leadership","0","0","0","0","0","0","0.0","0.0","null","2024","3","2024","2","06","30"
"2024-06-30","Agency","Merit Systems Protection Board","null","144","1","144","1","0","0","100.0","100.0","Non-CFO","2024","3","2024","2","06","30"
"2024-06-30","Bureau","Merit Systems Protection Board","Merit Systems Protection Board","144","1","144","1","0","0","100.0","100.0","null","2024","3","2024","2","06","30"
"2024-06-30","Agency","National Aeronautics and Space Administration","null","1207201","134","1207201","134","0","0","100.0","100.0","CFO","2024","3","2024","2","06","30"
"2024-06-30","Bureau","National Aeronautics and Space Administration","National Aeronautics and Space Admin","1207201","134","1207201","134","0","0","100.0","100.0","null","2024","3","2024","2","06","30"
"2024-06-30","Agency","National Archives & Records Admin","null","100964","87","100964","87","0","0","100.0","100.0","Non-CFO","2024","3","2024","2","06","30"
"2024-06-30","Bureau","National Archives & Records Admin","Nat'l Archives & Records Administration","100964","87","100964","87","0","0","100.0","100.0","null","2024","3","2024","2","06","30"
"2024-06-30","Agency","National Credit Union Administration","null","397","1","397","1","0","0","100.0","100.0","Non-CFO","2024","3","2024","2","06","30"
"2024-06-30","Bureau","National Credit Union Administration","National Credit Union Administration","397","1","397","1","0","0","100.0","100.0","null","2024","3","2024","2","06","30"
"2024-06-30","Agency","National Foundation  Arts & Humanities","null","0","0","0","0","0","0","0.0","0.0","Non-CFO","2024","3","2024","2","06","30"
"2024-06-30","Bureau","National Foundation  Arts & Humanities","National Endowment for the Arts","0","0","0","0","0","0","0.0","0.0","null","2024","3","2024","2","06","30"
"2024-06-30","Bureau","National Foundation  Arts & Humanities","National Endowment for the Humanities","0","0","0","0","0","0","0.0","0.0","null","2024","3","2024","2","06","30"
"2024-06-30","Agency","National Labor Relations Board","null","0","0","0","0","0","0","0.0","0.0","Non-CFO","2024","3","2024","2","06","30"
"2024-06-30","Bureau","National Labor Relations Board","National Labor Relations Board","0","0","0","0","0","0","0.0","0.0","null","2024","3","2024","2","06","30"
"2024-06-30","Agency","National Science Foundation","null","555548","28","555548","28","0","0","100.0","100.0","CFO","2024","3","2024","2","06","30"
"2024-06-30","Bureau","National Science Foundation","National Science Foundation","555548","28","555548","28","0","0","100.0","100.0","null","2024","3","2024","2","06","30"
"2024-06-30","Agency","Neighborhood Reinvestment Corporation","null","0","0","0","0","0","0","0.0","0.0","Non-CFO","2024","3","2024","2","06","30"
"2024-06-30","Bureau","Neighborhood Reinvestment Corporation","Neighborhood Reinvestment Corporation","0","0","0","0","0","0","0.0","0.0","null","2024","3","2024","2","06","30"
"2024-06-30","Agency","Nuclear Regulatory Commission","null","3409530","364","3409530","364","0","0","100.0","100.0","CFO","2024","3","2024","2","06","30"
"2024-06-30","Bureau","Nuclear Regulatory Commission","Nuclear Regulatory Commission","3409530","364","3409530","364","0","0","100.0","100.0","null","2024","3","2024","2","06","30"
"2024-06-30","Agency","Occupational Safety & Health Rev Comm","null","0","0","0","0","0","0","0.0","0.0","Non-CFO","2024","3","2024","2","06","30"
"2024-06-30","Bureau","Occupational Safety & Health Rev Comm","Occupational Safety & Health Rev Comm","0","0","0","0","0","0","0.0","0.0","null","2024","3","2024","2","06","30"
"2024-06-30","Agency","Office of Compliance","null","0","0","0","0","0","0","0.0","0.0","Non-CFO","2024","3","2024","2","06","30"
"2024-06-30","Bureau","Office of Compliance","Office of Compliance","0","0","0","0","0","0","0.0","0.0","null","2024","3","2024","2","06","30"
"2024-06-30","Agency","Office of Government Ethics","null","0","0","0","0","0","0","0.0","0.0","Non-CFO","2024","3","2024","2","06","30"
"2024-06-30","Bureau","Office of Government Ethics","Office of Government Ethics","0","0","0","0","0","0","0.0","0.0","null","2024","3","2024","2","06","30"
"2024-06-30","Agency","Office of Personnel Management","null","17802092","989","17802092","989","0","0","100.0","100.0","CFO","2024","3","2024","2","06","30"
"2024-06-30","Bureau","Office of Personnel Management","Office of Personnel Management","17802092","989","17802092","989","0","0","100.0","100.0","null","2024","3","2024","2","06","30"
"2024-06-30","Agency","Office of Special Counsel","null","0","0","0","0","0","0","0.0","0.0","Non-CFO","2024","3","2024","2","06","30"
"2024-06-30","Bureau","Office of Special Counsel","Office of Special Counsel","0","0","0","0","0","0","0.0","0.0","null","2024","3","2024","2","06","30"
"2024-06-30","Agency","Other Agencies","null","728500","44","510963","5","217537","39","70.13905284831846","11.363636363636363","Non-CFO","2024","3","2024","2","06","30"
"2024-06-30","Bureau","Other Agencies","Advisory Council on Hist. Preservation","0","0","0","0","0","0","0.0","0.0","null","2024","3","2024","2","06","30"
"2024-06-30","Bureau","Other Agencies","Archit.&Trans. Barriers Compliance Bd","0","0","0","0","0","0","0.0","0.0","null","2024","3","2024","2","06","30"
"2024-06-30","Bureau","Other Agencies","Architect of the Capitol","0","0","0","0","0","0","0.0","0.0","null","2024","3","2024","2","06","30"
"2024-06-30","Bureau","Other Agencies","Chemical Safety Board","0","0","0","0","0","0","0.0","0.0","null","2024","3","2024","2","06","30"
"2024-06-30","Bureau","Other Agencies","Comm. for Purchase from Blind/Handic.","0","0","0","0","0","0","0.0","0.0","null","2024","3","2024","2","06","30"
"2024-06-30","Bureau","Other Agencies","Commission On Fine Arts","0","0","0","0","0","0","0.0","0.0","null","2024","3","2024","2","06","30"
"2024-06-30","Bureau","Other Agencies","Consumer Financial Protection Bureau","515930","15","510963","5","4967","10","99.03727249820712","33.333333333333336","null","2024","3","2024","2","06","30"
"2024-06-30","Bureau","Other Agencies","Council of Insps. Gen. of Intg. & Effy.","0","0","0","0","0","0","0.0","0.0","null","2024","3","2024","2","06","30"
"2024-06-30","Bureau","Other Agencies","Defense Nuclear Facilities Safety Board","0","0","0","0","0","0","0.0","0.0","null","2024","3","2024","2","06","30"
"2024-06-30","Bureau","Other Agencies","Delta Regional Authority","0","0","0","0","0","0","0.0","0.0","null","2024","3","2024","2","06","30"
"2024-06-30","Bureau","Other Agencies","Denali Commission","0","0","0","0","0","0","0.0","0.0","null","2024","3","2024","2","06","30"
"2024-06-30","Bureau","Other Agencies","District of Columbia Government","0","0","0","0","0","0","0.0","0.0","null","2024","3","2024","2","06","30"
"2024-06-30","Bureau","Other Agencies","Election Assistance Commission","0","0","0","0","0","0","0.0","0.0","null","2024","3","2024","2","06","30"
"2024-06-30","Bureau","Other Agencies","Federal Housing Finance Agency","0","0","0","0","0","0","0.0","0.0","null","2024","3","2024","2","06","30"
"2024-06-30","Bureau","Other Agencies","Federal Housing Finance Agency OIG","0","0","0","0","0","0","0.0","0.0","null","2024","3","2024","2","06","30"
"2024-06-30","Bureau","Other Agencies","Federal Mine Safety & Health Review Comm","0","0","0","0","0","0","0.0","0.0","null","2024","3","2024","2","06","30"
"2024-06-30","Bureau","Other Agencies","Gulf Coast Ecosystem Restoration Council","0","0","0","0","0","0","0.0","0.0","null","2024","3","2024","2","06","30"
"2024-06-30","Bureau","Other Agencies","James Madison Memorial Fellowship","197397","25","0","0","197397","25","0.0","0.0","null","2024","3","2024","2","06","30"
"2024-06-30","Bureau","Other Agencies","John C. Stennis","6313","2","0","0","6313","2","0.0","0.0","null","2024","3","2024","2","06","30"
"2024-06-30","Bureau","Other Agencies","Millennium Challenge Corporation","0","0","0","0","0","0","0.0","0.0","null","2024","3","2024","2","06","30"
"2024-06-30","Bureau","Other Agencies","Morris K. Udall Scholarship","0","0","0","0","0","0","0.0","0.0","null","2024","3","2024","2","06","30"
"2024-06-30","Bureau","Other Agencies","National Capital Planning Commission","0","0","0","0","0","0","0.0","0.0","null","2024","3","2024","2","06","30"
"2024-06-30","Bureau","Other Agencies","National Council on Disability","0","0","0","0","0","0","0.0","0.0","null","2024","3","2024","2","06","30"
"2024-06-30","Bureau","Other Agencies","National Mediation Board","0","0","0","0","0","0","0.0","0.0","null","2024","3","2024","2","06","30"
"2024-06-30","Bureau","Other Agencies","National Transportation Safety Board","0","0","0","0","0","0","0.0","0.0","null","2024","3","2024","2","06","30"
"2024-06-30","Bureau","Other Agencies","Privacy & Civil Liberties Oversight Bd","0","0","0","0","0","0","0.0","0.0","null","2024","3","2024","2","06","30"
"2024-06-30","Bureau","Other Agencies","Surface Transportation Board","0","0","0","0","0","0","0.0","0.0","null","2024","3","2024","2","06","30"
"2024-06-30","Bureau","Other Agencies","U.S.  Agency of Global Media","0","0","0","0","0","0","0.0","0.0","null","2024","3","2024","2","06","30"
"2024-06-30","Bureau","Other Agencies","U.S. Holocaust Memorial Council","0","0","0","0","0","0","0.0","0.0","null","2024","3","2024","2","06","30"
"2024-06-30","Bureau","Other Agencies","U.S. Inst. for Env. Conflict Resolution","8860","2","0","0","8860","2","0.0","0.0","null","2024","3","2024","2","06","30"
"2024-06-30","Bureau","Other Agencies","U.S. Institute of Peace","0","0","0","0","0","0","0.0","0.0","null","2024","3","2024","2","06","30"
"2024-06-30","Agency","Other Agencies/Boards/Commissions","null","1024","1","0","0","1024","1","0.0","0.0","Non-CFO","2024","3","2024","2","06","30"
"2024-06-30","Bureau","Other Agencies/Boards/Commissions","Medicare Payment Advisory Commission","0","0","0","0","0","0","0.0","0.0","null","2024","3","2024","2","06","30"
"2024-06-30","Bureau","Other Agencies/Boards/Commissions","Nuclear Waste Technical Review Board","0","0","0","0","0","0","0.0","0.0","null","2024","3","2024","2","06","30"
"2024-06-30","Bureau","Other Agencies/Boards/Commissions","U.S. Comm. on Int. Religious Freedom","1024","1","0","0","1024","1","0.0","0.0","null","2024","3","2024","2","06","30"
"2024-06-30","Bureau","Other Agencies/Boards/Commissions","U.S.-China Security Review Commission","0","0","0","0","0","0","0.0","0.0","null","2024","3","2024","2","06","30"
"2024-06-30","Agency","Pension Benefit Guaranty Corp","null","5562406","1735","5562406","1735","0","0","100.0","100.0","Non-CFO","2024","3","2024","2","06","30"
"2024-06-30","Bureau","Pension Benefit Guaranty Corp","Pension Benefit Guaranty Corporation","5562406","1735","5562406","1735","0","0","100.0","100.0","null","2024","3","2024","2","06","30"
"2024-06-30","Agency","Presidio Trust Corporation","null","1402257","61","1402257","61","0","0","100.0","100.0","Non-CFO","2024","3","2024","2","06","30"
"2024-06-30","Bureau","Presidio Trust Corporation","Presidio Trust Corporation","1402257","61","1402257","61","0","0","100.0","100.0","null","2024","3","2024","2","06","30"
"2024-06-30","Agency","Railroad Retirement Board","null","26012310","1930","26012310","1930","0","0","100.0","100.0","Non-CFO","2024","3","2024","2","06","30"
"2024-06-30","Bureau","Railroad Retirement Board","Railroad Retirement Board","26012310","1930","26012310","1930","0","0","100.0","100.0","null","2024","3","2024","2","06","30"
"2024-06-30","Agency","Securities & Exchange Commission","null","3931043971","1782","3931043971","1782","0","0","100.0","100.0","Non-CFO","2024","3","2024","2","06","30"
"2024-06-30","Bureau","Securities & Exchange Commission","SEC Enforcement","3930789694","1738","3930789694","1738","0","0","100.0","100.0","null","2024","3","2024","2","06","30"
"2024-06-30","Bureau","Securities & Exchange Commission","Securities and Exchange Commission","254277","44","254277","44","0","0","100.0","100.0","null","2024","3","2024","2","06","30"
"2024-06-30","Agency","Selective Service System","null","1301","2","0","0","1301","2","0.0","0.0","Non-CFO","2024","3","2024","2","06","30"
"2024-06-30","Bureau","Selective Service System","Selective Service System","1301","2","0","0","1301","2","0.0","0.0","null","2024","3","2024","2","06","30"
"2024-06-30","Agency","Small Business Administration","null","74414103000","1252332","74414103000","1252332","0","0","100.0","100.0","CFO","2024","3","2024","2","06","30"
"2024-06-30","Bureau","Small Business Administration","Small Business Administration","74414103000","1252332","74414103000","1252332","0","0","100.0","100.0","null","2024","3","2024","2","06","30"
"2024-06-30","Agency","Smithsonian Institution","null","4786","11","0","0","4786","11","0.0","0.0","Non-CFO","2024","3","2024","2","06","30"
"2024-06-30","Bureau","Smithsonian Institution","Administrative Conference of the US","0","0","0","0","0","0","0.0","0.0","null","2024","3","2024","2","06","30"
"2024-06-30","Bureau","Smithsonian Institution","JFK Center for the Performing Arts","0","0","0","0","0","0","0.0","0.0","null","2024","3","2024","2","06","30"
"2024-06-30","Bureau","Smithsonian Institution","National Gallery of Art","0","0","0","0","0","0","0.0","0.0","null","2024","3","2024","2","06","30"
"2024-06-30","Bureau","Smithsonian Institution","Smithsonian Institution","4786","11","0","0","4786","11","0.0","0.0","null","2024","3","2024","2","06","30"
"2024-06-30","Agency","Social Security Administration","null","4253622106","1316428","2310352032","394056","1943270074","922372","54.31493382407205","29.93372975962225","CFO","2024","3","2024","2","06","30"
"2024-06-30","Bureau","Social Security Administration","Social Security Administration","4253622106","1316428","2310352032","394056","1943270074","922372","54.31493382407205","29.93372975962225","null","2024","3","2024","2","06","30"
"2024-06-30","Agency","Tennessee Valley Authority","null","0","0","0","0","0","0","0.0","0.0","Non-CFO","2024","3","2024","2","06","30"
"2024-06-30","Bureau","Tennessee Valley Authority","Tennessee Valley Authority","0","0","0","0","0","0","0.0","0.0","null","2024","3","2024","2","06","30"
"2024-06-30","Agency","The Judiciary","null","1046620","310","1034627","180","11993","130","98.85412088437064","58.064516129032256","Non-CFO","2024","3","2024","2","06","30"
"2024-06-30","Bureau","The Judiciary","Administrative Office of the U.S. Courts","1046620","310","1034627","180","11993","130","98.85412088437064","58.064516129032256","null","2024","3","2024","2","06","30"
"2024-06-30","Agency","U.S. Court of Appeals / Veterans Claims","null","0","0","0","0","0","0","0.0","0.0","Non-CFO","2024","3","2024","2","06","30"
"2024-06-30","Bureau","U.S. Court of Appeals / Veterans Claims","U.S. Court of Appeals / Veterans Claims","0","0","0","0","0","0","0.0","0.0","null","2024","3","2024","2","06","30"
"2024-06-30","Agency","U.S. Postal Service","null","84236430","81459","72561127","68300","11675303","13159","86.13984115898549","83.84586110804209","Non-CFO","2024","3","2024","2","06","30"
"2024-06-30","Bureau","U.S. Postal Service","U.S. Postal Service","84236430","81459","72561127","68300","11675303","13159","86.13984115898549","83.84586110804209","null","2024","3","2024","2","06","30"
"2024-06-30","Agency","U.S. Tax Court","null","0","0","0","0","0","0","0.0","0.0","Non-CFO","2024","3","2024","2","06","30"
"2024-06-30","Bureau","U.S. Tax Court","U.S. Tax Court","0","0","0","0","0","0","0.0","0.0","null","2024","3","2024","2","06","30"
"2024-06-30","Agency","US International Development Fin. Corp.","null","0","0","0","0","0","0","0.0","0.0","Non-CFO","2024","3","2024","2","06","30"
"2024-06-30","Bureau","US International Development Fin. Corp.","US International Development Fin. Corp.","0","0","0","0","0","0","0.0","0.0","null","2024","3","2024","2","06","30"
"2024-03-31","Agency","Agency for International Development","null","28422086","55","28421814","54","272","1","99.99904299775885","98.18181818181819","CFO","2024","2","2024","1","03","31"
"2024-03-31","Bureau","Agency for International Development","Agency for International Development","28422086","55","28421814","54","272","1","99.99904299775885","98.18181818181819","null","2024","2","2024","1","03","31"
"2024-03-31","Agency","American Battle Monuments Commission","null","0","0","0","0","0","0","0.0","0.0","Non-CFO","2024","2","2024","1","03","31"
"2024-03-31","Bureau","American Battle Monuments Commission","American Battle Monuments Commission","0","0","0","0","0","0","0.0","0.0","null","2024","2","2024","1","03","31"
"2024-03-31","Agency","Armed Forces Retirement Home","null","108568","92","75398","91","33170","1","69.44771940166531","98.91304347826087","Non-CFO","2024","2","2024","1","03","31"
"2024-03-31","Bureau","Armed Forces Retirement Home","Armed Forces Retirement Home","108568","92","75398","91","33170","1","69.44771940166531","98.91304347826087","null","2024","2","2024","1","03","31"
"2024-03-31","Agency","Commodity Futures Trading Commission","null","630758270","359","630758270","359","0","0","100.0","100.0","Non-CFO","2024","2","2024","1","03","31"
"2024-03-31","Bureau","Commodity Futures Trading Commission","Commodity Futures Trading Commission","630758270","359","630758270","359","0","0","100.0","100.0","null","2024","2","2024","1","03","31"
"2024-03-31","Agency","Consumer Product Safety Commission","null","420","2","420","2","0","0","100.0","100.0","Non-CFO","2024","2","2024","1","03","31"
"2024-03-31","Bureau","Consumer Product Safety Commission","Consumer Product Safety Commission","420","2","420","2","0","0","100.0","100.0","null","2024","2","2024","1","03","31"
"2024-03-31","Agency","Corp. for National and Community Service","null","3891687","373","3601798","147","289889","226","92.55107103937188","39.41018766756032","Non-CFO","2024","2","2024","1","03","31"
"2024-03-31","Bureau","Corp. for National and Community Service","Corp. for National and Community Service","3891687","373","3601798","147","289889","226","92.55107103937188","39.41018766756032","null","2024","2","2024","1","03","31"
"2024-03-31","Agency","Department of Agriculture","null","1122868742","48238","1114111213","45256","8757529","2982","99.22007544849797","93.81815166466271","CFO","2024","2","2024","1","03","31"
"2024-03-31","Bureau","Department of Agriculture","Agricultural Marketing Service","4944590","1997","3836370","1160","1108220","837","77.58722158965658","58.08713069604406","null","2024","2","2024","1","03","31"
"2024-03-31","Bureau","Department of Agriculture","Commodity Credit Corporation","123651867","8731","123651867","8731","0","0","100.0","100.0","null","2024","2","2024","1","03","31"
"2024-03-31","Bureau","Department of Agriculture","Farm Service Agency","75242985","1544","75242985","1544","0","0","100.0","100.0","null","2024","2","2024","1","03","31"
"2024-03-31","Bureau","Department of Agriculture","Federal Crop Insurance Corporation","5591","6","5591","6","0","0","100.0","100.0","null","2024","2","2024","1","03","31"
"2024-03-31","Bureau","Department of Agriculture","Food Safety and Inspection Service","1690746","3036","1620129","2992","70617","44","95.82332295921445","98.55072463768116","null","2024","2","2024","1","03","31"
"2024-03-31","Bureau","Department of Agriculture","Food and Nutrition Service","46829","20","38429","15","8400","5","82.06239723248414","75.0","null","2024","2","2024","1","03","31"
"2024-03-31","Bureau","Department of Agriculture","Forest Service","75098925","713","71629215","405","3469710","308","95.37981402530063","56.80224403927069","null","2024","2","2024","1","03","31"
"2024-03-31","Bureau","Department of Agriculture","Rural Development","818867977","28050","818860780","28043","7197","7","99.99912110374295","99.97504456327985","null","2024","2","2024","1","03","31"
"2024-03-31","Bureau","Department of Agriculture","U.S. Department of Agriculture","23319232","4141","19225847","2360","4093385","1781","82.44631298320631","56.99106496015455","null","2024","2","2024","1","03","31"
"2024-03-31","Agency","Department of Commerce","null","59048584","7680","59048584","7680","0","0","100.0","100.0","CFO","2024","2","2024","1","03","31"
"2024-03-31","Bureau","Department of Commerce","Bureau of Industry and Security","37546041","27","37546041","27","0","0","100.0","100.0","null","2024","2","2024","1","03","31"
"2024-03-31","Bureau","Department of Commerce","Bureau of the Census","1958543","6005","1958543","6005","0","0","100.0","100.0","null","2024","2","2024","1","03","31"
"2024-03-31","Bureau","Department of Commerce","Economic Development Administration","5120584","11","5120584","11","0","0","100.0","100.0","null","2024","2","2024","1","03","31"
"2024-03-31","Bureau","Department of Commerce","Economic and Statistical Analysis","0","0","0","0","0","0","0.0","0.0","null","2024","2","2024","1","03","31"
"2024-03-31","Bureau","Department of Commerce","General Administration","0","0","0","0","0","0","0.0","0.0","null","2024","2","2024","1","03","31"
"2024-03-31","Bureau","Department of Commerce","International Trade Administration","0","0","0","0","0","0","0.0","0.0","null","2024","2","2024","1","03","31"
"2024-03-31","Bureau","Department of Commerce","Minority Business Development Agency","0","0","0","0","0","0","0.0","0.0","null","2024","2","2024","1","03","31"
"2024-03-31","Bureau","Department of Commerce","NOAA","12517698","814","12517698","814","0","0","100.0","100.0","null","2024","2","2024","1","03","31"
"2024-03-31","Bureau","Department of Commerce","Nat'l Institute of Standards& Technology","992651","5","992651","5","0","0","100.0","100.0","null","2024","2","2024","1","03","31"
"2024-03-31","Bureau","Department of Commerce","Nat'l Telecomm & Information Admin.","296093","1","296093","1","0","0","100.0","100.0","null","2024","2","2024","1","03","31"
"2024-03-31","Bureau","Department of Commerce","National Technical Information Service","0","0","0","0","0","0","0.0","0.0","null","2024","2","2024","1","03","31"
"2024-03-31","Bureau","Department of Commerce","Office of the Inspector General","0","0","0","0","0","0","0.0","0.0","null","2024","2","2024","1","03","31"
"2024-03-31","Bureau","Department of Commerce","Patent and Trademark Office","616974","817","616974","817","0","0","100.0","100.0","null","2024","2","2024","1","03","31"
"2024-03-31","Agency","Department of Defense","null","2971421400","1703180","1087730100","302643","1883691300","1400537","36.60638979042152","17.76929038621872","CFO","2024","2","2024","1","03","31"
"2024-03-31","Bureau","Department of Defense","Consolidated Report","2971421400","1703180","1087730100","302643","1883691300","1400537","36.60638979042152","17.76929038621872","null","2024","2","2024","1","03","31"
"2024-03-31","Agency","Department of Education","null","115460737581","19566556","112398362197","18968090","3062375384","598466","97.34769113019772","96.94138304155315","CFO","2024","2","2024","1","03","31"
"2024-03-31","Bureau","Department of Education","Departmental Management","1206277979","2073","1201806445","1996","4471534","77","99.62931147895887","96.28557645923782","null","2024","2","2024","1","03","31"
"2024-03-31","Bureau","Department of Education","Federal Student Aid","114254459602","19564483","111196555752","18966094","3057903850","598389","97.32360219403947","96.94145252905481","null","2024","2","2024","1","03","31"
"2024-03-31","Bureau","Department of Education","Office of Postsecondary Education","0","0","0","0","0","0","0.0","0.0","null","2024","2","2024","1","03","31"
"2024-03-31","Agency","Department of Energy","null","13773303","104","13773303","104","0","0","100.0","100.0","CFO","2024","2","2024","1","03","31"
"2024-03-31","Bureau","Department of Energy","Bonneville Power Administration","1058470","28","1058470","28","0","0","100.0","100.0","null","2024","2","2024","1","03","31"
"2024-03-31","Bureau","Department of Energy","Energy Consolidated Reports","12714833","76","12714833","76","0","0","100.0","100.0","null","2024","2","2024","1","03","31"
"2024-03-31","Agency","Department of Health & Human Services","null","6507316323","1164681","6267671328","1135049","239644995","29632","96.31729912755311","97.45578403013357","CFO","2024","2","2024","1","03","31"
"2024-03-31","Bureau","Department of Health & Human Services","Administration for Children and Families","38434245","1739","38434245","1739","0","0","100.0","100.0","null","2024","2","2024","1","03","31"
"2024-03-31","Bureau","Department of Health & Human Services","Administration for Community Living","0","0","0","0","0","0","0.0","0.0","null","2024","2","2024","1","03","31"
"2024-03-31","Bureau","Department of Health & Human Services","Agency for Healthcare Research & Quality","0","0","0","0","0","0","0.0","0.0","null","2024","2","2024","1","03","31"
"2024-03-31","Bureau","Department of Health & Human Services","Centers for Disease Control","6582915","120","972113","20","5610802","100","14.76721178991374","16.666666666666668","null","2024","2","2024","1","03","31"
"2024-03-31","Bureau","Department of Health & Human Services","Centers for Medicare & Medicaid Services","5792932505","1129961","5715139258","1120396","77793247","9565","98.65710075280775","99.15351060788824","null","2024","2","2024","1","03","31"
"2024-03-31","Bureau","Department of Health & Human Services","Food and Drug Administration","192736791","21581","57699499","1994","135037292","19587","29.93694078885022","9.239608915249525","null","2024","2","2024","1","03","31"
"2024-03-31","Bureau","Department of Health & Human Services","Health Resources and Services Admin","134213968","696","134213968","696","0","0","100.0","100.0","null","2024","2","2024","1","03","31"
"2024-03-31","Bureau","Department of Health & Human Services","Indian Health Services","112618366","4486","110596054","4486","2022312","0","98.20427868754551","100.0","null","2024","2","2024","1","03","31"
"2024-03-31","Bureau","Department of Health & Human Services","National Institutes of Health","26992106","514","7810764","134","19181342","380","28.93721594009745","26.070038910505836","null","2024","2","2024","1","03","31"
"2024-03-31","Bureau","Department of Health & Human Services","Office of the Inspector General","33600","1","33600","1","0","0","100.0","100.0","null","2024","2","2024","1","03","31"
"2024-03-31","Bureau","Department of Health & Human Services","Office of the Secretary","195075001","5322","195075001","5322","0","0","100.0","100.0","null","2024","2","2024","1","03","31"
"2024-03-31","Bureau","Department of Health & Human Services","Program Support Center","6599578","251","6599578","251","0","0","100.0","100.0","null","2024","2","2024","1","03","31"
"2024-03-31","Bureau","Department of Health & Human Services","Substance Abuse & Mental Health Admin.","1097248","10","1097248","10","0","0","100.0","100.0","null","2024","2","2024","1","03","31"
"2024-03-31","Agency","Department of Homeland Security","null","398504252","175936","372681238","113956","25823014","61980","93.52001544013638","64.77128046562386","CFO","2024","2","2024","1","03","31"
"2024-03-31","Bureau","Department of Homeland Security","Bureau of Customs & Border Protection","9436867","862","9436867","862","0","0","100.0","100.0","null","2024","2","2024","1","03","31"
"2024-03-31","Bureau","Department of Homeland Security","Citizenship and Immigration Services","1236530","1536","1236530","1536","0","0","100.0","100.0","null","2024","2","2024","1","03","31"
"2024-03-31","Bureau","Department of Homeland Security","Domestic Nuclear Detection Office","3752","27","0","0","3752","27","0.0","0.0","null","2024","2","2024","1","03","31"
"2024-03-31","Bureau","Department of Homeland Security","Emergency Preparedness & Resp","215630768","44592","215630768","44592","0","0","100.0","100.0","null","2024","2","2024","1","03","31"
"2024-03-31","Bureau","Department of Homeland Security","Federal Law Enforcement Training Ctr.","8562","1","8562","1","0","0","100.0","100.0","null","2024","2","2024","1","03","31"
"2024-03-31","Bureau","Department of Homeland Security","Immigration and Customs Enforcement","17049916","683","17049916","683","0","0","100.0","100.0","null","2024","2","2024","1","03","31"
"2024-03-31","Bureau","Department of Homeland Security","Info Analysis Infrastructure Prot-NPPD","0","0","0","0","0","0","0.0","0.0","null","2024","2","2024","1","03","31"
"2024-03-31","Bureau","Department of Homeland Security","Management Headquarters","0","0","0","0","0","0","0.0","0.0","null","2024","2","2024","1","03","31"
"2024-03-31","Bureau","Department of Homeland Security","Office of Biometric Identity Management","0","0","0","0","0","0","0.0","0.0","null","2024","2","2024","1","03","31"
"2024-03-31","Bureau","Department of Homeland Security","Office of the Inspector General DHS","100","1","100","1","0","0","100.0","100.0","null","2024","2","2024","1","03","31"
"2024-03-31","Bureau","Department of Homeland Security","Science and Technology","0","0","0","0","0","0","0.0","0.0","null","2024","2","2024","1","03","31"
"2024-03-31","Bureau","Department of Homeland Security","Transportation Safety Administration","128382235","64936","128382235","64936","0","0","100.0","100.0","null","2024","2","2024","1","03","31"
"2024-03-31","Bureau","Department of Homeland Security","U.S. Coast Guard","26755522","63298","936260","1345","25819262","61953","3.49931501990505","2.1248696641284086","null","2024","2","2024","1","03","31"
"2024-03-31","Bureau","Department of Homeland Security","U.S. Secret Service","0","0","0","0","0","0","0.0","0.0","null","2024","2","2024","1","03","31"
"2024-03-31","Agency","Department of Housing and Urban Development","null","84215132","3617","83945464","3607","269668","10","99.67978676326246","99.72352778545756","CFO","2024","2","2024","1","03","31"
"2024-03-31","Bureau","Department of Housing and Urban Development","Community Planning and Development","102184","1","102184","1","0","0","100.0","100.0","null","2024","2","2024","1","03","31"
"2024-03-31","Bureau","Department of Housing and Urban Development","Government National Mortgage Association","218994","7","0","0","218994","7","0.0","0.0","null","2024","2","2024","1","03","31"
"2024-03-31","Bureau","Department of Housing and Urban Development","Housing Programs","82482577","3549","82431903","3546","50674","3","99.93856399515742","99.91546914623838","null","2024","2","2024","1","03","31"
"2024-03-31","Bureau","Department of Housing and Urban Development","Management and Administration","55945","53","55945","53","0","0","100.0","100.0","null","2024","2","2024","1","03","31"
"2024-03-31","Bureau","Department of Housing and Urban Development","Policy, Development and Research","0","0","0","0","0","0","0.0","0.0","null","2024","2","2024","1","03","31"
"2024-03-31","Bureau","Department of Housing and Urban Development","Public and Indian Housing Programs","1355432","7","1355432","7","0","0","100.0","100.0","null","2024","2","2024","1","03","31"
"2024-03-31","Agency","Department of Justice","null","93003329","39819","90486585","39244","2516744","575","97.29392052192024","98.5559657449961","CFO","2024","2","2024","1","03","31"
"2024-03-31","Bureau","Department of Justice","Bureau of ATF and Explosives","19881","1","19881","1","0","0","100.0","100.0","null","2024","2","2024","1","03","31"
"2024-03-31","Bureau","Department of Justice","Drug Enforcement Administration","343135","15","343135","15","0","0","100.0","100.0","null","2024","2","2024","1","03","31"
"2024-03-31","Bureau","Department of Justice","Federal Bureau of Investigation","497990","114","497990","114","0","0","100.0","100.0","null","2024","2","2024","1","03","31"
"2024-03-31","Bureau","Department of Justice","Federal Prison Industries","525521","238","0","0","525521","238","0.0","0.0","null","2024","2","2024","1","03","31"
"2024-03-31","Bureau","Department of Justice","Federal Prison System","0","0","0","0","0","0","0.0","0.0","null","2024","2","2024","1","03","31"
"2024-03-31","Bureau","Department of Justice","General Administration","0","0","0","0","0","0","0.0","0.0","null","2024","2","2024","1","03","31"
"2024-03-31","Bureau","Department of Justice","Legal Activities","91191852","39444","89206663","39111","1985189","333","97.82306318332037","99.15576513538181","null","2024","2","2024","1","03","31"
"2024-03-31","Bureau","Department of Justice","Office of Justice Assistance Programs","418916","3","418916","3","0","0","100.0","100.0","null","2024","2","2024","1","03","31"
"2024-03-31","Bureau","Department of Justice","U.S. Marshals Service","6034","4","0","0","6034","4","0.0","0.0","null","2024","2","2024","1","03","31"
"2024-03-31","Agency","Department of Labor","null","175739667","16202","155666673","11402","20072994","4800","88.57799474492005","70.3740278977904","CFO","2024","2","2024","1","03","31"
"2024-03-31","Bureau","Department of Labor","Bureau of Labor Statistics","4782","1","4782","1","0","0","100.0","100.0","null","2024","2","2024","1","03","31"
"2024-03-31","Bureau","Department of Labor","Departmental Management","0","0","0","0","0","0","0.0","0.0","null","2024","2","2024","1","03","31"
"2024-03-31","Bureau","Department of Labor","Employee Benefit Security Administration","20713277","447","20713277","447","0","0","100.0","100.0","null","2024","2","2024","1","03","31"
"2024-03-31","Bureau","Department of Labor","Employment Standards Administration","70700780","4823","61201194","3011","9499586","1812","86.5636758180037","62.4300228073813","null","2024","2","2024","1","03","31"
"2024-03-31","Bureau","Department of Labor","Employment and Training Administration","1423363","13","1423363","13","0","0","100.0","100.0","null","2024","2","2024","1","03","31"
"2024-03-31","Bureau","Department of Labor","Mine Safety and Health Administration","15411145","6497","11369188","4433","4041957","2064","73.772506844884","68.23149145759581","null","2024","2","2024","1","03","31"
"2024-03-31","Bureau","Department of Labor","Occupational Safety and Health Admin","67486320","4421","60954869","3497","6531451","924","90.32181485077272","79.09975118751414","null","2024","2","2024","1","03","31"
"2024-03-31","Agency","Department of State","null","23079739","20796","22664853","20707","414886","89","98.2023800182489","99.57203308328525","CFO","2024","2","2024","1","03","31"
"2024-03-31","Bureau","Department of State","Department of State","21391002","9918","20976116","9829","414886","89","98.0604648627493","99.10264166162533","null","2024","2","2024","1","03","31"
"2024-03-31","Bureau","Department of State","International Commissions","0","0","0","0","0","0","0.0","0.0","null","2024","2","2024","1","03","31"
"2024-03-31","Bureau","Department of State","Passport NSF","1688737","10878","1688737","10878","0","0","100.0","100.0","null","2024","2","2024","1","03","31"
"2024-03-31","Agency","Department of Transportation","null","89042178","9587","89016522","9579","25656","8","99.9711866886275","99.91655366642328","CFO","2024","2","2024","1","03","31"
"2024-03-31","Bureau","Department of Transportation","Federal Aviation Administration","4489917","527","4489917","527","0","0","100.0","100.0","null","2024","2","2024","1","03","31"
"2024-03-31","Bureau","Department of Transportation","Federal Highway Administration","10438","8","10438","8","0","0","100.0","100.0","null","2024","2","2024","1","03","31"
"2024-03-31","Bureau","Department of Transportation","Federal Motor Carrier Safety Admin","80851219","8894","80825563","8886","25656","8","99.96826763984845","99.91005172026085","null","2024","2","2024","1","03","31"
"2024-03-31","Bureau","Department of Transportation","Federal Railroad Administration","144874","12","144874","12","0","0","100.0","100.0","null","2024","2","2024","1","03","31"
"2024-03-31","Bureau","Department of Transportation","Federal Transit Administration","786379","2","786379","2","0","0","100.0","100.0","null","2024","2","2024","1","03","31"
"2024-03-31","Bureau","Department of Transportation","Maritime Administration","304542","19","304542","19","0","0","100.0","100.0","null","2024","2","2024","1","03","31"
"2024-03-31","Bureau","Department of Transportation","National Highway Traffic Safety Admin.","29816","6","29816","6","0","0","100.0","100.0","null","2024","2","2024","1","03","31"
"2024-03-31","Bureau","Department of Transportation","Office of the Inspector General","0","0","0","0","0","0","0.0","0.0","null","2024","2","2024","1","03","31"
"2024-03-31","Bureau","Department of Transportation","Office of the Secretary","1156735","15","1156735","15","0","0","100.0","100.0","null","2024","2","2024","1","03","31"
"2024-03-31","Bureau","Department of Transportation","Pipeline Hazardous Material Safety Admin","1257058","98","1257058","98","0","0","100.0","100.0","null","2024","2","2024","1","03","31"
"2024-03-31","Bureau","Department of Transportation","Research Innovative Technology Admin","3472","4","3472","4","0","0","100.0","100.0","null","2024","2","2024","1","03","31"
"2024-03-31","Bureau","Department of Transportation","St. Lawrence Seaway Development Corp.","7728","2","7728","2","0","0","100.0","100.0","null","2024","2","2024","1","03","31"
"2024-03-31","Agency","Department of Veterans Affairs","null","202699416","3573603","195607841","3568683","7091575","4920","96.50143293950092","99.86232382276374","CFO","2024","2","2024","1","03","31"
"2024-03-31","Bureau","Department of Veterans Affairs","Administration and Cemeteries","5150209","869","788246","318","4361963","551","15.305126452149805","36.59378596087457","null","2024","2","2024","1","03","31"
"2024-03-31","Bureau","Department of Veterans Affairs","Housing Credit Assistance","570298","10","30834","2","539464","8","5.406647051190781","20.0","null","2024","2","2024","1","03","31"
"2024-03-31","Bureau","Department of Veterans Affairs","Life Insurance","1227637","255","1227637","255","0","0","100.0","100.0","null","2024","2","2024","1","03","31"
"2024-03-31","Bureau","Department of Veterans Affairs","Medical and Construction","194524169","3570837","193561124","3568108","963045","2729","99.50492270191886","99.92357534101949","null","2024","2","2024","1","03","31"
"2024-03-31","Bureau","Department of Veterans Affairs","Veterans Benefits","1227103","1632","0","0","1227103","1632","0.0","0.0","null","2024","2","2024","1","03","31"
"2024-03-31","Agency","Department of the Interior","null","80761105","31700","80755153","31636","5952","64","99.9926301156974","99.7981072555205","CFO","2024","2","2024","1","03","31"
"2024-03-31","Bureau","Department of the Interior","Bureau of Indian Affairs","20321798","27571","20315846","27507","5952","64","99.9707112530102","99.76787203946175","null","2024","2","2024","1","03","31"
"2024-03-31","Bureau","Department of the Interior","Bureau of Land Management","8960674","312","8960674","312","0","0","100.0","100.0","null","2024","2","2024","1","03","31"
"2024-03-31","Bureau","Department of the Interior","Bureau of Ocean Energy Mgmt., Reg & Enf","933","1","933","1","0","0","100.0","100.0","null","2024","2","2024","1","03","31"
"2024-03-31","Bureau","Department of the Interior","Bureau of Reclamation","7403974","62","7403974","62","0","0","100.0","100.0","null","2024","2","2024","1","03","31"
"2024-03-31","Bureau","Department of the Interior","Bureau of Safety and Environmental Enf.","14064","2","14064","2","0","0","100.0","100.0","null","2024","2","2024","1","03","31"
"2024-03-31","Bureau","Department of the Interior","Fish and Wildlife Service","817954","90","817954","90","0","0","100.0","100.0","null","2024","2","2024","1","03","31"
"2024-03-31","Bureau","Department of the Interior","Geological Survey","168506","485","168506","485","0","0","100.0","100.0","null","2024","2","2024","1","03","31"
"2024-03-31","Bureau","Department of the Interior","National Park Service","8614602","2048","8614602","2048","0","0","100.0","100.0","null","2024","2","2024","1","03","31"
"2024-03-31","Bureau","Department of the Interior","Office of Natural Resources Revenue","20814336","505","20814336","505","0","0","100.0","100.0","null","2024","2","2024","1","03","31"
"2024-03-31","Bureau","Department of the Interior","Office of Surface Mining","13600391","610","13600391","610","0","0","100.0","100.0","null","2024","2","2024","1","03","31"
"2024-03-31","Bureau","Department of the Interior","Office of the Secretary","43873","14","43873","14","0","0","100.0","100.0","null","2024","2","2024","1","03","31"
"2024-03-31","Agency","Department of the Treasury","null","46442906","4564","45892326","4540","550580","24","98.8145014009244","99.47414548641542","CFO","2024","2","2024","1","03","31"
"2024-03-31","Bureau","Department of the Treasury","Bureau of Engraving and Printing","418575","6","38345","2","380230","4","9.160843337514185","33.333333333333336","null","2024","2","2024","1","03","31"
"2024-03-31","Bureau","Department of the Treasury","Bureau of the Fiscal Service","13676578","3101","13676578","3101","0","0","100.0","100.0","null","2024","2","2024","1","03","31"
"2024-03-31","Bureau","Department of the Treasury","Community Dev Financial Inst Fund","3623095","7","3623095","7","0","0","100.0","100.0","null","2024","2","2024","1","03","31"
"2024-03-31","Bureau","Department of the Treasury","Comptroller of the Currency","1388804","40","1382004","23","6800","17","99.5103700738189","57.5","null","2024","2","2024","1","03","31"
"2024-03-31","Bureau","Department of the Treasury","D.C. Pension Program","864123","16","864123","16","0","0","100.0","100.0","null","2024","2","2024","1","03","31"
"2024-03-31","Bureau","Department of the Treasury","Departmental Offices","20938171","1319","20918166","1318","20005","1","99.90445679328916","99.92418498862774","null","2024","2","2024","1","03","31"
"2024-03-31","Bureau","Department of the Treasury","Financial Crimes Enforcement Network","1544945","3","1544945","3","0","0","100.0","100.0","null","2024","2","2024","1","03","31"
"2024-03-31","Bureau","Department of the Treasury","Interest on Tax/Deposit of Earnings","0","0","0","0","0","0","0.0","0.0","null","2024","2","2024","1","03","31"
"2024-03-31","Bureau","Department of the Treasury","Internal Revenue Service","119803","42","119803","42","0","0","100.0","100.0","null","2024","2","2024","1","03","31"
"2024-03-31","Bureau","Department of the Treasury","International Monetary Funds","0","0","0","0","0","0","0.0","0.0","null","2024","2","2024","1","03","31"
"2024-03-31","Bureau","Department of the Treasury","Office of Financial Research","268","1","268","1","0","0","100.0","100.0","null","2024","2","2024","1","03","31"
"2024-03-31","Bureau","Department of the Treasury","Office of Sec International Affairs","0","0","0","0","0","0","0.0","0.0","null","2024","2","2024","1","03","31"
"2024-03-31","Bureau","Department of the Treasury","Office of the Secretary","0","0","0","0","0","0","0.0","0.0","null","2024","2","2024","1","03","31"
"2024-03-31","Bureau","Department of the Treasury","Pandemic Receivables","3701819","6","3701819","6","0","0","100.0","100.0","null","2024","2","2024","1","03","31"
"2024-03-31","Bureau","Department of the Treasury","Spec Insp Gen-Troubled Asset Rel Prog","0","0","0","0","0","0","0.0","0.0","null","2024","2","2024","1","03","31"
"2024-03-31","Bureau","Department of the Treasury","Tobacco Tax and Trade","1000","1","1000","1","0","0","100.0","100.0","null","2024","2","2024","1","03","31"
"2024-03-31","Bureau","Department of the Treasury","Treasury Forfeiture Fund","0","0","0","0","0","0","0.0","0.0","null","2024","2","2024","1","03","31"
"2024-03-31","Bureau","Department of the Treasury","Treasury Franchise Fund","0","0","0","0","0","0","0.0","0.0","null","2024","2","2024","1","03","31"
"2024-03-31","Bureau","Department of the Treasury","Treasury IG for Tax Admin","64","1","64","1","0","0","100.0","100.0","null","2024","2","2024","1","03","31"
"2024-03-31","Bureau","Department of the Treasury","U.S. Mint","165661","21","22116","19","143545","2","13.350154834269985","90.47619047619048","null","2024","2","2024","1","03","31"
"2024-03-31","Bureau","Department of the Treasury","U.S. Treasury IG Office","0","0","0","0","0","0","0.0","0.0","null","2024","2","2024","1","03","31"
"2024-03-31","Agency","Environmental Protection Agency","null","28612461","249","28612461","249","0","0","100.0","100.0","CFO","2024","2","2024","1","03","31"
"2024-03-31","Bureau","Environmental Protection Agency","Environmental Protection Agency","28612461","249","28612461","249","0","0","100.0","100.0","null","2024","2","2024","1","03","31"
"2024-03-31","Agency","Equal Employment Opportunity Commission","null","24513","22","24513","22","0","0","100.0","100.0","Non-CFO","2024","2","2024","1","03","31"
"2024-03-31","Bureau","Equal Employment Opportunity Commission","Equal Employment Opportunity Commission","24513","22","24513","22","0","0","100.0","100.0","null","2024","2","2024","1","03","31"
"2024-03-31","Agency","Export - Import  Bank","null","0","0","0","0","0","0","0.0","0.0","Non-CFO","2024","2","2024","1","03","31"
"2024-03-31","Bureau","Export - Import  Bank","Export-Import Bank","0","0","0","0","0","0","0.0","0.0","null","2024","2","2024","1","03","31"
"2024-03-31","Agency","Farm Credit Administration","null","630","1","630","1","0","0","100.0","100.0","Non-CFO","2024","2","2024","1","03","31"
"2024-03-31","Bureau","Farm Credit Administration","Farm Credit Administration","630","1","630","1","0","0","100.0","100.0","null","2024","2","2024","1","03","31"
"2024-03-31","Bureau","Farm Credit Administration","Farm Credit System Insurance Corporation","0","0","0","0","0","0","0.0","0.0","null","2024","2","2024","1","03","31"
"2024-03-31","Agency","Federal Communications Commission","null","252531990","12468","252531990","12468","0","0","100.0","100.0","Non-CFO","2024","2","2024","1","03","31"
"2024-03-31","Bureau","Federal Communications Commission","Federal Communications Commission","252531990","12468","252531990","12468","0","0","100.0","100.0","null","2024","2","2024","1","03","31"
"2024-03-31","Agency","Federal Deposit Insurance Corporation","null","0","0","0","0","0","0","0.0","0.0","Non-CFO","2024","2","2024","1","03","31"
"2024-03-31","Bureau","Federal Deposit Insurance Corporation","Federal Deposit Insurance Corporation","0","0","0","0","0","0","0.0","0.0","null","2024","2","2024","1","03","31"
"2024-03-31","Agency","Federal Election Commission","null","2997472","385","2997472","385","0","0","100.0","100.0","Non-CFO","2024","2","2024","1","03","31"
"2024-03-31","Bureau","Federal Election Commission","Federal Election Commission","2997472","385","2997472","385","0","0","100.0","100.0","null","2024","2","2024","1","03","31"
"2024-03-31","Agency","Federal Labor Relations Authority","null","0","0","0","0","0","0","0.0","0.0","Non-CFO","2024","2","2024","1","03","31"
"2024-03-31","Bureau","Federal Labor Relations Authority","Federal Labor Relations Authority","0","0","0","0","0","0","0.0","0.0","null","2024","2","2024","1","03","31"
"2024-03-31","Agency","Federal Maritime Commission","null","466589","7","466589","7","0","0","100.0","100.0","Non-CFO","2024","2","2024","1","03","31"
"2024-03-31","Bureau","Federal Maritime Commission","Salaries and Expenses","466589","7","466589","7","0","0","100.0","100.0","null","2024","2","2024","1","03","31"
"2024-03-31","Agency","Federal Mediation/Conciliation Service","null","0","0","0","0","0","0","0.0","0.0","Non-CFO","2024","2","2024","1","03","31"
"2024-03-31","Bureau","Federal Mediation/Conciliation Service","Federal Mediation/Conciliation Service","0","0","0","0","0","0","0.0","0.0","null","2024","2","2024","1","03","31"
"2024-03-31","Agency","Federal Trade Commission","null","701640302","75","701640302","75","0","0","100.0","100.0","Non-CFO","2024","2","2024","1","03","31"
"2024-03-31","Bureau","Federal Trade Commission","Federal Trade Commission","701640302","75","701640302","75","0","0","100.0","100.0","null","2024","2","2024","1","03","31"
"2024-03-31","Agency","Funds Appropriated to the President","null","1236060","7","0","0","1236060","7","0.0","0.0","Non-CFO","2024","2","2024","1","03","31"
"2024-03-31","Bureau","Funds Appropriated to the President","African Development Foundation","0","0","0","0","0","0","0.0","0.0","null","2024","2","2024","1","03","31"
"2024-03-31","Bureau","Funds Appropriated to the President","Defense Security Assistance Agency","0","0","0","0","0","0","0.0","0.0","null","2024","2","2024","1","03","31"
"2024-03-31","Bureau","Funds Appropriated to the President","Executive Branch","0","0","0","0","0","0","0.0","0.0","null","2024","2","2024","1","03","31"
"2024-03-31","Bureau","Funds Appropriated to the President","Inter-American Foundation","0","0","0","0","0","0","0.0","0.0","null","2024","2","2024","1","03","31"
"2024-03-31","Bureau","Funds Appropriated to the President","Peace Corps","0","0","0","0","0","0","0.0","0.0","null","2024","2","2024","1","03","31"
"2024-03-31","Bureau","Funds Appropriated to the President","Trade and Development Agency","1236060","7","0","0","1236060","7","0.0","0.0","null","2024","2","2024","1","03","31"
"2024-03-31","Agency","General Services Administration","null","10027350","382","10027350","382","0","0","100.0","100.0","CFO","2024","2","2024","1","03","31"
"2024-03-31","Bureau","General Services Administration","General Services Administration","10027350","382","10027350","382","0","0","100.0","100.0","null","2024","2","2024","1","03","31"
"2024-03-31","Agency","Legis Branch-Library of Congress","null","0","0","0","0","0","0","0.0","0.0","Non-CFO","2024","2","2024","1","03","31"
"2024-03-31","Bureau","Legis Branch-Library of Congress","Library of Congress","0","0","0","0","0","0","0.0","0.0","null","2024","2","2024","1","03","31"
"2024-03-31","Agency","Legislative Branch - U.S. House/Senate","null","349877","240","0","0","349877","240","0.0","0.0","Non-CFO","2024","2","2024","1","03","31"
"2024-03-31","Bureau","Legislative Branch - U.S. House/Senate","U.S. House of Representatives","349877","240","0","0","349877","240","0.0","0.0","null","2024","2","2024","1","03","31"
"2024-03-31","Agency","Legislative Branch-CBO","null","0","0","0","0","0","0","0.0","0.0","Non-CFO","2024","2","2024","1","03","31"
"2024-03-31","Bureau","Legislative Branch-CBO","Congressional Budget Office","0","0","0","0","0","0","0.0","0.0","null","2024","2","2024","1","03","31"
"2024-03-31","Agency","Legislative Branch-GAO","null","0","0","0","0","0","0","0.0","0.0","Non-CFO","2024","2","2024","1","03","31"
"2024-03-31","Bureau","Legislative Branch-GAO","Government Accountability Office","0","0","0","0","0","0","0.0","0.0","null","2024","2","2024","1","03","31"
"2024-03-31","Agency","Legislative Branch-GPO","null","0","0","0","0","0","0","0.0","0.0","Non-CFO","2024","2","2024","1","03","31"
"2024-03-31","Bureau","Legislative Branch-GPO","Government Publishing Office","0","0","0","0","0","0","0.0","0.0","null","2024","2","2024","1","03","31"
"2024-03-31","Agency","Legislative Branch-Office of Tech.","null","0","0","0","0","0","0","0.0","0.0","Non-CFO","2024","2","2024","1","03","31"
"2024-03-31","Bureau","Legislative Branch-Office of Tech.","Medicaid & CHIP Payment & Access Comm.","0","0","0","0","0","0","0.0","0.0","null","2024","2","2024","1","03","31"
"2024-03-31","Bureau","Legislative Branch-Office of Tech.","Open World Leadership","0","0","0","0","0","0","0.0","0.0","null","2024","2","2024","1","03","31"
"2024-03-31","Agency","Merit Systems Protection Board","null","144","1","144","1","0","0","100.0","100.0","Non-CFO","2024","2","2024","1","03","31"
"2024-03-31","Bureau","Merit Systems Protection Board","Merit Systems Protection Board","144","1","144","1","0","0","100.0","100.0","null","2024","2","2024","1","03","31"
"2024-03-31","Agency","National Aeronautics and Space Administration","null","1075789","132","1075789","132","0","0","100.0","100.0","CFO","2024","2","2024","1","03","31"
"2024-03-31","Bureau","National Aeronautics and Space Administration","National Aeronautics and Space Admin","1075789","132","1075789","132","0","0","100.0","100.0","null","2024","2","2024","1","03","31"
"2024-03-31","Agency","National Archives & Records Admin","null","114362","93","114282","92","80","1","99.93004669383187","98.9247311827957","Non-CFO","2024","2","2024","1","03","31"
"2024-03-31","Bureau","National Archives & Records Admin","Nat'l Archives & Records Administration","114362","93","114282","92","80","1","99.93004669383187","98.9247311827957","null","2024","2","2024","1","03","31"
"2024-03-31","Agency","National Credit Union Administration","null","1373","2","1373","2","0","0","100.0","100.0","Non-CFO","2024","2","2024","1","03","31"
"2024-03-31","Bureau","National Credit Union Administration","National Credit Union Administration","1373","2","1373","2","0","0","100.0","100.0","null","2024","2","2024","1","03","31"
"2024-03-31","Agency","National Foundation  Arts & Humanities","null","0","0","0","0","0","0","0.0","0.0","Non-CFO","2024","2","2024","1","03","31"
"2024-03-31","Bureau","National Foundation  Arts & Humanities","National Endowment for the Arts","0","0","0","0","0","0","0.0","0.0","null","2024","2","2024","1","03","31"
"2024-03-31","Bureau","National Foundation  Arts & Humanities","National Endowment for the Humanities","0","0","0","0","0","0","0.0","0.0","null","2024","2","2024","1","03","31"
"2024-03-31","Agency","National Labor Relations Board","null","0","0","0","0","0","0","0.0","0.0","Non-CFO","2024","2","2024","1","03","31"
"2024-03-31","Bureau","National Labor Relations Board","National Labor Relations Board","0","0","0","0","0","0","0.0","0.0","null","2024","2","2024","1","03","31"
"2024-03-31","Agency","National Science Foundation","null","719320","29","718684","28","636","1","99.9115831618751","96.55172413793103","CFO","2024","2","2024","1","03","31"
"2024-03-31","Bureau","National Science Foundation","National Science Foundation","719320","29","718684","28","636","1","99.9115831618751","96.55172413793103","null","2024","2","2024","1","03","31"
"2024-03-31","Agency","Neighborhood Reinvestment Corporation","null","0","0","0","0","0","0","0.0","0.0","Non-CFO","2024","2","2024","1","03","31"
"2024-03-31","Bureau","Neighborhood Reinvestment Corporation","Neighborhood Reinvestment Corporation","0","0","0","0","0","0","0.0","0.0","null","2024","2","2024","1","03","31"
"2024-03-31","Agency","Nuclear Regulatory Commission","null","3246047","356","3246047","356","0","0","100.0","100.0","CFO","2024","2","2024","1","03","31"
"2024-03-31","Bureau","Nuclear Regulatory Commission","Nuclear Regulatory Commission","3246047","356","3246047","356","0","0","100.0","100.0","null","2024","2","2024","1","03","31"
"2024-03-31","Agency","Occupational Safety & Health Rev Comm","null","0","0","0","0","0","0","0.0","0.0","Non-CFO","2024","2","2024","1","03","31"
"2024-03-31","Bureau","Occupational Safety & Health Rev Comm","Occupational Safety & Health Rev Comm","0","0","0","0","0","0","0.0","0.0","null","2024","2","2024","1","03","31"
"2024-03-31","Agency","Office of Compliance","null","0","0","0","0","0","0","0.0","0.0","Non-CFO","2024","2","2024","1","03","31"
"2024-03-31","Bureau","Office of Compliance","Office of Compliance","0","0","0","0","0","0","0.0","0.0","null","2024","2","2024","1","03","31"
"2024-03-31","Agency","Office of Government Ethics","null","0","0","0","0","0","0","0.0","0.0","Non-CFO","2024","2","2024","1","03","31"
"2024-03-31","Bureau","Office of Government Ethics","Office of Government Ethics","0","0","0","0","0","0","0.0","0.0","null","2024","2","2024","1","03","31"
"2024-03-31","Agency","Office of Personnel Management","null","15868250","881","15868250","881","0","0","100.0","100.0","CFO","2024","2","2024","1","03","31"
"2024-03-31","Bureau","Office of Personnel Management","Office of Personnel Management","15868250","881","15868250","881","0","0","100.0","100.0","null","2024","2","2024","1","03","31"
"2024-03-31","Agency","Office of Special Counsel","null","0","0","0","0","0","0","0.0","0.0","Non-CFO","2024","2","2024","1","03","31"
"2024-03-31","Bureau","Office of Special Counsel","Office of Special Counsel","0","0","0","0","0","0","0.0","0.0","null","2024","2","2024","1","03","31"
"2024-03-31","Agency","Other Agencies","null","728458","42","511358","6","217100","36","70.19732091623676","14.285714285714286","Non-CFO","2024","2","2024","1","03","31"
"2024-03-31","Bureau","Other Agencies","Advisory Council on Hist. Preservation","0","0","0","0","0","0","0.0","0.0","null","2024","2","2024","1","03","31"
"2024-03-31","Bureau","Other Agencies","Archit.&Trans. Barriers Compliance Bd","0","0","0","0","0","0","0.0","0.0","null","2024","2","2024","1","03","31"
"2024-03-31","Bureau","Other Agencies","Architect of the Capitol","0","0","0","0","0","0","0.0","0.0","null","2024","2","2024","1","03","31"
"2024-03-31","Bureau","Other Agencies","Chemical Safety Board","0","0","0","0","0","0","0.0","0.0","null","2024","2","2024","1","03","31"
"2024-03-31","Bureau","Other Agencies","Comm. for Purchase from Blind/Handic.","0","0","0","0","0","0","0.0","0.0","null","2024","2","2024","1","03","31"
"2024-03-31","Bureau","Other Agencies","Commission On Fine Arts","0","0","0","0","0","0","0.0","0.0","null","2024","2","2024","1","03","31"
"2024-03-31","Bureau","Other Agencies","Consumer Financial Protection Bureau","515888","13","511358","6","4530","7","99.12190242843408","46.15384615384615","null","2024","2","2024","1","03","31"
"2024-03-31","Bureau","Other Agencies","Council of Insps. Gen. of Intg. & Effy.","0","0","0","0","0","0","0.0","0.0","null","2024","2","2024","1","03","31"
"2024-03-31","Bureau","Other Agencies","Defense Nuclear Facilities Safety Board","0","0","0","0","0","0","0.0","0.0","null","2024","2","2024","1","03","31"
"2024-03-31","Bureau","Other Agencies","Delta Regional Authority","0","0","0","0","0","0","0.0","0.0","null","2024","2","2024","1","03","31"
"2024-03-31","Bureau","Other Agencies","Denali Commission","0","0","0","0","0","0","0.0","0.0","null","2024","2","2024","1","03","31"
"2024-03-31","Bureau","Other Agencies","District of Columbia Government","0","0","0","0","0","0","0.0","0.0","null","2024","2","2024","1","03","31"
"2024-03-31","Bureau","Other Agencies","Election Assistance Commission","0","0","0","0","0","0","0.0","0.0","null","2024","2","2024","1","03","31"
"2024-03-31","Bureau","Other Agencies","Federal Housing Finance Agency","0","0","0","0","0","0","0.0","0.0","null","2024","2","2024","1","03","31"
"2024-03-31","Bureau","Other Agencies","Federal Housing Finance Agency OIG","0","0","0","0","0","0","0.0","0.0","null","2024","2","2024","1","03","31"
"2024-03-31","Bureau","Other Agencies","Federal Mine Safety & Health Review Comm","0","0","0","0","0","0","0.0","0.0","null","2024","2","2024","1","03","31"
"2024-03-31","Bureau","Other Agencies","Gulf Coast Ecosystem Restoration Council","0","0","0","0","0","0","0.0","0.0","null","2024","2","2024","1","03","31"
"2024-03-31","Bureau","Other Agencies","James Madison Memorial Fellowship","197397","25","0","0","197397","25","0.0","0.0","null","2024","2","2024","1","03","31"
"2024-03-31","Bureau","Other Agencies","John C. Stennis","6313","2","0","0","6313","2","0.0","0.0","null","2024","2","2024","1","03","31"
"2024-03-31","Bureau","Other Agencies","Millennium Challenge Corporation","0","0","0","0","0","0","0.0","0.0","null","2024","2","2024","1","03","31"
"2024-03-31","Bureau","Other Agencies","Morris K. Udall Scholarship","0","0","0","0","0","0","0.0","0.0","null","2024","2","2024","1","03","31"
"2024-03-31","Bureau","Other Agencies","National Capital Planning Commission","0","0","0","0","0","0","0.0","0.0","null","2024","2","2024","1","03","31"
"2024-03-31","Bureau","Other Agencies","National Council on Disability","0","0","0","0","0","0","0.0","0.0","null","2024","2","2024","1","03","31"
"2024-03-31","Bureau","Other Agencies","National Mediation Board","0","0","0","0","0","0","0.0","0.0","null","2024","2","2024","1","03","31"
"2024-03-31","Bureau","Other Agencies","National Transportation Safety Board","0","0","0","0","0","0","0.0","0.0","null","2024","2","2024","1","03","31"
"2024-03-31","Bureau","Other Agencies","Privacy & Civil Liberties Oversight Bd","0","0","0","0","0","0","0.0","0.0","null","2024","2","2024","1","03","31"
"2024-03-31","Bureau","Other Agencies","Surface Transportation Board","0","0","0","0","0","0","0.0","0.0","null","2024","2","2024","1","03","31"
"2024-03-31","Bureau","Other Agencies","U.S.  Agency of Global Media","0","0","0","0","0","0","0.0","0.0","null","2024","2","2024","1","03","31"
"2024-03-31","Bureau","Other Agencies","U.S. Holocaust Memorial Council","0","0","0","0","0","0","0.0","0.0","null","2024","2","2024","1","03","31"
"2024-03-31","Bureau","Other Agencies","U.S. Inst. for Env. Conflict Resolution","8860","2","0","0","8860","2","0.0","0.0","null","2024","2","2024","1","03","31"
"2024-03-31","Bureau","Other Agencies","U.S. Institute of Peace","0","0","0","0","0","0","0.0","0.0","null","2024","2","2024","1","03","31"
"2024-03-31","Agency","Other Agencies/Boards/Commissions","null","1024","1","0","0","1024","1","0.0","0.0","Non-CFO","2024","2","2024","1","03","31"
"2024-03-31","Bureau","Other Agencies/Boards/Commissions","Medicare Payment Advisory Commission","0","0","0","0","0","0","0.0","0.0","null","2024","2","2024","1","03","31"
"2024-03-31","Bureau","Other Agencies/Boards/Commissions","Nuclear Waste Technical Review Board","0","0","0","0","0","0","0.0","0.0","null","2024","2","2024","1","03","31"
"2024-03-31","Bureau","Other Agencies/Boards/Commissions","U.S. Comm. on Int. Religious Freedom","1024","1","0","0","1024","1","0.0","0.0","null","2024","2","2024","1","03","31"
"2024-03-31","Bureau","Other Agencies/Boards/Commissions","U.S.-China Security Review Commission","0","0","0","0","0","0","0.0","0.0","null","2024","2","2024","1","03","31"
"2024-03-31","Agency","Pension Benefit Guaranty Corp","null","4818938","1601","4818938","1601","0","0","100.0","100.0","Non-CFO","2024","2","2024","1","03","31"
"2024-03-31","Bureau","Pension Benefit Guaranty Corp","Pension Benefit Guaranty Corporation","4818938","1601","4818938","1601","0","0","100.0","100.0","null","2024","2","2024","1","03","31"
"2024-03-31","Agency","Presidio Trust Corporation","null","1343620","60","1343620","60","0","0","100.0","100.0","Non-CFO","2024","2","2024","1","03","31"
"2024-03-31","Bureau","Presidio Trust Corporation","Presidio Trust Corporation","1343620","60","1343620","60","0","0","100.0","100.0","null","2024","2","2024","1","03","31"
"2024-03-31","Agency","Railroad Retirement Board","null","24878995","2449","24878995","2449","0","0","100.0","100.0","Non-CFO","2024","2","2024","1","03","31"
"2024-03-31","Bureau","Railroad Retirement Board","Railroad Retirement Board","24878995","2449","24878995","2449","0","0","100.0","100.0","null","2024","2","2024","1","03","31"
"2024-03-31","Agency","Securities & Exchange Commission","null","3127384644","1704","3127384644","1704","0","0","100.0","100.0","Non-CFO","2024","2","2024","1","03","31"
"2024-03-31","Bureau","Securities & Exchange Commission","SEC Enforcement","3127127944","1660","3127127944","1660","0","0","100.0","100.0","null","2024","2","2024","1","03","31"
"2024-03-31","Bureau","Securities & Exchange Commission","Securities and Exchange Commission","256700","44","256700","44","0","0","100.0","100.0","null","2024","2","2024","1","03","31"
"2024-03-31","Agency","Selective Service System","null","1301","2","0","0","1301","2","0.0","0.0","Non-CFO","2024","2","2024","1","03","31"
"2024-03-31","Bureau","Selective Service System","Selective Service System","1301","2","0","0","1301","2","0.0","0.0","null","2024","2","2024","1","03","31"
"2024-03-31","Agency","Small Business Administration","null","57217803197","771093","57217803197","771093","0","0","100.0","100.0","CFO","2024","2","2024","1","03","31"
"2024-03-31","Bureau","Small Business Administration","Small Business Administration","57217803197","771093","57217803197","771093","0","0","100.0","100.0","null","2024","2","2024","1","03","31"
"2024-03-31","Agency","Smithsonian Institution","null","8262","21","0","0","8262","21","0.0","0.0","Non-CFO","2024","2","2024","1","03","31"
"2024-03-31","Bureau","Smithsonian Institution","Administrative Conference of the US","0","0","0","0","0","0","0.0","0.0","null","2024","2","2024","1","03","31"
"2024-03-31","Bureau","Smithsonian Institution","JFK Center for the Performing Arts","0","0","0","0","0","0","0.0","0.0","null","2024","2","2024","1","03","31"
"2024-03-31","Bureau","Smithsonian Institution","National Gallery of Art","0","0","0","0","0","0","0.0","0.0","null","2024","2","2024","1","03","31"
"2024-03-31","Bureau","Smithsonian Institution","Smithsonian Institution","8262","21","0","0","8262","21","0.0","0.0","null","2024","2","2024","1","03","31"
"2024-03-31","Agency","Social Security Administration","null","4286940597","1322221","2343022627","399444","1943917970","922777","54.65488905163852","30.210078345450572","CFO","2024","2","2024","1","03","31"
"2024-03-31","Bureau","Social Security Administration","Social Security Administration","4286940597","1322221","2343022627","399444","1943917970","922777","54.65488905163852","30.210078345450572","null","2024","2","2024","1","03","31"
"2024-03-31","Agency","Tennessee Valley Authority","null","0","0","0","0","0","0","0.0","0.0","Non-CFO","2024","2","2024","1","03","31"
"2024-03-31","Bureau","Tennessee Valley Authority","Tennessee Valley Authority","0","0","0","0","0","0","0.0","0.0","null","2024","2","2024","1","03","31"
"2024-03-31","Agency","The Judiciary","null","1047036","309","1035041","179","11995","130","98.85438514053003","57.92880258899677","Non-CFO","2024","2","2024","1","03","31"
"2024-03-31","Bureau","The Judiciary","Administrative Office of the U.S. Courts","1047036","309","1035041","179","11995","130","98.85438514053003","57.92880258899677","null","2024","2","2024","1","03","31"
"2024-03-31","Agency","U.S. Court of Appeals / Veterans Claims","null","0","0","0","0","0","0","0.0","0.0","Non-CFO","2024","2","2024","1","03","31"
"2024-03-31","Bureau","U.S. Court of Appeals / Veterans Claims","U.S. Court of Appeals / Veterans Claims","0","0","0","0","0","0","0.0","0.0","null","2024","2","2024","1","03","31"
"2024-03-31","Agency","U.S. Postal Service","null","81796823","77887","70514955","68901","11281868","8986","86.20744964630228","88.46277299164174","Non-CFO","2024","2","2024","1","03","31"
"2024-03-31","Bureau","U.S. Postal Service","U.S. Postal Service","81796823","77887","70514955","68901","11281868","8986","86.20744964630228","88.46277299164174","null","2024","2","2024","1","03","31"
"2024-03-31","Agency","U.S. Tax Court","null","0","0","0","0","0","0","0.0","0.0","Non-CFO","2024","2","2024","1","03","31"
"2024-03-31","Bureau","U.S. Tax Court","U.S. Tax Court","0","0","0","0","0","0","0.0","0.0","null","2024","2","2024","1","03","31"
"2024-03-31","Agency","US International Development Fin. Corp.","null","0","0","0","0","0","0","0.0","0.0","Non-CFO","2024","2","2024","1","03","31"
"2024-03-31","Bureau","US International Development Fin. Corp.","US International Development Fin. Corp.","0","0","0","0","0","0","0.0","0.0","null","2024","2","2024","1","03","31"
"2023-12-31","Agency","Agency for International Development","null","28413237","55","28412964","54","273","1","99.99903918022434","98.18181818181819","CFO","2024","1","2023","4","12","31"
"2023-12-31","Bureau","Agency for International Development","Agency for International Development","28413237","55","28412964","54","273","1","99.99903918022434","98.18181818181819","null","2024","1","2023","4","12","31"
"2023-12-31","Agency","American Battle Monuments Commission","null","0","0","0","0","0","0","0.0","0.0","Non-CFO","2024","1","2023","4","12","31"
"2023-12-31","Bureau","American Battle Monuments Commission","American Battle Monuments Commission","0","0","0","0","0","0","0.0","0.0","null","2024","1","2023","4","12","31"
"2023-12-31","Agency","Armed Forces Retirement Home","null","108955","95","75785","94","33170","1","69.55623881418934","98.94736842105263","Non-CFO","2024","1","2023","4","12","31"
"2023-12-31","Bureau","Armed Forces Retirement Home","Armed Forces Retirement Home","108955","95","75785","94","33170","1","69.55623881418934","98.94736842105263","null","2024","1","2023","4","12","31"
"2023-12-31","Agency","Commodity Futures Trading Commission","null","632255040","360","632255040","360","0","0","100.0","100.0","Non-CFO","2024","1","2023","4","12","31"
"2023-12-31","Bureau","Commodity Futures Trading Commission","Commodity Futures Trading Commission","632255040","360","632255040","360","0","0","100.0","100.0","null","2024","1","2023","4","12","31"
"2023-12-31","Agency","Consumer Product Safety Commission","null","413","9","413","9","0","0","100.0","100.0","Non-CFO","2024","1","2023","4","12","31"
"2023-12-31","Bureau","Consumer Product Safety Commission","Consumer Product Safety Commission","413","9","413","9","0","0","100.0","100.0","null","2024","1","2023","4","12","31"
"2023-12-31","Agency","Corp. for National and Community Service","null","4090345","339","3602899","148","487446","191","88.08301011283889","43.657817109144545","Non-CFO","2024","1","2023","4","12","31"
"2023-12-31","Bureau","Corp. for National and Community Service","Corp. for National and Community Service","4090345","339","3602899","148","487446","191","88.08301011283889","43.657817109144545","null","2024","1","2023","4","12","31"
"2023-12-31","Agency","Department of Agriculture","null","1309817548","54336","1294478886","51797","15338662","2539","98.82894667097558","95.32722320376914","CFO","2024","1","2023","4","12","31"
"2023-12-31","Bureau","Department of Agriculture","Agricultural Marketing Service","5244306","1789","3741270","1186","1503036","603","71.33965866980301","66.29401900503075","null","2024","1","2023","4","12","31"
"2023-12-31","Bureau","Department of Agriculture","Commodity Credit Corporation","120531281","8977","120531281","8977","0","0","100.0","100.0","null","2024","1","2023","4","12","31"
"2023-12-31","Bureau","Department of Agriculture","Farm Service Agency","164243781","9623","164243781","9623","0","0","100.0","100.0","null","2024","1","2023","4","12","31"
"2023-12-31","Bureau","Department of Agriculture","Federal Crop Insurance Corporation","7807","6","7807","6","0","0","100.0","100.0","null","2024","1","2023","4","12","31"
"2023-12-31","Bureau","Department of Agriculture","Food Safety and Inspection Service","1668040","2129","1614802","2078","53238","51","96.8083499196662","97.60450915922968","null","2024","1","2023","4","12","31"
"2023-12-31","Bureau","Department of Agriculture","Food and Nutrition Service","5364595","96","38643","15","5325952","81","0.7203339674290417","15.625","null","2024","1","2023","4","12","31"
"2023-12-31","Bureau","Department of Agriculture","Forest Service","75848428","689","71058575","414","4789853","275","93.68496734039103","60.087082728592165","null","2024","1","2023","4","12","31"
"2023-12-31","Bureau","Department of Agriculture","Rural Development","913836980","27164","913829500","27156","7480","8","99.99918147326451","99.97054925636873","null","2024","1","2023","4","12","31"
"2023-12-31","Bureau","Department of Agriculture","U.S. Department of Agriculture","23072330","3863","19413227","2342","3659103","1521","84.14073047672255","60.626456122184834","null","2024","1","2023","4","12","31"
"2023-12-31","Agency","Department of Commerce","null","59036810","7982","59036810","7982","0","0","100.0","100.0","CFO","2024","1","2023","4","12","31"
"2023-12-31","Bureau","Department of Commerce","Bureau of Industry and Security","37546041","27","37546041","27","0","0","100.0","100.0","null","2024","1","2023","4","12","31"
"2023-12-31","Bureau","Department of Commerce","Bureau of the Census","2071882","6275","2071882","6275","0","0","100.0","100.0","null","2024","1","2023","4","12","31"
"2023-12-31","Bureau","Department of Commerce","Economic Development Administration","5120584","11","5120584","11","0","0","100.0","100.0","null","2024","1","2023","4","12","31"
"2023-12-31","Bureau","Department of Commerce","Economic and Statistical Analysis","0","0","0","0","0","0","0.0","0.0","null","2024","1","2023","4","12","31"
"2023-12-31","Bureau","Department of Commerce","General Administration","0","0","0","0","0","0","0.0","0.0","null","2024","1","2023","4","12","31"
"2023-12-31","Bureau","Department of Commerce","International Trade Administration","0","0","0","0","0","0","0.0","0.0","null","2024","1","2023","4","12","31"
"2023-12-31","Bureau","Department of Commerce","Minority Business Development Agency","0","0","0","0","0","0","0.0","0.0","null","2024","1","2023","4","12","31"
"2023-12-31","Bureau","Department of Commerce","NOAA","12517698","814","12517698","814","0","0","100.0","100.0","null","2024","1","2023","4","12","31"
"2023-12-31","Bureau","Department of Commerce","Nat'l Institute of Standards& Technology","992235","3","992235","3","0","0","100.0","100.0","null","2024","1","2023","4","12","31"
"2023-12-31","Bureau","Department of Commerce","Nat'l Telecomm & Information Admin.","296092","1","296092","1","0","0","100.0","100.0","null","2024","1","2023","4","12","31"
"2023-12-31","Bureau","Department of Commerce","National Technical Information Service","0","0","0","0","0","0","0.0","0.0","null","2024","1","2023","4","12","31"
"2023-12-31","Bureau","Department of Commerce","Office of the Inspector General","0","0","0","0","0","0","0.0","0.0","null","2024","1","2023","4","12","31"
"2023-12-31","Bureau","Department of Commerce","Patent and Trademark Office","492278","851","492278","851","0","0","100.0","100.0","null","2024","1","2023","4","12","31"
"2023-12-31","Agency","Department of Defense","null","2948774967","1692265","1094164109","301533","1854610858","1390732","37.1057175011619","17.818308598239636","CFO","2024","1","2023","4","12","31"
"2023-12-31","Bureau","Department of Defense","Consolidated Report","2948774967","1692265","1094164109","301533","1854610858","1390732","37.1057175011619","17.818308598239636","null","2024","1","2023","4","12","31"
"2023-12-31","Agency","Department of Education","null","116375366443","20143062","112964237421","19460230","3411129022","682832","97.06885647172527","96.61008837683168","CFO","2024","1","2023","4","12","31"
"2023-12-31","Bureau","Department of Education","Departmental Management","1477225691","2061","1471566855","1973","5658836","88","99.61692813532309","95.73022804463852","null","2024","1","2023","4","12","31"
"2023-12-31","Bureau","Department of Education","Federal Student Aid","114898140752","20141001","111492670566","19458257","3405470186","682744","97.03609635133219","96.61017841168868","null","2024","1","2023","4","12","31"
"2023-12-31","Bureau","Department of Education","Office of Postsecondary Education","0","0","0","0","0","0","0.0","0.0","null","2024","1","2023","4","12","31"
"2023-12-31","Agency","Department of Energy","null","14421542","104","14421542","104","0","0","100.0","100.0","CFO","2024","1","2023","4","12","31"
"2023-12-31","Bureau","Department of Energy","Bonneville Power Administration","1720488","32","1720488","32","0","0","100.0","100.0","null","2024","1","2023","4","12","31"
"2023-12-31","Bureau","Department of Energy","Energy Consolidated Reports","12701054","72","12701054","72","0","0","100.0","100.0","null","2024","1","2023","4","12","31"
"2023-12-31","Agency","Department of Health & Human Services","null","6218583605","1108675","5948182027","1077185","270401578","31490","95.65171757468073","97.15967258213634","CFO","2024","1","2023","4","12","31"
"2023-12-31","Bureau","Department of Health & Human Services","Administration for Children and Families","40532632","1726","40532632","1726","0","0","100.0","100.0","null","2024","1","2023","4","12","31"
"2023-12-31","Bureau","Department of Health & Human Services","Administration for Community Living","0","0","0","0","0","0","0.0","0.0","null","2024","1","2023","4","12","31"
"2023-12-31","Bureau","Department of Health & Human Services","Agency for Healthcare Research & Quality","0","0","0","0","0","0","0.0","0.0","null","2024","1","2023","4","12","31"
"2023-12-31","Bureau","Department of Health & Human Services","Centers for Disease Control","6553584","120","958972","21","5594612","99","14.63278718942185","17.5","null","2024","1","2023","4","12","31"
"2023-12-31","Bureau","Department of Health & Human Services","Centers for Medicare & Medicaid Services","5749035697","1079791","5637853029","1068268","111182668","11523","98.06606405213282","98.93284904208315","null","2024","1","2023","4","12","31"
"2023-12-31","Bureau","Department of Health & Human Services","Food and Drug Administration","191758449","21615","55189251","2148","136569198","19467","28.78060981813636","9.937543372657876","null","2024","1","2023","4","12","31"
"2023-12-31","Bureau","Department of Health & Human Services","Health Resources and Services Admin","127766083","709","127766083","709","0","0","100.0","100.0","null","2024","1","2023","4","12","31"
"2023-12-31","Bureau","Department of Health & Human Services","Indian Health Services","58200952","3364","58200952","3364","0","0","100.0","100.0","null","2024","1","2023","4","12","31"
"2023-12-31","Bureau","Department of Health & Human Services","National Institutes of Health","25324564","548","8269464","147","17055100","401","32.653924466379756","26.824817518248175","null","2024","1","2023","4","12","31"
"2023-12-31","Bureau","Department of Health & Human Services","Office of the Inspector General","33600","1","33600","1","0","0","100.0","100.0","null","2024","1","2023","4","12","31"
"2023-12-31","Bureau","Department of Health & Human Services","Office of the Secretary","11751654","538","11751654","538","0","0","100.0","100.0","null","2024","1","2023","4","12","31"
"2023-12-31","Bureau","Department of Health & Human Services","Program Support Center","6541890","253","6541890","253","0","0","100.0","100.0","null","2024","1","2023","4","12","31"
"2023-12-31","Bureau","Department of Health & Human Services","Substance Abuse & Mental Health Admin.","1084500","10","1084500","10","0","0","100.0","100.0","null","2024","1","2023","4","12","31"
"2023-12-31","Agency","Department of Homeland Security","null","307382051","122231","278951845","74220","28430206","48011","90.75085682215062","60.721093666909375","CFO","2024","1","2023","4","12","31"
"2023-12-31","Bureau","Department of Homeland Security","Bureau of Customs & Border Protection","9413643","888","9413643","888","0","0","100.0","100.0","null","2024","1","2023","4","12","31"
"2023-12-31","Bureau","Department of Homeland Security","Citizenship and Immigration Services","1188817","1458","1188817","1458","0","0","100.0","100.0","null","2024","1","2023","4","12","31"
"2023-12-31","Bureau","Department of Homeland Security","Domestic Nuclear Detection Office","4321","24","0","0","4321","24","0.0","0.0","null","2024","1","2023","4","12","31"
"2023-12-31","Bureau","Department of Homeland Security","Emergency Preparedness & Resp","220110221","45298","220110221","45298","0","0","100.0","100.0","null","2024","1","2023","4","12","31"
"2023-12-31","Bureau","Department of Homeland Security","Federal Law Enforcement Training Ctr.","8562","1","8562","1","0","0","100.0","100.0","null","2024","1","2023","4","12","31"
"2023-12-31","Bureau","Department of Homeland Security","Immigration and Customs Enforcement","17000209","673","17000209","673","0","0","100.0","100.0","null","2024","1","2023","4","12","31"
"2023-12-31","Bureau","Department of Homeland Security","Info Analysis Infrastructure Prot-NPPD","0","0","0","0","0","0","0.0","0.0","null","2024","1","2023","4","12","31"
"2023-12-31","Bureau","Department of Homeland Security","Management Headquarters","0","0","0","0","0","0","0.0","0.0","null","2024","1","2023","4","12","31"
"2023-12-31","Bureau","Department of Homeland Security","Office of Biometric Identity Management","0","0","0","0","0","0","0.0","0.0","null","2024","1","2023","4","12","31"
"2023-12-31","Bureau","Department of Homeland Security","Office of the Inspector General DHS","0","0","0","0","0","0","0.0","0.0","null","2024","1","2023","4","12","31"
"2023-12-31","Bureau","Department of Homeland Security","Science and Technology","0","0","0","0","0","0","0.0","0.0","null","2024","1","2023","4","12","31"
"2023-12-31","Bureau","Department of Homeland Security","Transportation Safety Administration","30015734","24501","30015734","24501","0","0","100.0","100.0","null","2024","1","2023","4","12","31"
"2023-12-31","Bureau","Department of Homeland Security","U.S. Coast Guard","29640544","49388","1214659","1401","28425885","47987","4.0979645987604005","2.8367214708026243","null","2024","1","2023","4","12","31"
"2023-12-31","Bureau","Department of Homeland Security","U.S. Secret Service","0","0","0","0","0","0","0.0","0.0","null","2024","1","2023","4","12","31"
"2023-12-31","Agency","Department of Housing and Urban Development","null","70357079","2882","70186290","2878","170789","4","99.75725399287825","99.86120749479528","CFO","2024","1","2023","4","12","31"
"2023-12-31","Bureau","Department of Housing and Urban Development","Community Planning and Development","102215","1","102215","1","0","0","100.0","100.0","null","2024","1","2023","4","12","31"
"2023-12-31","Bureau","Department of Housing and Urban Development","Government National Mortgage Association","148564","1","0","0","148564","1","0.0","0.0","null","2024","1","2023","4","12","31"
"2023-12-31","Bureau","Department of Housing and Urban Development","Housing Programs","70096066","2876","70073841","2873","22225","3","99.96829351307676","99.89568845618915","null","2024","1","2023","4","12","31"
"2023-12-31","Bureau","Department of Housing and Urban Development","Management and Administration","9981","2","9981","2","0","0","100.0","100.0","null","2024","1","2023","4","12","31"
"2023-12-31","Bureau","Department of Housing and Urban Development","Policy, Development and Research","0","0","0","0","0","0","0.0","0.0","null","2024","1","2023","4","12","31"
"2023-12-31","Bureau","Department of Housing and Urban Development","Public and Indian Housing Programs","253","2","253","2","0","0","100.0","100.0","null","2024","1","2023","4","12","31"
"2023-12-31","Agency","Department of Justice","null","92087543","39651","90230465","39087","1857078","564","97.98335590298028","98.57758946810925","CFO","2024","1","2023","4","12","31"
"2023-12-31","Bureau","Department of Justice","Bureau of ATF and Explosives","19881","1","19881","1","0","0","100.0","100.0","null","2024","1","2023","4","12","31"
"2023-12-31","Bureau","Department of Justice","Drug Enforcement Administration","337050","15","337050","15","0","0","100.0","100.0","null","2024","1","2023","4","12","31"
"2023-12-31","Bureau","Department of Justice","Federal Bureau of Investigation","467885","104","467885","104","0","0","100.0","100.0","null","2024","1","2023","4","12","31"
"2023-12-31","Bureau","Department of Justice","Federal Prison Industries","109248","127","0","0","109248","127","0.0","0.0","null","2024","1","2023","4","12","31"
"2023-12-31","Bureau","Department of Justice","Federal Prison System","0","0","0","0","0","0","0.0","0.0","null","2024","1","2023","4","12","31"
"2023-12-31","Bureau","Department of Justice","General Administration","0","0","0","0","0","0","0.0","0.0","null","2024","1","2023","4","12","31"
"2023-12-31","Bureau","Department of Justice","Legal Activities","90725233","39395","88986733","38964","1738500","431","98.0837745547592","98.90595253204721","null","2024","1","2023","4","12","31"
"2023-12-31","Bureau","Department of Justice","Office of Justice Assistance Programs","418916","3","418916","3","0","0","100.0","100.0","null","2024","1","2023","4","12","31"
"2023-12-31","Bureau","Department of Justice","U.S. Marshals Service","9330","6","0","0","9330","6","0.0","0.0","null","2024","1","2023","4","12","31"
"2023-12-31","Agency","Department of Labor","null","164405418","15575","142767376","10204","21638042","5371","86.83860771547079","65.51524879614767","CFO","2024","1","2023","4","12","31"
"2023-12-31","Bureau","Department of Labor","Bureau of Labor Statistics","4782","1","4782","1","0","0","100.0","100.0","null","2024","1","2023","4","12","31"
"2023-12-31","Bureau","Department of Labor","Departmental Management","135201","163","0","0","135201","163","0.0","0.0","null","2024","1","2023","4","12","31"
"2023-12-31","Bureau","Department of Labor","Employee Benefit Security Administration","21183238","471","21183238","471","0","0","100.0","100.0","null","2024","1","2023","4","12","31"
"2023-12-31","Bureau","Department of Labor","Employment Standards Administration","68216130","6697","57235798","2563","10980332","4134","83.90361341225308","38.27086755263551","null","2024","1","2023","4","12","31"
"2023-12-31","Bureau","Department of Labor","Employment and Training Administration","1257938","11","1257938","11","0","0","100.0","100.0","null","2024","1","2023","4","12","31"
"2023-12-31","Bureau","Department of Labor","Mine Safety and Health Administration","12166493","4253","9427645","3947","2738848","306","77.48859922082724","92.80507876792852","null","2024","1","2023","4","12","31"
"2023-12-31","Bureau","Department of Labor","Occupational Safety and Health Admin","61441636","3979","53657975","3211","7783661","768","87.33161825313375","80.69866800703694","null","2024","1","2023","4","12","31"
"2023-12-31","Agency","Department of State","null","22842745","21070","22650774","20908","191971","162","99.15959750021287","99.2311343141908","CFO","2024","1","2023","4","12","31"
"2023-12-31","Bureau","Department of State","Department of State","21117231","9924","20925260","9762","191971","162","99.09092721484176","98.36759371221282","null","2024","1","2023","4","12","31"
"2023-12-31","Bureau","Department of State","International Commissions","0","0","0","0","0","0","0.0","0.0","null","2024","1","2023","4","12","31"
"2023-12-31","Bureau","Department of State","Passport NSF","1725514","11146","1725514","11146","0","0","100.0","100.0","null","2024","1","2023","4","12","31"
"2023-12-31","Agency","Department of Transportation","null","85897013","9365","85890113","9361","6900","4","99.99196712463097","99.9572877736252","CFO","2024","1","2023","4","12","31"
"2023-12-31","Bureau","Department of Transportation","Federal Aviation Administration","4420950","532","4420950","532","0","0","100.0","100.0","null","2024","1","2023","4","12","31"
"2023-12-31","Bureau","Department of Transportation","Federal Highway Administration","11103","9","11103","9","0","0","100.0","100.0","null","2024","1","2023","4","12","31"
"2023-12-31","Bureau","Department of Transportation","Federal Motor Carrier Safety Admin","77790845","8665","77783945","8661","6900","4","99.99113006164157","99.95383727639931","null","2024","1","2023","4","12","31"
"2023-12-31","Bureau","Department of Transportation","Federal Railroad Administration","146063","12","146063","12","0","0","100.0","100.0","null","2024","1","2023","4","12","31"
"2023-12-31","Bureau","Department of Transportation","Federal Transit Administration","783404","1","783404","1","0","0","100.0","100.0","null","2024","1","2023","4","12","31"
"2023-12-31","Bureau","Department of Transportation","Maritime Administration","304111","19","304111","19","0","0","100.0","100.0","null","2024","1","2023","4","12","31"
"2023-12-31","Bureau","Department of Transportation","National Highway Traffic Safety Admin.","26711","4","26711","4","0","0","100.0","100.0","null","2024","1","2023","4","12","31"
"2023-12-31","Bureau","Department of Transportation","Office of the Inspector General","3380","1","3380","1","0","0","100.0","100.0","null","2024","1","2023","4","12","31"
"2023-12-31","Bureau","Department of Transportation","Office of the Secretary","1148207","15","1148207","15","0","0","100.0","100.0","null","2024","1","2023","4","12","31"
"2023-12-31","Bureau","Department of Transportation","Pipeline Hazardous Material Safety Admin","1227189","97","1227189","97","0","0","100.0","100.0","null","2024","1","2023","4","12","31"
"2023-12-31","Bureau","Department of Transportation","Research Innovative Technology Admin","27322","8","27322","8","0","0","100.0","100.0","null","2024","1","2023","4","12","31"
"2023-12-31","Bureau","Department of Transportation","St. Lawrence Seaway Development Corp.","7728","2","7728","2","0","0","100.0","100.0","null","2024","1","2023","4","12","31"
"2023-12-31","Agency","Department of Veterans Affairs","null","271895877","2112244","151238327","2023077","120657550","89167","55.62361911063477","95.7785653551389","CFO","2024","1","2023","4","12","31"
"2023-12-31","Bureau","Department of Veterans Affairs","Administration and Cemeteries","5935457","705","238254","284","5697203","421","4.014080128960583","40.283687943262414","null","2024","1","2023","4","12","31"
"2023-12-31","Bureau","Department of Veterans Affairs","Housing Credit Assistance","1006506","30","31564","2","974942","28","3.135997202202471","6.666666666666667","null","2024","1","2023","4","12","31"
"2023-12-31","Bureau","Department of Veterans Affairs","Life Insurance","1233113","257","1233113","257","0","0","100.0","100.0","null","2024","1","2023","4","12","31"
"2023-12-31","Bureau","Department of Veterans Affairs","Medical and Construction","150544019","2025054","149735396","2022534","808623","2520","99.46286607374286","99.87555887398558","null","2024","1","2023","4","12","31"
"2023-12-31","Bureau","Department of Veterans Affairs","Veterans Benefits","113176782","86198","0","0","113176782","86198","0.0","0.0","null","2024","1","2023","4","12","31"
"2023-12-31","Agency","Department of the Interior","null","92190181","33081","92185910","33028","4271","53","99.99536718557913","99.83978718902088","CFO","2024","1","2023","4","12","31"
"2023-12-31","Bureau","Department of the Interior","Bureau of Indian Affairs","29262580","29179","29258310","29126","4270","53","99.98540798521525","99.81836252099113","null","2024","1","2023","4","12","31"
"2023-12-31","Bureau","Department of the Interior","Bureau of Land Management","9044071","347","9044071","347","0","0","100.0","100.0","null","2024","1","2023","4","12","31"
"2023-12-31","Bureau","Department of the Interior","Bureau of Ocean Energy Mgmt., Reg & Enf","1333","1","1333","1","0","0","100.0","100.0","null","2024","1","2023","4","12","31"
"2023-12-31","Bureau","Department of the Interior","Bureau of Reclamation","7391411","64","7391411","64","0","0","100.0","100.0","null","2024","1","2023","4","12","31"
"2023-12-31","Bureau","Department of the Interior","Bureau of Safety and Environmental Enf.","14064","2","14064","2","0","0","100.0","100.0","null","2024","1","2023","4","12","31"
"2023-12-31","Bureau","Department of the Interior","Fish and Wildlife Service","807789","98","807789","98","0","0","100.0","100.0","null","2024","1","2023","4","12","31"
"2023-12-31","Bureau","Department of the Interior","Geological Survey","149827","453","149827","453","0","0","100.0","100.0","null","2024","1","2023","4","12","31"
"2023-12-31","Bureau","Department of the Interior","National Park Service","8558522","1974","8558522","1974","0","0","100.0","100.0","null","2024","1","2023","4","12","31"
"2023-12-31","Bureau","Department of the Interior","Office of Natural Resources Revenue","27915764","548","27915764","548","0","0","100.0","100.0","null","2024","1","2023","4","12","31"
"2023-12-31","Bureau","Department of the Interior","Office of Surface Mining","9022540","402","9022539","402","1","0","99.99998891664653","100.0","null","2024","1","2023","4","12","31"
"2023-12-31","Bureau","Department of the Interior","Office of the Secretary","22280","13","22280","13","0","0","100.0","100.0","null","2024","1","2023","4","12","31"
"2023-12-31","Agency","Department of the Treasury","null","46827394","4685","46298149","4671","529245","14","98.86979617101905","99.70117395944504","CFO","2024","1","2023","4","12","31"
"2023-12-31","Bureau","Department of the Treasury","Bureau of Engraving and Printing","360275","4","0","0","360275","4","0.0","0.0","null","2024","1","2023","4","12","31"
"2023-12-31","Bureau","Department of the Treasury","Bureau of the Fiscal Service","13531024","3231","13531024","3231","0","0","100.0","100.0","null","2024","1","2023","4","12","31"
"2023-12-31","Bureau","Department of the Treasury","Community Dev Financial Inst Fund","3623095","7","3623095","7","0","0","100.0","100.0","null","2024","1","2023","4","12","31"
"2023-12-31","Bureau","Department of the Treasury","Comptroller of the Currency","1395649","25","1392107","21","3542","4","99.74621126085427","84.0","null","2024","1","2023","4","12","31"
"2023-12-31","Bureau","Department of the Treasury","D.C. Pension Program","1504438","21","1504438","21","0","0","100.0","100.0","null","2024","1","2023","4","12","31"
"2023-12-31","Bureau","Department of the Treasury","Departmental Offices","20955124","1323","20934901","1321","20223","2","99.9034937707837","99.848828420257","null","2024","1","2023","4","12","31"
"2023-12-31","Bureau","Department of the Treasury","Financial Crimes Enforcement Network","1544945","3","1544945","3","0","0","100.0","100.0","null","2024","1","2023","4","12","31"
"2023-12-31","Bureau","Department of the Treasury","Interest on Tax/Deposit of Earnings","0","0","0","0","0","0","0.0","0.0","null","2024","1","2023","4","12","31"
"2023-12-31","Bureau","Department of the Treasury","Internal Revenue Service","38820","38","38820","38","0","0","100.0","100.0","null","2024","1","2023","4","12","31"
"2023-12-31","Bureau","Department of the Treasury","International Monetary Funds","0","0","0","0","0","0","0.0","0.0","null","2024","1","2023","4","12","31"
"2023-12-31","Bureau","Department of the Treasury","Office of Financial Research","521","2","268","1","253","1","51.43953934740883","50.0","null","2024","1","2023","4","12","31"
"2023-12-31","Bureau","Department of the Treasury","Office of Sec International Affairs","0","0","0","0","0","0","0.0","0.0","null","2024","1","2023","4","12","31"
"2023-12-31","Bureau","Department of the Treasury","Office of the Secretary","0","0","0","0","0","0","0.0","0.0","null","2024","1","2023","4","12","31"
"2023-12-31","Bureau","Department of the Treasury","Pandemic Receivables","3701819","6","3701819","6","0","0","100.0","100.0","null","2024","1","2023","4","12","31"
"2023-12-31","Bureau","Department of the Treasury","Spec Insp Gen-Troubled Asset Rel Prog","3916","1","3916","1","0","0","100.0","100.0","null","2024","1","2023","4","12","31"
"2023-12-31","Bureau","Department of the Treasury","Tobacco Tax and Trade","1000","1","1000","1","0","0","100.0","100.0","null","2024","1","2023","4","12","31"
"2023-12-31","Bureau","Department of the Treasury","Treasury Forfeiture Fund","0","0","0","0","0","0","0.0","0.0","null","2024","1","2023","4","12","31"
"2023-12-31","Bureau","Department of the Treasury","Treasury Franchise Fund","0","0","0","0","0","0","0.0","0.0","null","2024","1","2023","4","12","31"
"2023-12-31","Bureau","Department of the Treasury","Treasury IG for Tax Admin","267","2","267","2","0","0","100.0","100.0","null","2024","1","2023","4","12","31"
"2023-12-31","Bureau","Department of the Treasury","U.S. Mint","166501","21","21549","18","144952","3","12.942264611023358","85.71428571428571","null","2024","1","2023","4","12","31"
"2023-12-31","Bureau","Department of the Treasury","U.S. Treasury IG Office","0","0","0","0","0","0","0.0","0.0","null","2024","1","2023","4","12","31"
"2023-12-31","Agency","Environmental Protection Agency","null","28420411","248","28413732","246","6679","2","99.97649928426439","99.19354838709677","CFO","2024","1","2023","4","12","31"
"2023-12-31","Bureau","Environmental Protection Agency","Environmental Protection Agency","28420411","248","28413732","246","6679","2","99.97649928426439","99.19354838709677","null","2024","1","2023","4","12","31"
"2023-12-31","Agency","Equal Employment Opportunity Commission","null","18953","16","18953","16","0","0","100.0","100.0","Non-CFO","2024","1","2023","4","12","31"
"2023-12-31","Bureau","Equal Employment Opportunity Commission","Equal Employment Opportunity Commission","18953","16","18953","16","0","0","100.0","100.0","null","2024","1","2023","4","12","31"
"2023-12-31","Agency","Export - Import  Bank","null","0","0","0","0","0","0","0.0","0.0","Non-CFO","2024","1","2023","4","12","31"
"2023-12-31","Bureau","Export - Import  Bank","Export-Import Bank","0","0","0","0","0","0","0.0","0.0","null","2024","1","2023","4","12","31"
"2023-12-31","Agency","Farm Credit Administration","null","630","1","630","1","0","0","100.0","100.0","Non-CFO","2024","1","2023","4","12","31"
"2023-12-31","Bureau","Farm Credit Administration","Farm Credit Administration","630","1","630","1","0","0","100.0","100.0","null","2024","1","2023","4","12","31"
"2023-12-31","Bureau","Farm Credit Administration","Farm Credit System Insurance Corporation","0","0","0","0","0","0","0.0","0.0","null","2024","1","2023","4","12","31"
"2023-12-31","Agency","Federal Communications Commission","null","251442520","13197","251442520","13197","0","0","100.0","100.0","Non-CFO","2024","1","2023","4","12","31"
"2023-12-31","Bureau","Federal Communications Commission","Federal Communications Commission","251442520","13197","251442520","13197","0","0","100.0","100.0","null","2024","1","2023","4","12","31"
"2023-12-31","Agency","Federal Deposit Insurance Corporation","null","0","0","0","0","0","0","0.0","0.0","Non-CFO","2024","1","2023","4","12","31"
"2023-12-31","Bureau","Federal Deposit Insurance Corporation","Federal Deposit Insurance Corporation","0","0","0","0","0","0","0.0","0.0","null","2024","1","2023","4","12","31"
"2023-12-31","Agency","Federal Election Commission","null","2928612","380","2928612","380","0","0","100.0","100.0","Non-CFO","2024","1","2023","4","12","31"
"2023-12-31","Bureau","Federal Election Commission","Federal Election Commission","2928612","380","2928612","380","0","0","100.0","100.0","null","2024","1","2023","4","12","31"
"2023-12-31","Agency","Federal Labor Relations Authority","null","0","0","0","0","0","0","0.0","0.0","Non-CFO","2024","1","2023","4","12","31"
"2023-12-31","Bureau","Federal Labor Relations Authority","Federal Labor Relations Authority","0","0","0","0","0","0","0.0","0.0","null","2024","1","2023","4","12","31"
"2023-12-31","Agency","Federal Maritime Commission","null","397569","6","397569","6","0","0","100.0","100.0","Non-CFO","2024","1","2023","4","12","31"
"2023-12-31","Bureau","Federal Maritime Commission","Salaries and Expenses","397569","6","397569","6","0","0","100.0","100.0","null","2024","1","2023","4","12","31"
"2023-12-31","Agency","Federal Mediation/Conciliation Service","null","0","0","0","0","0","0","0.0","0.0","Non-CFO","2024","1","2023","4","12","31"
"2023-12-31","Bureau","Federal Mediation/Conciliation Service","Federal Mediation/Conciliation Service","0","0","0","0","0","0","0.0","0.0","null","2024","1","2023","4","12","31"
"2023-12-31","Agency","Federal Trade Commission","null","652607559","67","652607559","67","0","0","100.0","100.0","Non-CFO","2024","1","2023","4","12","31"
"2023-12-31","Bureau","Federal Trade Commission","Federal Trade Commission","652607559","67","652607559","67","0","0","100.0","100.0","null","2024","1","2023","4","12","31"
"2023-12-31","Agency","Funds Appropriated to the President","null","1237938","8","1878","1","1236060","7","0.15170388177760114","12.5","Non-CFO","2024","1","2023","4","12","31"
"2023-12-31","Bureau","Funds Appropriated to the President","African Development Foundation","1878","1","1878","1","0","0","100.0","100.0","null","2024","1","2023","4","12","31"
"2023-12-31","Bureau","Funds Appropriated to the President","Defense Security Assistance Agency","0","0","0","0","0","0","0.0","0.0","null","2024","1","2023","4","12","31"
"2023-12-31","Bureau","Funds Appropriated to the President","Executive Branch","0","0","0","0","0","0","0.0","0.0","null","2024","1","2023","4","12","31"
"2023-12-31","Bureau","Funds Appropriated to the President","Inter-American Foundation","0","0","0","0","0","0","0.0","0.0","null","2024","1","2023","4","12","31"
"2023-12-31","Bureau","Funds Appropriated to the President","Peace Corps","0","0","0","0","0","0","0.0","0.0","null","2024","1","2023","4","12","31"
"2023-12-31","Bureau","Funds Appropriated to the President","Trade and Development Agency","1236060","7","0","0","1236060","7","0.0","0.0","null","2024","1","2023","4","12","31"
"2023-12-31","Agency","General Services Administration","null","10115910","379","10115910","379","0","0","100.0","100.0","CFO","2024","1","2023","4","12","31"
"2023-12-31","Bureau","General Services Administration","General Services Administration","10115910","379","10115910","379","0","0","100.0","100.0","null","2024","1","2023","4","12","31"
"2023-12-31","Agency","Legis Branch-Library of Congress","null","0","0","0","0","0","0","0.0","0.0","Non-CFO","2024","1","2023","4","12","31"
"2023-12-31","Bureau","Legis Branch-Library of Congress","Library of Congress","0","0","0","0","0","0","0.0","0.0","null","2024","1","2023","4","12","31"
"2023-12-31","Agency","Legislative Branch - U.S. House/Senate","null","325235","230","0","0","325235","230","0.0","0.0","Non-CFO","2024","1","2023","4","12","31"
"2023-12-31","Bureau","Legislative Branch - U.S. House/Senate","U.S. House of Representatives","325235","230","0","0","325235","230","0.0","0.0","null","2024","1","2023","4","12","31"
"2023-12-31","Agency","Legislative Branch-CBO","null","0","0","0","0","0","0","0.0","0.0","Non-CFO","2024","1","2023","4","12","31"
"2023-12-31","Bureau","Legislative Branch-CBO","Congressional Budget Office","0","0","0","0","0","0","0.0","0.0","null","2024","1","2023","4","12","31"
"2023-12-31","Agency","Legislative Branch-GAO","null","0","0","0","0","0","0","0.0","0.0","Non-CFO","2024","1","2023","4","12","31"
"2023-12-31","Bureau","Legislative Branch-GAO","Government Accountability Office","0","0","0","0","0","0","0.0","0.0","null","2024","1","2023","4","12","31"
"2023-12-31","Agency","Legislative Branch-GPO","null","0","0","0","0","0","0","0.0","0.0","Non-CFO","2024","1","2023","4","12","31"
"2023-12-31","Bureau","Legislative Branch-GPO","Government Publishing Office","0","0","0","0","0","0","0.0","0.0","null","2024","1","2023","4","12","31"
"2023-12-31","Agency","Legislative Branch-Office of Tech.","null","0","0","0","0","0","0","0.0","0.0","Non-CFO","2024","1","2023","4","12","31"
"2023-12-31","Bureau","Legislative Branch-Office of Tech.","Medicaid & CHIP Payment & Access Comm.","0","0","0","0","0","0","0.0","0.0","null","2024","1","2023","4","12","31"
"2023-12-31","Bureau","Legislative Branch-Office of Tech.","Open World Leadership","0","0","0","0","0","0","0.0","0.0","null","2024","1","2023","4","12","31"
"2023-12-31","Agency","Merit Systems Protection Board","null","144","1","144","1","0","0","100.0","100.0","Non-CFO","2024","1","2023","4","12","31"
"2023-12-31","Bureau","Merit Systems Protection Board","Merit Systems Protection Board","144","1","144","1","0","0","100.0","100.0","null","2024","1","2023","4","12","31"
"2023-12-31","Agency","National Aeronautics and Space Administration","null","1086766","133","1086487","132","279","1","99.97432750012422","99.24812030075188","CFO","2024","1","2023","4","12","31"
"2023-12-31","Bureau","National Aeronautics and Space Administration","National Aeronautics and Space Admin","1086766","133","1086487","132","279","1","99.97432750012422","99.24812030075188","null","2024","1","2023","4","12","31"
"2023-12-31","Agency","National Archives & Records Admin","null","127725","117","127725","117","0","0","100.0","100.0","Non-CFO","2024","1","2023","4","12","31"
"2023-12-31","Bureau","National Archives & Records Admin","Nat'l Archives & Records Administration","127725","117","127725","117","0","0","100.0","100.0","null","2024","1","2023","4","12","31"
"2023-12-31","Agency","National Credit Union Administration","null","1373","2","1373","2","0","0","100.0","100.0","Non-CFO","2024","1","2023","4","12","31"
"2023-12-31","Bureau","National Credit Union Administration","National Credit Union Administration","1373","2","1373","2","0","0","100.0","100.0","null","2024","1","2023","4","12","31"
"2023-12-31","Agency","National Foundation  Arts & Humanities","null","0","0","0","0","0","0","0.0","0.0","Non-CFO","2024","1","2023","4","12","31"
"2023-12-31","Bureau","National Foundation  Arts & Humanities","National Endowment for the Arts","0","0","0","0","0","0","0.0","0.0","null","2024","1","2023","4","12","31"
"2023-12-31","Bureau","National Foundation  Arts & Humanities","National Endowment for the Humanities","0","0","0","0","0","0","0.0","0.0","null","2024","1","2023","4","12","31"
"2023-12-31","Agency","National Labor Relations Board","null","0","0","0","0","0","0","0.0","0.0","Non-CFO","2024","1","2023","4","12","31"
"2023-12-31","Bureau","National Labor Relations Board","National Labor Relations Board","0","0","0","0","0","0","0.0","0.0","null","2024","1","2023","4","12","31"
"2023-12-31","Agency","National Science Foundation","null","719532","30","718896","29","636","1","99.9116092126549","96.66666666666667","CFO","2024","1","2023","4","12","31"
"2023-12-31","Bureau","National Science Foundation","National Science Foundation","719532","30","718896","29","636","1","99.9116092126549","96.66666666666667","null","2024","1","2023","4","12","31"
"2023-12-31","Agency","Neighborhood Reinvestment Corporation","null","0","0","0","0","0","0","0.0","0.0","Non-CFO","2024","1","2023","4","12","31"
"2023-12-31","Bureau","Neighborhood Reinvestment Corporation","Neighborhood Reinvestment Corporation","0","0","0","0","0","0","0.0","0.0","null","2024","1","2023","4","12","31"
"2023-12-31","Agency","Nuclear Regulatory Commission","null","3168984","356","3168984","356","0","0","100.0","100.0","CFO","2024","1","2023","4","12","31"
"2023-12-31","Bureau","Nuclear Regulatory Commission","Nuclear Regulatory Commission","3168984","356","3168984","356","0","0","100.0","100.0","null","2024","1","2023","4","12","31"
"2023-12-31","Agency","Occupational Safety & Health Rev Comm","null","0","0","0","0","0","0","0.0","0.0","Non-CFO","2024","1","2023","4","12","31"
"2023-12-31","Bureau","Occupational Safety & Health Rev Comm","Occupational Safety & Health Rev Comm","0","0","0","0","0","0","0.0","0.0","null","2024","1","2023","4","12","31"
"2023-12-31","Agency","Office of Compliance","null","0","0","0","0","0","0","0.0","0.0","Non-CFO","2024","1","2023","4","12","31"
"2023-12-31","Bureau","Office of Compliance","Office of Compliance","0","0","0","0","0","0","0.0","0.0","null","2024","1","2023","4","12","31"
"2023-12-31","Agency","Office of Government Ethics","null","0","0","0","0","0","0","0.0","0.0","Non-CFO","2024","1","2023","4","12","31"
"2023-12-31","Bureau","Office of Government Ethics","Office of Government Ethics","0","0","0","0","0","0","0.0","0.0","null","2024","1","2023","4","12","31"
"2023-12-31","Agency","Office of Personnel Management","null","18911332","997","18911332","997","0","0","100.0","100.0","CFO","2024","1","2023","4","12","31"
"2023-12-31","Bureau","Office of Personnel Management","Office of Personnel Management","18911332","997","18911332","997","0","0","100.0","100.0","null","2024","1","2023","4","12","31"
"2023-12-31","Agency","Office of Special Counsel","null","0","0","0","0","0","0","0.0","0.0","Non-CFO","2024","1","2023","4","12","31"
"2023-12-31","Bureau","Office of Special Counsel","Office of Special Counsel","0","0","0","0","0","0","0.0","0.0","null","2024","1","2023","4","12","31"
"2023-12-31","Agency","Other Agencies","null","748729","45","525333","7","223396","38","70.16330341151472","15.555555555555555","Non-CFO","2024","1","2023","4","12","31"
"2023-12-31","Bureau","Other Agencies","Advisory Council on Hist. Preservation","0","0","0","0","0","0","0.0","0.0","null","2024","1","2023","4","12","31"
"2023-12-31","Bureau","Other Agencies","Archit.&Trans. Barriers Compliance Bd","0","0","0","0","0","0","0.0","0.0","null","2024","1","2023","4","12","31"
"2023-12-31","Bureau","Other Agencies","Architect of the Capitol","0","0","0","0","0","0","0.0","0.0","null","2024","1","2023","4","12","31"
"2023-12-31","Bureau","Other Agencies","Chemical Safety Board","13361","1","13361","1","0","0","100.0","100.0","null","2024","1","2023","4","12","31"
"2023-12-31","Bureau","Other Agencies","Comm. for Purchase from Blind/Handic.","0","0","0","0","0","0","0.0","0.0","null","2024","1","2023","4","12","31"
"2023-12-31","Bureau","Other Agencies","Commission On Fine Arts","0","0","0","0","0","0","0.0","0.0","null","2024","1","2023","4","12","31"
"2023-12-31","Bureau","Other Agencies","Consumer Financial Protection Bureau","515730","13","510963","5","4767","8","99.0756791344308","38.46153846153846","null","2024","1","2023","4","12","31"
"2023-12-31","Bureau","Other Agencies","Council of Insps. Gen. of Intg. & Effy.","0","0","0","0","0","0","0.0","0.0","null","2024","1","2023","4","12","31"
"2023-12-31","Bureau","Other Agencies","Defense Nuclear Facilities Safety Board","0","0","0","0","0","0","0.0","0.0","null","2024","1","2023","4","12","31"
"2023-12-31","Bureau","Other Agencies","Delta Regional Authority","0","0","0","0","0","0","0.0","0.0","null","2024","1","2023","4","12","31"
"2023-12-31","Bureau","Other Agencies","Denali Commission","0","0","0","0","0","0","0.0","0.0","null","2024","1","2023","4","12","31"
"2023-12-31","Bureau","Other Agencies","District of Columbia Government","0","0","0","0","0","0","0.0","0.0","null","2024","1","2023","4","12","31"
"2023-12-31","Bureau","Other Agencies","Election Assistance Commission","5576","1","0","0","5576","1","0.0","0.0","null","2024","1","2023","4","12","31"
"2023-12-31","Bureau","Other Agencies","Federal Housing Finance Agency","1009","1","1009","1","0","0","100.0","100.0","null","2024","1","2023","4","12","31"
"2023-12-31","Bureau","Other Agencies","Federal Housing Finance Agency OIG","0","0","0","0","0","0","0.0","0.0","null","2024","1","2023","4","12","31"
"2023-12-31","Bureau","Other Agencies","Federal Mine Safety & Health Review Comm","0","0","0","0","0","0","0.0","0.0","null","2024","1","2023","4","12","31"
"2023-12-31","Bureau","Other Agencies","Gulf Coast Ecosystem Restoration Council","0","0","0","0","0","0","0.0","0.0","null","2024","1","2023","4","12","31"
"2023-12-31","Bureau","Other Agencies","James Madison Memorial Fellowship","197452","24","0","0","197452","24","0.0","0.0","null","2024","1","2023","4","12","31"
"2023-12-31","Bureau","Other Agencies","John C. Stennis","6313","2","0","0","6313","2","0.0","0.0","null","2024","1","2023","4","12","31"
"2023-12-31","Bureau","Other Agencies","Millennium Challenge Corporation","0","0","0","0","0","0","0.0","0.0","null","2024","1","2023","4","12","31"
"2023-12-31","Bureau","Other Agencies","Morris K. Udall Scholarship","0","0","0","0","0","0","0.0","0.0","null","2024","1","2023","4","12","31"
"2023-12-31","Bureau","Other Agencies","National Capital Planning Commission","0","0","0","0","0","0","0.0","0.0","null","2024","1","2023","4","12","31"
"2023-12-31","Bureau","Other Agencies","National Council on Disability","0","0","0","0","0","0","0.0","0.0","null","2024","1","2023","4","12","31"
"2023-12-31","Bureau","Other Agencies","National Mediation Board","0","0","0","0","0","0","0.0","0.0","null","2024","1","2023","4","12","31"
"2023-12-31","Bureau","Other Agencies","National Transportation Safety Board","428","1","0","0","428","1","0.0","0.0","null","2024","1","2023","4","12","31"
"2023-12-31","Bureau","Other Agencies","Privacy & Civil Liberties Oversight Bd","0","0","0","0","0","0","0.0","0.0","null","2024","1","2023","4","12","31"
"2023-12-31","Bureau","Other Agencies","Surface Transportation Board","0","0","0","0","0","0","0.0","0.0","null","2024","1","2023","4","12","31"
"2023-12-31","Bureau","Other Agencies","U.S.  Agency of Global Media","0","0","0","0","0","0","0.0","0.0","null","2024","1","2023","4","12","31"
"2023-12-31","Bureau","Other Agencies","U.S. Holocaust Memorial Council","0","0","0","0","0","0","0.0","0.0","null","2024","1","2023","4","12","31"
"2023-12-31","Bureau","Other Agencies","U.S. Inst. for Env. Conflict Resolution","8860","2","0","0","8860","2","0.0","0.0","null","2024","1","2023","4","12","31"
"2023-12-31","Bureau","Other Agencies","U.S. Institute of Peace","0","0","0","0","0","0","0.0","0.0","null","2024","1","2023","4","12","31"
"2023-12-31","Agency","Other Agencies/Boards/Commissions","null","1024","1","0","0","1024","1","0.0","0.0","Non-CFO","2024","1","2023","4","12","31"
"2023-12-31","Bureau","Other Agencies/Boards/Commissions","Medicare Payment Advisory Commission","0","0","0","0","0","0","0.0","0.0","null","2024","1","2023","4","12","31"
"2023-12-31","Bureau","Other Agencies/Boards/Commissions","Nuclear Waste Technical Review Board","0","0","0","0","0","0","0.0","0.0","null","2024","1","2023","4","12","31"
"2023-12-31","Bureau","Other Agencies/Boards/Commissions","U.S. Comm. on Int. Religious Freedom","1024","1","0","0","1024","1","0.0","0.0","null","2024","1","2023","4","12","31"
"2023-12-31","Bureau","Other Agencies/Boards/Commissions","U.S.-China Security Review Commission","0","0","0","0","0","0","0.0","0.0","null","2024","1","2023","4","12","31"
"2023-12-31","Agency","Pension Benefit Guaranty Corp","null","6292984","1469","6292984","1469","0","0","100.0","100.0","Non-CFO","2024","1","2023","4","12","31"
"2023-12-31","Bureau","Pension Benefit Guaranty Corp","Pension Benefit Guaranty Corporation","6292984","1469","6292984","1469","0","0","100.0","100.0","null","2024","1","2023","4","12","31"
"2023-12-31","Agency","Presidio Trust Corporation","null","1337667","60","1337667","60","0","0","100.0","100.0","Non-CFO","2024","1","2023","4","12","31"
"2023-12-31","Bureau","Presidio Trust Corporation","Presidio Trust Corporation","1337667","60","1337667","60","0","0","100.0","100.0","null","2024","1","2023","4","12","31"
"2023-12-31","Agency","Railroad Retirement Board","null","45492339","6079","45492339","6079","0","0","100.0","100.0","Non-CFO","2024","1","2023","4","12","31"
"2023-12-31","Bureau","Railroad Retirement Board","Railroad Retirement Board","45492339","6079","45492339","6079","0","0","100.0","100.0","null","2024","1","2023","4","12","31"
"2023-12-31","Agency","Securities & Exchange Commission","null","2904129432","1603","2904129432","1603","0","0","100.0","100.0","Non-CFO","2024","1","2023","4","12","31"
"2023-12-31","Bureau","Securities & Exchange Commission","SEC Enforcement","2903870907","1558","2903870907","1558","0","0","100.0","100.0","null","2024","1","2023","4","12","31"
"2023-12-31","Bureau","Securities & Exchange Commission","Securities and Exchange Commission","258525","45","258525","45","0","0","100.0","100.0","null","2024","1","2023","4","12","31"
"2023-12-31","Agency","Selective Service System","null","1301","2","0","0","1301","2","0.0","0.0","Non-CFO","2024","1","2023","4","12","31"
"2023-12-31","Bureau","Selective Service System","Selective Service System","1301","2","0","0","1301","2","0.0","0.0","null","2024","1","2023","4","12","31"
"2023-12-31","Agency","Small Business Administration","null","19752855663","164128","19752855663","164128","0","0","100.0","100.0","CFO","2024","1","2023","4","12","31"
"2023-12-31","Bureau","Small Business Administration","Small Business Administration","19752855663","164128","19752855663","164128","0","0","100.0","100.0","null","2024","1","2023","4","12","31"
"2023-12-31","Agency","Smithsonian Institution","null","8982","21","0","0","8982","21","0.0","0.0","Non-CFO","2024","1","2023","4","12","31"
"2023-12-31","Bureau","Smithsonian Institution","Administrative Conference of the US","0","0","0","0","0","0","0.0","0.0","null","2024","1","2023","4","12","31"
"2023-12-31","Bureau","Smithsonian Institution","JFK Center for the Performing Arts","0","0","0","0","0","0","0.0","0.0","null","2024","1","2023","4","12","31"
"2023-12-31","Bureau","Smithsonian Institution","National Gallery of Art","0","0","0","0","0","0","0.0","0.0","null","2024","1","2023","4","12","31"
"2023-12-31","Bureau","Smithsonian Institution","Smithsonian Institution","8982","21","0","0","8982","21","0.0","0.0","null","2024","1","2023","4","12","31"
"2023-12-31","Agency","Social Security Administration","null","4328552581","1339352","2383889905","406240","1944662676","933112","55.07360394474552","30.331085480142637","CFO","2024","1","2023","4","12","31"
"2023-12-31","Bureau","Social Security Administration","Social Security Administration","4328552581","1339352","2383889905","406240","1944662676","933112","55.07360394474552","30.331085480142637","null","2024","1","2023","4","12","31"
"2023-12-31","Agency","Tennessee Valley Authority","null","468082","0","0","0","468082","0","0.0","0.0","Non-CFO","2024","1","2023","4","12","31"
"2023-12-31","Bureau","Tennessee Valley Authority","Tennessee Valley Authority","468082","0","0","0","468082","0","0.0","0.0","null","2024","1","2023","4","12","31"
"2023-12-31","Agency","The Judiciary","null","1058720","306","1022263","174","36457","132","96.55650219132538","56.86274509803921","Non-CFO","2024","1","2023","4","12","31"
"2023-12-31","Bureau","The Judiciary","Administrative Office of the U.S. Courts","1058720","306","1022263","174","36457","132","96.55650219132538","56.86274509803921","null","2024","1","2023","4","12","31"
"2023-12-31","Agency","U.S. Court of Appeals / Veterans Claims","null","0","0","0","0","0","0","0.0","0.0","Non-CFO","2024","1","2023","4","12","31"
"2023-12-31","Bureau","U.S. Court of Appeals / Veterans Claims","U.S. Court of Appeals / Veterans Claims","0","0","0","0","0","0","0.0","0.0","null","2024","1","2023","4","12","31"
"2023-12-31","Agency","U.S. Postal Service","null","88625630","82117","72844050","67702","15781580","14415","82.19298412885753","82.4457785842152","Non-CFO","2024","1","2023","4","12","31"
"2023-12-31","Bureau","U.S. Postal Service","U.S. Postal Service","88625630","82117","72844050","67702","15781580","14415","82.19298412885753","82.4457785842152","null","2024","1","2023","4","12","31"
"2023-12-31","Agency","U.S. Tax Court","null","0","0","0","0","0","0","0.0","0.0","Non-CFO","2024","1","2023","4","12","31"
"2023-12-31","Bureau","U.S. Tax Court","U.S. Tax Court","0","0","0","0","0","0","0.0","0.0","null","2024","1","2023","4","12","31"
"2023-12-31","Agency","US International Development Fin. Corp.","null","0","0","0","0","0","0","0.0","0.0","Non-CFO","2024","1","2023","4","12","31"
"2023-12-31","Bureau","US International Development Fin. Corp.","US International Development Fin. Corp.","0","0","0","0","0","0","0.0","0.0","null","2024","1","2023","4","12","31"
"2023-09-30","Agency","Agency for International Development","null","28413237","55","28412964","54","273","1","99.99903918022434","98.18181818181819","CFO","2023","4","2023","3","09","30"
"2023-09-30","Bureau","Agency for International Development","Agency for International Development","28413237","55","28412964","54","273","1","99.99903918022434","98.18181818181819","null","2023","4","2023","3","09","30"
"2023-09-30","Agency","American Battle Monuments Commission","null","0","0","0","0","0","0","0.0","0.0","Non-CFO","2023","4","2023","3","09","30"
"2023-09-30","Bureau","American Battle Monuments Commission","American Battle Monuments Commission","0","0","0","0","0","0","0.0","0.0","null","2023","4","2023","3","09","30"
"2023-09-30","Agency","Armed Forces Retirement Home","null","110190","103","77020","102","33170","1","69.89744985933388","99.02912621359224","Non-CFO","2023","4","2023","3","09","30"
"2023-09-30","Bureau","Armed Forces Retirement Home","Armed Forces Retirement Home","110190","103","77020","102","33170","1","69.89744985933388","99.02912621359224","null","2023","4","2023","3","09","30"
"2023-09-30","Agency","Commodity Futures Trading Commission","null","629802832","360","629802832","360","0","0","100.0","100.0","Non-CFO","2023","4","2023","3","09","30"
"2023-09-30","Bureau","Commodity Futures Trading Commission","Commodity Futures Trading Commission","629802832","360","629802832","360","0","0","100.0","100.0","null","2023","4","2023","3","09","30"
"2023-09-30","Agency","Consumer Product Safety Commission","null","468","3","468","3","0","0","100.0","100.0","Non-CFO","2023","4","2023","3","09","30"
"2023-09-30","Bureau","Consumer Product Safety Commission","Consumer Product Safety Commission","468","3","468","3","0","0","100.0","100.0","null","2023","4","2023","3","09","30"
"2023-09-30","Agency","Corp. for National and Community Service","null","4073036","334","3602976","149","470060","185","88.45922304639586","44.61077844311377","Non-CFO","2023","4","2023","3","09","30"
"2023-09-30","Bureau","Corp. for National and Community Service","Corp. for National and Community Service","4073036","334","3602976","149","470060","185","88.45922304639586","44.61077844311377","null","2023","4","2023","3","09","30"
"2023-09-30","Agency","Department of Agriculture","null","1127039686","45695","1114326922","43443","12712764","2252","98.87202161929903","95.07167086114454","CFO","2023","4","2023","3","09","30"
"2023-09-30","Bureau","Department of Agriculture","Agricultural Marketing Service","4645358","1695","3636216","1192","1009142","503","78.27633521463792","70.3244837758112","null","2023","4","2023","3","09","30"
"2023-09-30","Bureau","Department of Agriculture","Commodity Credit Corporation","123357004","9445","123357004","9445","0","0","100.0","100.0","null","2023","4","2023","3","09","30"
"2023-09-30","Bureau","Department of Agriculture","Farm Service Agency","85337188","1667","85337188","1667","0","0","100.0","100.0","null","2023","4","2023","3","09","30"
"2023-09-30","Bureau","Department of Agriculture","Federal Crop Insurance Corporation","15141","4","15141","4","0","0","100.0","100.0","null","2023","4","2023","3","09","30"
"2023-09-30","Bureau","Department of Agriculture","Food Safety and Inspection Service","1150494","1093","1117030","1057","33464","36","97.09133641722599","96.70631290027447","null","2023","4","2023","3","09","30"
"2023-09-30","Bureau","Department of Agriculture","Food and Nutrition Service","4718206","201","39040","17","4679166","184","0.8274331387819862","8.457711442786069","null","2023","4","2023","3","09","30"
"2023-09-30","Bureau","Department of Agriculture","Forest Service","75132692","674","70441642","421","4691050","253","93.75631316391538","62.46290801186944","null","2023","4","2023","3","09","30"
"2023-09-30","Bureau","Department of Agriculture","Rural Development","811913411","27245","811907784","27241","5627","4","99.99930694579942","99.98531840704716","null","2023","4","2023","3","09","30"
"2023-09-30","Bureau","Department of Agriculture","U.S. Department of Agriculture","20770192","3671","18475877","2399","2294315","1272","88.95380938221467","65.35004086080087","null","2023","4","2023","3","09","30"
"2023-09-30","Agency","Department of Commerce","null","76772661","11840","76772661","11840","0","0","100.0","100.0","CFO","2023","4","2023","3","09","30"
"2023-09-30","Bureau","Department of Commerce","Bureau of Industry and Security","37546041","27","37546041","27","0","0","100.0","100.0","null","2023","4","2023","3","09","30"
"2023-09-30","Bureau","Department of Commerce","Bureau of the Census","2297697","9831","2297697","9831","0","0","100.0","100.0","null","2023","4","2023","3","09","30"
"2023-09-30","Bureau","Department of Commerce","Economic Development Administration","5153780","13","5153780","13","0","0","100.0","100.0","null","2023","4","2023","3","09","30"
"2023-09-30","Bureau","Department of Commerce","Economic and Statistical Analysis","0","0","0","0","0","0","0.0","0.0","null","2023","4","2023","3","09","30"
"2023-09-30","Bureau","Department of Commerce","General Administration","4660","1","4660","1","0","0","100.0","100.0","null","2023","4","2023","3","09","30"
"2023-09-30","Bureau","Department of Commerce","International Trade Administration","0","0","0","0","0","0","0.0","0.0","null","2023","4","2023","3","09","30"
"2023-09-30","Bureau","Department of Commerce","Minority Business Development Agency","0","0","0","0","0","0","0.0","0.0","null","2023","4","2023","3","09","30"
"2023-09-30","Bureau","Department of Commerce","NOAA","30036302","1263","30036302","1263","0","0","100.0","100.0","null","2023","4","2023","3","09","30"
"2023-09-30","Bureau","Department of Commerce","Nat'l Institute of Standards& Technology","965081","2","965081","2","0","0","100.0","100.0","null","2023","4","2023","3","09","30"
"2023-09-30","Bureau","Department of Commerce","Nat'l Telecomm & Information Admin.","296093","1","296093","1","0","0","100.0","100.0","null","2023","4","2023","3","09","30"
"2023-09-30","Bureau","Department of Commerce","National Technical Information Service","0","0","0","0","0","0","0.0","0.0","null","2023","4","2023","3","09","30"
"2023-09-30","Bureau","Department of Commerce","Office of the Inspector General","0","0","0","0","0","0","0.0","0.0","null","2023","4","2023","3","09","30"
"2023-09-30","Bureau","Department of Commerce","Patent and Trademark Office","473007","702","473007","702","0","0","100.0","100.0","null","2023","4","2023","3","09","30"
"2023-09-30","Agency","Department of Defense","null","3315855883","1731343","1104986384","304080","2210869499","1427263","33.32431875779446","17.563244256048627","CFO","2023","4","2023","3","09","30"
"2023-09-30","Bureau","Department of Defense","Consolidated Report","3315855883","1731343","1104986384","304080","2210869499","1427263","33.32431875779446","17.563244256048627","null","2023","4","2023","3","09","30"
"2023-09-30","Agency","Department of Education","null","118454359000","20475710","115618579152","19709151","2835779848","766559","97.60601477907622","96.25625191995785","CFO","2023","4","2023","3","09","30"
"2023-09-30","Bureau","Department of Education","Departmental Management","1458104947","2020","1452883662","1961","5221285","59","99.64191294935645","97.07920792079207","null","2023","4","2023","3","09","30"
"2023-09-30","Bureau","Department of Education","Federal Student Aid","116996254053","20473690","114165695490","19707190","2830558563","766500","97.58064171719742","96.25617072447615","null","2023","4","2023","3","09","30"
"2023-09-30","Bureau","Department of Education","Office of Postsecondary Education","0","0","0","0","0","0","0.0","0.0","null","2023","4","2023","3","09","30"
"2023-09-30","Agency","Department of Energy","null","13760196","101","13760196","101","0","0","100.0","100.0","CFO","2023","4","2023","3","09","30"
"2023-09-30","Bureau","Department of Energy","Bonneville Power Administration","1058470","28","1058470","28","0","0","100.0","100.0","null","2023","4","2023","3","09","30"
"2023-09-30","Bureau","Department of Energy","Energy Consolidated Reports","12701726","73","12701726","73","0","0","100.0","100.0","null","2023","4","2023","3","09","30"
"2023-09-30","Agency","Department of Health & Human Services","null","11060668038","1179770","10769925375","1148646","290742663","31124","97.37138243367285","97.36185866736737","CFO","2023","4","2023","3","09","30"
"2023-09-30","Bureau","Department of Health & Human Services","Administration for Children and Families","42030661","1710","42030661","1710","0","0","100.0","100.0","null","2023","4","2023","3","09","30"
"2023-09-30","Bureau","Department of Health & Human Services","Administration for Community Living","0","0","0","0","0","0","0.0","0.0","null","2023","4","2023","3","09","30"
"2023-09-30","Bureau","Department of Health & Human Services","Agency for Healthcare Research & Quality","99","1","99","1","0","0","100.0","100.0","null","2023","4","2023","3","09","30"
"2023-09-30","Bureau","Department of Health & Human Services","Centers for Disease Control","8839011","111","946044","21","7892967","90","10.703052637902589","18.91891891891892","null","2023","4","2023","3","09","30"
"2023-09-30","Bureau","Department of Health & Human Services","Centers for Medicare & Medicaid Services","10537656594","1143249","10413206765","1137853","124449829","5396","98.81899900713353","99.52801183294278","null","2023","4","2023","3","09","30"
"2023-09-30","Bureau","Department of Health & Human Services","Food and Drug Administration","192816897","26432","53546628","1844","139270269","24588","27.77071347642318","6.97639225181598","null","2023","4","2023","3","09","30"
"2023-09-30","Bureau","Department of Health & Human Services","Health Resources and Services Admin","123070576","1665","123070576","1665","0","0","100.0","100.0","null","2023","4","2023","3","09","30"
"2023-09-30","Bureau","Department of Health & Human Services","Indian Health Services","81429057","4151","81429057","4151","0","0","100.0","100.0","null","2023","4","2023","3","09","30"
"2023-09-30","Bureau","Department of Health & Human Services","National Institutes of Health","26894676","1182","7765078","132","19129598","1050","28.872175295958204","11.16751269035533","null","2023","4","2023","3","09","30"
"2023-09-30","Bureau","Department of Health & Human Services","Office of the Inspector General","33600","1","33600","1","0","0","100.0","100.0","null","2023","4","2023","3","09","30"
"2023-09-30","Bureau","Department of Health & Human Services","Office of the Secretary","40342364","999","40342364","999","0","0","100.0","100.0","null","2023","4","2023","3","09","30"
"2023-09-30","Bureau","Department of Health & Human Services","Program Support Center","6482841","258","6482841","258","0","0","100.0","100.0","null","2023","4","2023","3","09","30"
"2023-09-30","Bureau","Department of Health & Human Services","Substance Abuse & Mental Health Admin.","1071662","11","1071662","11","0","0","100.0","100.0","null","2023","4","2023","3","09","30"
"2023-09-30","Agency","Department of Homeland Security","null","282180372","86334","262861693","61713","19318679","24621","93.1537835664913","71.4816874000973","CFO","2023","4","2023","3","09","30"
"2023-09-30","Bureau","Department of Homeland Security","Bureau of Customs & Border Protection","10633073","905","10633073","905","0","0","100.0","100.0","null","2023","4","2023","3","09","30"
"2023-09-30","Bureau","Department of Homeland Security","Citizenship and Immigration Services","1159268","1395","1159268","1395","0","0","100.0","100.0","null","2023","4","2023","3","09","30"
"2023-09-30","Bureau","Department of Homeland Security","Domestic Nuclear Detection Office","3252","23","0","0","3252","23","0.0","0.0","null","2023","4","2023","3","09","30"
"2023-09-30","Bureau","Department of Homeland Security","Emergency Preparedness & Resp","222162279","43088","222162279","43088","0","0","100.0","100.0","null","2023","4","2023","3","09","30"
"2023-09-30","Bureau","Department of Homeland Security","Federal Law Enforcement Training Ctr.","14673","2","14673","2","0","0","100.0","100.0","null","2023","4","2023","3","09","30"
"2023-09-30","Bureau","Department of Homeland Security","Immigration and Customs Enforcement","16713418","658","16713418","658","0","0","100.0","100.0","null","2023","4","2023","3","09","30"
"2023-09-30","Bureau","Department of Homeland Security","Info Analysis Infrastructure Prot-NPPD","0","0","0","0","0","0","0.0","0.0","null","2023","4","2023","3","09","30"
"2023-09-30","Bureau","Department of Homeland Security","Management Headquarters","0","0","0","0","0","0","0.0","0.0","null","2023","4","2023","3","09","30"
"2023-09-30","Bureau","Department of Homeland Security","Office of Biometric Identity Management","0","0","0","0","0","0","0.0","0.0","null","2023","4","2023","3","09","30"
"2023-09-30","Bureau","Department of Homeland Security","Office of the Inspector General DHS","100","1","100","1","0","0","100.0","100.0","null","2023","4","2023","3","09","30"
"2023-09-30","Bureau","Department of Homeland Security","Science and Technology","0","0","0","0","0","0","0.0","0.0","null","2023","4","2023","3","09","30"
"2023-09-30","Bureau","Department of Homeland Security","Transportation Safety Administration","10949732","14270","10949732","14270","0","0","100.0","100.0","null","2023","4","2023","3","09","30"
"2023-09-30","Bureau","Department of Homeland Security","U.S. Coast Guard","20544577","25992","1229150","1394","19315427","24598","5.982844037139339","5.363188673437981","null","2023","4","2023","3","09","30"
"2023-09-30","Bureau","Department of Homeland Security","U.S. Secret Service","0","0","0","0","0","0","0.0","0.0","null","2023","4","2023","3","09","30"
"2023-09-30","Agency","Department of Housing and Urban Development","null","63635877","2547","63472017","2543","163860","4","99.74250374517507","99.84295249312918","CFO","2023","4","2023","3","09","30"
"2023-09-30","Bureau","Department of Housing and Urban Development","Community Planning and Development","102215","1","102215","1","0","0","100.0","100.0","null","2023","4","2023","3","09","30"
"2023-09-30","Bureau","Department of Housing and Urban Development","Government National Mortgage Association","143585","1","0","0","143585","1","0.0","0.0","null","2023","4","2023","3","09","30"
"2023-09-30","Bureau","Department of Housing and Urban Development","Housing Programs","63379843","2541","63359568","2538","20275","3","99.9680103341373","99.8819362455726","null","2023","4","2023","3","09","30"
"2023-09-30","Bureau","Department of Housing and Urban Development","Management and Administration","9981","2","9981","2","0","0","100.0","100.0","null","2023","4","2023","3","09","30"
"2023-09-30","Bureau","Department of Housing and Urban Development","Policy, Development and Research","0","0","0","0","0","0","0.0","0.0","null","2023","4","2023","3","09","30"
"2023-09-30","Bureau","Department of Housing and Urban Development","Public and Indian Housing Programs","253","2","253","2","0","0","100.0","100.0","null","2023","4","2023","3","09","30"
"2023-09-30","Agency","Department of Justice","null","119280551","40595","117662785","40138","1617766","457","98.6437302758603","98.87424559674837","CFO","2023","4","2023","3","09","30"
"2023-09-30","Bureau","Department of Justice","Bureau of ATF and Explosives","19881","1","19881","1","0","0","100.0","100.0","null","2023","4","2023","3","09","30"
"2023-09-30","Bureau","Department of Justice","Drug Enforcement Administration","343675","16","343675","16","0","0","100.0","100.0","null","2023","4","2023","3","09","30"
"2023-09-30","Bureau","Department of Justice","Federal Bureau of Investigation","428276","104","428276","104","0","0","100.0","100.0","null","2023","4","2023","3","09","30"
"2023-09-30","Bureau","Department of Justice","Federal Prison Industries","115249","45","0","0","115249","45","0.0","0.0","null","2023","4","2023","3","09","30"
"2023-09-30","Bureau","Department of Justice","Federal Prison System","27061326","1194","27061326","1194","0","0","100.0","100.0","null","2023","4","2023","3","09","30"
"2023-09-30","Bureau","Department of Justice","General Administration","0","0","0","0","0","0","0.0","0.0","null","2023","4","2023","3","09","30"
"2023-09-30","Bureau","Department of Justice","Legal Activities","89955458","39229","88452941","38817","1502517","412","98.32971002159758","98.94975655764868","null","2023","4","2023","3","09","30"
"2023-09-30","Bureau","Department of Justice","Office of Justice Assistance Programs","1356686","6","1356686","6","0","0","100.0","100.0","null","2023","4","2023","3","09","30"
"2023-09-30","Bureau","Department of Justice","U.S. Marshals Service","0","0","0","0","0","0","0.0","0.0","null","2023","4","2023","3","09","30"
"2023-09-30","Agency","Department of Labor","null","155610431","12371","143115553","9458","12494878","2913","91.97041103240694","76.45299490744483","CFO","2023","4","2023","3","09","30"
"2023-09-30","Bureau","Department of Labor","Bureau of Labor Statistics","4782","1","4782","1","0","0","100.0","100.0","null","2023","4","2023","3","09","30"
"2023-09-30","Bureau","Department of Labor","Departmental Management","0","0","0","0","0","0","0.0","0.0","null","2023","4","2023","3","09","30"
"2023-09-30","Bureau","Department of Labor","Employee Benefit Security Administration","21127004","472","21127004","472","0","0","100.0","100.0","null","2023","4","2023","3","09","30"
"2023-09-30","Bureau","Department of Labor","Employment Standards Administration","67126726","4024","60052928","2379","7073798","1645","89.46202441036674","59.12027833001988","null","2023","4","2023","3","09","30"
"2023-09-30","Bureau","Department of Labor","Employment and Training Administration","885054","10","885054","10","0","0","100.0","100.0","null","2023","4","2023","3","09","30"
"2023-09-30","Bureau","Department of Labor","Mine Safety and Health Administration","10222863","3913","7714344","3469","2508519","444","75.46167839674659","88.65320725785843","null","2023","4","2023","3","09","30"
"2023-09-30","Bureau","Department of Labor","Occupational Safety and Health Admin","56244002","3951","53331441","3127","2912561","824","94.82156159513684","79.14452037458871","null","2023","4","2023","3","09","30"
"2023-09-30","Agency","Department of State","null","22680684","21004","22443845","20836","236839","168","98.95576782428607","99.20015235193297","CFO","2023","4","2023","3","09","30"
"2023-09-30","Bureau","Department of State","Department of State","20924672","9688","20687833","9520","236839","168","98.86813518510588","98.26589595375722","null","2023","4","2023","3","09","30"
"2023-09-30","Bureau","Department of State","International Commissions","0","0","0","0","0","0","0.0","0.0","null","2023","4","2023","3","09","30"
"2023-09-30","Bureau","Department of State","Passport NSF","1756012","11316","1756012","11316","0","0","100.0","100.0","null","2023","4","2023","3","09","30"
"2023-09-30","Agency","Department of Transportation","null","82954724","9027","82954724","9027","0","0","100.0","100.0","CFO","2023","4","2023","3","09","30"
"2023-09-30","Bureau","Department of Transportation","Federal Aviation Administration","3895327","485","3895327","485","0","0","100.0","100.0","null","2023","4","2023","3","09","30"
"2023-09-30","Bureau","Department of Transportation","Federal Highway Administration","10778","9","10778","9","0","0","100.0","100.0","null","2023","4","2023","3","09","30"
"2023-09-30","Bureau","Department of Transportation","Federal Motor Carrier Safety Admin","75263151","8371","75263151","8371","0","0","100.0","100.0","null","2023","4","2023","3","09","30"
"2023-09-30","Bureau","Department of Transportation","Federal Railroad Administration","185691","15","185691","15","0","0","100.0","100.0","null","2023","4","2023","3","09","30"
"2023-09-30","Bureau","Department of Transportation","Federal Transit Administration","784983","3","784983","3","0","0","100.0","100.0","null","2023","4","2023","3","09","30"
"2023-09-30","Bureau","Department of Transportation","Maritime Administration","295449","15","295449","15","0","0","100.0","100.0","null","2023","4","2023","3","09","30"
"2023-09-30","Bureau","Department of Transportation","National Highway Traffic Safety Admin.","28794","4","28794","4","0","0","100.0","100.0","null","2023","4","2023","3","09","30"
"2023-09-30","Bureau","Department of Transportation","Office of the Inspector General","3334","1","3334","1","0","0","100.0","100.0","null","2023","4","2023","3","09","30"
"2023-09-30","Bureau","Department of Transportation","Office of the Secretary","1139870","16","1139870","16","0","0","100.0","100.0","null","2023","4","2023","3","09","30"
"2023-09-30","Bureau","Department of Transportation","Pipeline Hazardous Material Safety Admin","1312721","99","1312721","99","0","0","100.0","100.0","null","2023","4","2023","3","09","30"
"2023-09-30","Bureau","Department of Transportation","Research Innovative Technology Admin","26898","7","26898","7","0","0","100.0","100.0","null","2023","4","2023","3","09","30"
"2023-09-30","Bureau","Department of Transportation","St. Lawrence Seaway Development Corp.","7728","2","7728","2","0","0","100.0","100.0","null","2023","4","2023","3","09","30"
"2023-09-30","Agency","Department of Veterans Affairs","null","248734786","3530257","246077764","3525916","2657022","4341","98.93178511830669","99.87703444820023","CFO","2023","4","2023","3","09","30"
"2023-09-30","Bureau","Department of Veterans Affairs","Administration and Cemeteries","2992422","724","2644953","356","347469","368","88.38836902014489","49.171270718232044","null","2023","4","2023","3","09","30"
"2023-09-30","Bureau","Department of Veterans Affairs","Housing Credit Assistance","395049","12","671","1","394378","11","0.16985234743031877","8.333333333333334","null","2023","4","2023","3","09","30"
"2023-09-30","Bureau","Department of Veterans Affairs","Life Insurance","1233112","257","1233112","257","0","0","100.0","100.0","null","2023","4","2023","3","09","30"
"2023-09-30","Bureau","Department of Veterans Affairs","Medical and Construction","242889950","3527637","242199028","3525302","690922","2335","99.71554113292872","99.93380838221167","null","2023","4","2023","3","09","30"
"2023-09-30","Bureau","Department of Veterans Affairs","Veterans Benefits","1224253","1627","0","0","1224253","1627","0.0","0.0","null","2023","4","2023","3","09","30"
"2023-09-30","Agency","Department of the Interior","null","88542413","31192","88529336","31102","13077","90","99.98523080684508","99.7114644780713","CFO","2023","4","2023","3","09","30"
"2023-09-30","Bureau","Department of the Interior","Bureau of Indian Affairs","29232973","27337","29225348","27253","7625","84","99.9739164401787","99.6927241467608","null","2023","4","2023","3","09","30"
"2023-09-30","Bureau","Department of the Interior","Bureau of Land Management","9060569","348","9060569","348","0","0","100.0","100.0","null","2023","4","2023","3","09","30"
"2023-09-30","Bureau","Department of the Interior","Bureau of Ocean Energy Mgmt., Reg & Enf","1333","1","1333","1","0","0","100.0","100.0","null","2023","4","2023","3","09","30"
"2023-09-30","Bureau","Department of the Interior","Bureau of Reclamation","7392883","65","7392883","65","0","0","100.0","100.0","null","2023","4","2023","3","09","30"
"2023-09-30","Bureau","Department of the Interior","Bureau of Safety and Environmental Enf.","7451","2","7451","2","0","0","100.0","100.0","null","2023","4","2023","3","09","30"
"2023-09-30","Bureau","Department of the Interior","Fish and Wildlife Service","830472","106","830472","106","0","0","100.0","100.0","null","2023","4","2023","3","09","30"
"2023-09-30","Bureau","Department of the Interior","Geological Survey","143786","406","143786","406","0","0","100.0","100.0","null","2023","4","2023","3","09","30"
"2023-09-30","Bureau","Department of the Interior","National Park Service","8916074","1994","8916074","1994","0","0","100.0","100.0","null","2023","4","2023","3","09","30"
"2023-09-30","Bureau","Department of the Interior","Office of Natural Resources Revenue","24574127","540","24574127","540","0","0","100.0","100.0","null","2023","4","2023","3","09","30"
"2023-09-30","Bureau","Department of the Interior","Office of Surface Mining","8373471","379","8373471","379","0","0","100.0","100.0","null","2023","4","2023","3","09","30"
"2023-09-30","Bureau","Department of the Interior","Office of the Secretary","9274","14","3822","8","5452","6","41.21199051110632","57.142857142857146","null","2023","4","2023","3","09","30"
"2023-09-30","Agency","Department of the Treasury","null","46814659","4634","46525009","4621","289650","13","99.38128354197774","99.71946482520501","CFO","2023","4","2023","3","09","30"
"2023-09-30","Bureau","Department of the Treasury","Bureau of Engraving and Printing","38345","2","0","0","38345","2","0.0","0.0","null","2023","4","2023","3","09","30"
"2023-09-30","Bureau","Department of the Treasury","Bureau of the Fiscal Service","13423814","3179","13423814","3179","0","0","100.0","100.0","null","2023","4","2023","3","09","30"
"2023-09-30","Bureau","Department of the Treasury","Community Dev Financial Inst Fund","3623095","7","3623095","7","0","0","100.0","100.0","null","2023","4","2023","3","09","30"
"2023-09-30","Bureau","Department of the Treasury","Comptroller of the Currency","1404991","26","1400949","22","4042","4","99.71231132441417","84.61538461538461","null","2023","4","2023","3","09","30"
"2023-09-30","Bureau","Department of the Treasury","D.C. Pension Program","1504069","20","1504069","20","0","0","100.0","100.0","null","2023","4","2023","3","09","30"
"2023-09-30","Bureau","Department of the Treasury","Departmental Offices","20955245","1320","20852924","1316","102321","4","99.51171651775009","99.6969696969697","null","2023","4","2023","3","09","30"
"2023-09-30","Bureau","Department of the Treasury","Financial Crimes Enforcement Network","1544945","3","1544945","3","0","0","100.0","100.0","null","2023","4","2023","3","09","30"
"2023-09-30","Bureau","Department of the Treasury","Interest on Tax/Deposit of Earnings","0","0","0","0","0","0","0.0","0.0","null","2023","4","2023","3","09","30"
"2023-09-30","Bureau","Department of the Treasury","Internal Revenue Service","46542","40","46542","40","0","0","100.0","100.0","null","2023","4","2023","3","09","30"
"2023-09-30","Bureau","Department of the Treasury","International Monetary Funds","0","0","0","0","0","0","0.0","0.0","null","2023","4","2023","3","09","30"
"2023-09-30","Bureau","Department of the Treasury","Office of Financial Research","521","2","521","2","0","0","100.0","100.0","null","2023","4","2023","3","09","30"
"2023-09-30","Bureau","Department of the Treasury","Office of Sec International Affairs","0","0","0","0","0","0","0.0","0.0","null","2023","4","2023","3","09","30"
"2023-09-30","Bureau","Department of the Treasury","Office of the Secretary","0","0","0","0","0","0","0.0","0.0","null","2023","4","2023","3","09","30"
"2023-09-30","Bureau","Department of the Treasury","Pandemic Receivables","4099198","9","4099198","9","0","0","100.0","100.0","null","2023","4","2023","3","09","30"
"2023-09-30","Bureau","Department of the Treasury","Spec Insp Gen-Troubled Asset Rel Prog","3916","1","3916","1","0","0","100.0","100.0","null","2023","4","2023","3","09","30"
"2023-09-30","Bureau","Department of the Treasury","Tobacco Tax and Trade","1000","1","1000","1","0","0","100.0","100.0","null","2023","4","2023","3","09","30"
"2023-09-30","Bureau","Department of the Treasury","Treasury Forfeiture Fund","0","0","0","0","0","0","0.0","0.0","null","2023","4","2023","3","09","30"
"2023-09-30","Bureau","Department of the Treasury","Treasury Franchise Fund","0","0","0","0","0","0","0.0","0.0","null","2023","4","2023","3","09","30"
"2023-09-30","Bureau","Department of the Treasury","Treasury IG for Tax Admin","263","2","263","2","0","0","100.0","100.0","null","2023","4","2023","3","09","30"
"2023-09-30","Bureau","Department of the Treasury","U.S. Mint","168715","22","23773","19","144942","3","14.090626203953413","86.36363636363636","null","2023","4","2023","3","09","30"
"2023-09-30","Bureau","Department of the Treasury","U.S. Treasury IG Office","0","0","0","0","0","0","0.0","0.0","null","2023","4","2023","3","09","30"
"2023-09-30","Agency","Environmental Protection Agency","null","28178548","245","28174690","244","3858","1","99.9863087338638","99.59183673469387","CFO","2023","4","2023","3","09","30"
"2023-09-30","Bureau","Environmental Protection Agency","Environmental Protection Agency","28178548","245","28174690","244","3858","1","99.9863087338638","99.59183673469387","null","2023","4","2023","3","09","30"
"2023-09-30","Agency","Equal Employment Opportunity Commission","null","15652","15","15652","15","0","0","100.0","100.0","Non-CFO","2023","4","2023","3","09","30"
"2023-09-30","Bureau","Equal Employment Opportunity Commission","Equal Employment Opportunity Commission","15652","15","15652","15","0","0","100.0","100.0","null","2023","4","2023","3","09","30"
"2023-09-30","Agency","Export - Import  Bank","null","0","0","0","0","0","0","0.0","0.0","Non-CFO","2023","4","2023","3","09","30"
"2023-09-30","Bureau","Export - Import  Bank","Export-Import Bank","0","0","0","0","0","0","0.0","0.0","null","2023","4","2023","3","09","30"
"2023-09-30","Agency","Farm Credit Administration","null","630","1","630","1","0","0","100.0","100.0","Non-CFO","2023","4","2023","3","09","30"
"2023-09-30","Bureau","Farm Credit Administration","Farm Credit Administration","630","1","630","1","0","0","100.0","100.0","null","2023","4","2023","3","09","30"
"2023-09-30","Bureau","Farm Credit Administration","Farm Credit System Insurance Corporation","0","0","0","0","0","0","0.0","0.0","null","2023","4","2023","3","09","30"
"2023-09-30","Agency","Federal Communications Commission","null","249427890","12165","249427890","12165","0","0","100.0","100.0","Non-CFO","2023","4","2023","3","09","30"
"2023-09-30","Bureau","Federal Communications Commission","Federal Communications Commission","249427890","12165","249427890","12165","0","0","100.0","100.0","null","2023","4","2023","3","09","30"
"2023-09-30","Agency","Federal Deposit Insurance Corporation","null","0","0","0","0","0","0","0.0","0.0","Non-CFO","2023","4","2023","3","09","30"
"2023-09-30","Bureau","Federal Deposit Insurance Corporation","Federal Deposit Insurance Corporation","0","0","0","0","0","0","0.0","0.0","null","2023","4","2023","3","09","30"
"2023-09-30","Agency","Federal Election Commission","null","2344754","327","2344754","327","0","0","100.0","100.0","Non-CFO","2023","4","2023","3","09","30"
"2023-09-30","Bureau","Federal Election Commission","Federal Election Commission","2344754","327","2344754","327","0","0","100.0","100.0","null","2023","4","2023","3","09","30"
"2023-09-30","Agency","Federal Labor Relations Authority","null","0","0","0","0","0","0","0.0","0.0","Non-CFO","2023","4","2023","3","09","30"
"2023-09-30","Bureau","Federal Labor Relations Authority","Federal Labor Relations Authority","0","0","0","0","0","0","0.0","0.0","null","2023","4","2023","3","09","30"
"2023-09-30","Agency","Federal Maritime Commission","null","397569","6","397569","6","0","0","100.0","100.0","Non-CFO","2023","4","2023","3","09","30"
"2023-09-30","Bureau","Federal Maritime Commission","Salaries and Expenses","397569","6","397569","6","0","0","100.0","100.0","null","2023","4","2023","3","09","30"
"2023-09-30","Agency","Federal Mediation/Conciliation Service","null","0","0","0","0","0","0","0.0","0.0","Non-CFO","2023","4","2023","3","09","30"
"2023-09-30","Bureau","Federal Mediation/Conciliation Service","Federal Mediation/Conciliation Service","0","0","0","0","0","0","0.0","0.0","null","2023","4","2023","3","09","30"
"2023-09-30","Agency","Federal Trade Commission","null","380675784","56","380675784","56","0","0","100.0","100.0","Non-CFO","2023","4","2023","3","09","30"
"2023-09-30","Bureau","Federal Trade Commission","Federal Trade Commission","380675784","56","380675784","56","0","0","100.0","100.0","null","2023","4","2023","3","09","30"
"2023-09-30","Agency","Funds Appropriated to the President","null","1236060","7","0","0","1236060","7","0.0","0.0","Non-CFO","2023","4","2023","3","09","30"
"2023-09-30","Bureau","Funds Appropriated to the President","African Development Foundation","0","0","0","0","0","0","0.0","0.0","null","2023","4","2023","3","09","30"
"2023-09-30","Bureau","Funds Appropriated to the President","Defense Security Assistance Agency","0","0","0","0","0","0","0.0","0.0","null","2023","4","2023","3","09","30"
"2023-09-30","Bureau","Funds Appropriated to the President","Executive Branch","0","0","0","0","0","0","0.0","0.0","null","2023","4","2023","3","09","30"
"2023-09-30","Bureau","Funds Appropriated to the President","Inter-American Foundation","0","0","0","0","0","0","0.0","0.0","null","2023","4","2023","3","09","30"
"2023-09-30","Bureau","Funds Appropriated to the President","Peace Corps","0","0","0","0","0","0","0.0","0.0","null","2023","4","2023","3","09","30"
"2023-09-30","Bureau","Funds Appropriated to the President","Trade and Development Agency","1236060","7","0","0","1236060","7","0.0","0.0","null","2023","4","2023","3","09","30"
"2023-09-30","Agency","General Services Administration","null","1259836","51","0","0","1259836","51","0.0","0.0","CFO","2023","4","2023","3","09","30"
"2023-09-30","Bureau","General Services Administration","General Services Administration","1259836","51","0","0","1259836","51","0.0","0.0","null","2023","4","2023","3","09","30"
"2023-09-30","Agency","Legis Branch-Library of Congress","null","0","0","0","0","0","0","0.0","0.0","Non-CFO","2023","4","2023","3","09","30"
"2023-09-30","Bureau","Legis Branch-Library of Congress","Library of Congress","0","0","0","0","0","0","0.0","0.0","null","2023","4","2023","3","09","30"
"2023-09-30","Agency","Legislative Branch - U.S. House/Senate","null","329537","226","0","0","329537","226","0.0","0.0","Non-CFO","2023","4","2023","3","09","30"
"2023-09-30","Bureau","Legislative Branch - U.S. House/Senate","U.S. House of Representatives","329537","226","0","0","329537","226","0.0","0.0","null","2023","4","2023","3","09","30"
"2023-09-30","Agency","Legislative Branch-CBO","null","0","0","0","0","0","0","0.0","0.0","Non-CFO","2023","4","2023","3","09","30"
"2023-09-30","Bureau","Legislative Branch-CBO","Congressional Budget Office","0","0","0","0","0","0","0.0","0.0","null","2023","4","2023","3","09","30"
"2023-09-30","Agency","Legislative Branch-GAO","null","24441","9","24441","9","0","0","100.0","100.0","Non-CFO","2023","4","2023","3","09","30"
"2023-09-30","Bureau","Legislative Branch-GAO","Government Accountability Office","24441","9","24441","9","0","0","100.0","100.0","null","2023","4","2023","3","09","30"
"2023-09-30","Agency","Legislative Branch-GPO","null","0","0","0","0","0","0","0.0","0.0","Non-CFO","2023","4","2023","3","09","30"
"2023-09-30","Bureau","Legislative Branch-GPO","Government Publishing Office","0","0","0","0","0","0","0.0","0.0","null","2023","4","2023","3","09","30"
"2023-09-30","Agency","Legislative Branch-Office of Tech.","null","0","0","0","0","0","0","0.0","0.0","Non-CFO","2023","4","2023","3","09","30"
"2023-09-30","Bureau","Legislative Branch-Office of Tech.","Medicaid & CHIP Payment & Access Comm.","0","0","0","0","0","0","0.0","0.0","null","2023","4","2023","3","09","30"
"2023-09-30","Bureau","Legislative Branch-Office of Tech.","Open World Leadership","0","0","0","0","0","0","0.0","0.0","null","2023","4","2023","3","09","30"
"2023-09-30","Agency","Merit Systems Protection Board","null","144","1","144","1","0","0","100.0","100.0","Non-CFO","2023","4","2023","3","09","30"
"2023-09-30","Bureau","Merit Systems Protection Board","Merit Systems Protection Board","144","1","144","1","0","0","100.0","100.0","null","2023","4","2023","3","09","30"
"2023-09-30","Agency","National Aeronautics and Space Administration","null","1047677","123","1047677","123","0","0","100.0","100.0","CFO","2023","4","2023","3","09","30"
"2023-09-30","Bureau","National Aeronautics and Space Administration","National Aeronautics and Space Admin","1047677","123","1047677","123","0","0","100.0","100.0","null","2023","4","2023","3","09","30"
"2023-09-30","Agency","National Archives & Records Admin","null","126935","112","126935","112","0","0","100.0","100.0","Non-CFO","2023","4","2023","3","09","30"
"2023-09-30","Bureau","National Archives & Records Admin","Nat'l Archives & Records Administration","126935","112","126935","112","0","0","100.0","100.0","null","2023","4","2023","3","09","30"
"2023-09-30","Agency","National Credit Union Administration","null","1373","2","1373","2","0","0","100.0","100.0","Non-CFO","2023","4","2023","3","09","30"
"2023-09-30","Bureau","National Credit Union Administration","National Credit Union Administration","1373","2","1373","2","0","0","100.0","100.0","null","2023","4","2023","3","09","30"
"2023-09-30","Agency","National Foundation  Arts & Humanities","null","0","0","0","0","0","0","0.0","0.0","Non-CFO","2023","4","2023","3","09","30"
"2023-09-30","Bureau","National Foundation  Arts & Humanities","National Endowment for the Arts","0","0","0","0","0","0","0.0","0.0","null","2023","4","2023","3","09","30"
"2023-09-30","Bureau","National Foundation  Arts & Humanities","National Endowment for the Humanities","0","0","0","0","0","0","0.0","0.0","null","2023","4","2023","3","09","30"
"2023-09-30","Agency","National Labor Relations Board","null","0","0","0","0","0","0","0.0","0.0","Non-CFO","2023","4","2023","3","09","30"
"2023-09-30","Bureau","National Labor Relations Board","National Labor Relations Board","0","0","0","0","0","0","0.0","0.0","null","2023","4","2023","3","09","30"
"2023-09-30","Agency","National Science Foundation","null","710131","30","710131","30","0","0","100.0","100.0","CFO","2023","4","2023","3","09","30"
"2023-09-30","Bureau","National Science Foundation","National Science Foundation","710131","30","710131","30","0","0","100.0","100.0","null","2023","4","2023","3","09","30"
"2023-09-30","Agency","Neighborhood Reinvestment Corporation","null","0","0","0","0","0","0","0.0","0.0","Non-CFO","2023","4","2023","3","09","30"
"2023-09-30","Bureau","Neighborhood Reinvestment Corporation","Neighborhood Reinvestment Corporation","0","0","0","0","0","0","0.0","0.0","null","2023","4","2023","3","09","30"
"2023-09-30","Agency","Nuclear Regulatory Commission","null","3168818","358","3168818","358","0","0","100.0","100.0","CFO","2023","4","2023","3","09","30"
"2023-09-30","Bureau","Nuclear Regulatory Commission","Nuclear Regulatory Commission","3168818","358","3168818","358","0","0","100.0","100.0","null","2023","4","2023","3","09","30"
"2023-09-30","Agency","Occupational Safety & Health Rev Comm","null","0","0","0","0","0","0","0.0","0.0","Non-CFO","2023","4","2023","3","09","30"
"2023-09-30","Bureau","Occupational Safety & Health Rev Comm","Occupational Safety & Health Rev Comm","0","0","0","0","0","0","0.0","0.0","null","2023","4","2023","3","09","30"
"2023-09-30","Agency","Office of Compliance","null","0","0","0","0","0","0","0.0","0.0","Non-CFO","2023","4","2023","3","09","30"
"2023-09-30","Bureau","Office of Compliance","Office of Compliance","0","0","0","0","0","0","0.0","0.0","null","2023","4","2023","3","09","30"
"2023-09-30","Agency","Office of Government Ethics","null","0","0","0","0","0","0","0.0","0.0","Non-CFO","2023","4","2023","3","09","30"
"2023-09-30","Bureau","Office of Government Ethics","Office of Government Ethics","0","0","0","0","0","0","0.0","0.0","null","2023","4","2023","3","09","30"
"2023-09-30","Agency","Office of Personnel Management","null","20899877","1153","20899877","1153","0","0","100.0","100.0","CFO","2023","4","2023","3","09","30"
"2023-09-30","Bureau","Office of Personnel Management","Office of Personnel Management","20899877","1153","20899877","1153","0","0","100.0","100.0","null","2023","4","2023","3","09","30"
"2023-09-30","Agency","Office of Special Counsel","null","0","0","0","0","0","0","0.0","0.0","Non-CFO","2023","4","2023","3","09","30"
"2023-09-30","Bureau","Office of Special Counsel","Office of Special Counsel","0","0","0","0","0","0","0.0","0.0","null","2023","4","2023","3","09","30"
"2023-09-30","Agency","Other Agencies","null","844031","85","526022","7","318009","78","62.32259241662925","8.235294117647058","Non-CFO","2023","4","2023","3","09","30"
"2023-09-30","Bureau","Other Agencies","Advisory Council on Hist. Preservation","0","0","0","0","0","0","0.0","0.0","null","2023","4","2023","3","09","30"
"2023-09-30","Bureau","Other Agencies","Archit.&Trans. Barriers Compliance Bd","0","0","0","0","0","0","0.0","0.0","null","2023","4","2023","3","09","30"
"2023-09-30","Bureau","Other Agencies","Architect of the Capitol","92743","34","0","0","92743","34","0.0","0.0","null","2023","4","2023","3","09","30"
"2023-09-30","Bureau","Other Agencies","Chemical Safety Board","14952","1","14952","1","0","0","100.0","100.0","null","2023","4","2023","3","09","30"
"2023-09-30","Bureau","Other Agencies","Comm. for Purchase from Blind/Handic.","0","0","0","0","0","0","0.0","0.0","null","2023","4","2023","3","09","30"
"2023-09-30","Bureau","Other Agencies","Commission On Fine Arts","0","0","0","0","0","0","0.0","0.0","null","2023","4","2023","3","09","30"
"2023-09-30","Bureau","Other Agencies","Consumer Financial Protection Bureau","515496","13","511070","6","4426","7","99.14140943867653","46.15384615384615","null","2023","4","2023","3","09","30"
"2023-09-30","Bureau","Other Agencies","Council of Insps. Gen. of Intg. & Effy.","2894","6","0","0","2894","6","0.0","0.0","null","2023","4","2023","3","09","30"
"2023-09-30","Bureau","Other Agencies","Defense Nuclear Facilities Safety Board","0","0","0","0","0","0","0.0","0.0","null","2023","4","2023","3","09","30"
"2023-09-30","Bureau","Other Agencies","Delta Regional Authority","0","0","0","0","0","0","0.0","0.0","null","2023","4","2023","3","09","30"
"2023-09-30","Bureau","Other Agencies","Denali Commission","0","0","0","0","0","0","0.0","0.0","null","2023","4","2023","3","09","30"
"2023-09-30","Bureau","Other Agencies","District of Columbia Government","0","0","0","0","0","0","0.0","0.0","null","2023","4","2023","3","09","30"
"2023-09-30","Bureau","Other Agencies","Election Assistance Commission","5576","1","0","0","5576","1","0.0","0.0","null","2023","4","2023","3","09","30"
"2023-09-30","Bureau","Other Agencies","Federal Housing Finance Agency","0","0","0","0","0","0","0.0","0.0","null","2023","4","2023","3","09","30"
"2023-09-30","Bureau","Other Agencies","Federal Housing Finance Agency OIG","0","0","0","0","0","0","0.0","0.0","null","2023","4","2023","3","09","30"
"2023-09-30","Bureau","Other Agencies","Federal Mine Safety & Health Review Comm","0","0","0","0","0","0","0.0","0.0","null","2023","4","2023","3","09","30"
"2023-09-30","Bureau","Other Agencies","Gulf Coast Ecosystem Restoration Council","0","0","0","0","0","0","0.0","0.0","null","2023","4","2023","3","09","30"
"2023-09-30","Bureau","Other Agencies","James Madison Memorial Fellowship","201616","25","0","0","201616","25","0.0","0.0","null","2023","4","2023","3","09","30"
"2023-09-30","Bureau","Other Agencies","John C. Stennis","1467","2","0","0","1467","2","0.0","0.0","null","2023","4","2023","3","09","30"
"2023-09-30","Bureau","Other Agencies","Millennium Challenge Corporation","0","0","0","0","0","0","0.0","0.0","null","2023","4","2023","3","09","30"
"2023-09-30","Bureau","Other Agencies","Morris K. Udall Scholarship","0","0","0","0","0","0","0.0","0.0","null","2023","4","2023","3","09","30"
"2023-09-30","Bureau","Other Agencies","National Capital Planning Commission","0","0","0","0","0","0","0.0","0.0","null","2023","4","2023","3","09","30"
"2023-09-30","Bureau","Other Agencies","National Council on Disability","0","0","0","0","0","0","0.0","0.0","null","2023","4","2023","3","09","30"
"2023-09-30","Bureau","Other Agencies","National Mediation Board","0","0","0","0","0","0","0.0","0.0","null","2023","4","2023","3","09","30"
"2023-09-30","Bureau","Other Agencies","National Transportation Safety Board","428","1","0","0","428","1","0.0","0.0","null","2023","4","2023","3","09","30"
"2023-09-30","Bureau","Other Agencies","Privacy & Civil Liberties Oversight Bd","0","0","0","0","0","0","0.0","0.0","null","2023","4","2023","3","09","30"
"2023-09-30","Bureau","Other Agencies","Surface Transportation Board","0","0","0","0","0","0","0.0","0.0","null","2023","4","2023","3","09","30"
"2023-09-30","Bureau","Other Agencies","U.S.  Agency of Global Media","0","0","0","0","0","0","0.0","0.0","null","2023","4","2023","3","09","30"
"2023-09-30","Bureau","Other Agencies","U.S. Holocaust Memorial Council","0","0","0","0","0","0","0.0","0.0","null","2023","4","2023","3","09","30"
"2023-09-30","Bureau","Other Agencies","U.S. Inst. for Env. Conflict Resolution","8859","2","0","0","8859","2","0.0","0.0","null","2023","4","2023","3","09","30"
"2023-09-30","Bureau","Other Agencies","U.S. Institute of Peace","0","0","0","0","0","0","0.0","0.0","null","2023","4","2023","3","09","30"
"2023-09-30","Agency","Other Agencies/Boards/Commissions","null","1024","1","0","0","1024","1","0.0","0.0","Non-CFO","2023","4","2023","3","09","30"
"2023-09-30","Bureau","Other Agencies/Boards/Commissions","Medicare Payment Advisory Commission","0","0","0","0","0","0","0.0","0.0","null","2023","4","2023","3","09","30"
"2023-09-30","Bureau","Other Agencies/Boards/Commissions","Nuclear Waste Technical Review Board","0","0","0","0","0","0","0.0","0.0","null","2023","4","2023","3","09","30"
"2023-09-30","Bureau","Other Agencies/Boards/Commissions","U.S. Comm. on Int. Religious Freedom","1024","1","0","0","1024","1","0.0","0.0","null","2023","4","2023","3","09","30"
"2023-09-30","Bureau","Other Agencies/Boards/Commissions","U.S.-China Security Review Commission","0","0","0","0","0","0","0.0","0.0","null","2023","4","2023","3","09","30"
"2023-09-30","Agency","Pension Benefit Guaranty Corp","null","4645894","1683","4645894","1683","0","0","100.0","100.0","Non-CFO","2023","4","2023","3","09","30"
"2023-09-30","Bureau","Pension Benefit Guaranty Corp","Pension Benefit Guaranty Corporation","4645894","1683","4645894","1683","0","0","100.0","100.0","null","2023","4","2023","3","09","30"
"2023-09-30","Agency","Presidio Trust Corporation","null","1324482","60","1324482","60","0","0","100.0","100.0","Non-CFO","2023","4","2023","3","09","30"
"2023-09-30","Bureau","Presidio Trust Corporation","Presidio Trust Corporation","1324482","60","1324482","60","0","0","100.0","100.0","null","2023","4","2023","3","09","30"
"2023-09-30","Agency","Railroad Retirement Board","null","21719276","4441","21719276","4441","0","0","100.0","100.0","Non-CFO","2023","4","2023","3","09","30"
"2023-09-30","Bureau","Railroad Retirement Board","Railroad Retirement Board","21719276","4441","21719276","4441","0","0","100.0","100.0","null","2023","4","2023","3","09","30"
"2023-09-30","Agency","Securities & Exchange Commission","null","2742794931","1526","2742794931","1526","0","0","100.0","100.0","Non-CFO","2023","4","2023","3","09","30"
"2023-09-30","Bureau","Securities & Exchange Commission","SEC Enforcement","2742536241","1480","2742536241","1480","0","0","100.0","100.0","null","2023","4","2023","3","09","30"
"2023-09-30","Bureau","Securities & Exchange Commission","Securities and Exchange Commission","258690","46","258690","46","0","0","100.0","100.0","null","2023","4","2023","3","09","30"
"2023-09-30","Agency","Selective Service System","null","1301","4","0","0","1301","4","0.0","0.0","Non-CFO","2023","4","2023","3","09","30"
"2023-09-30","Bureau","Selective Service System","Selective Service System","1301","4","0","0","1301","4","0.0","0.0","null","2023","4","2023","3","09","30"
"2023-09-30","Agency","Small Business Administration","null","18648730593","148450","18648730593","148450","0","0","100.0","100.0","CFO","2023","4","2023","3","09","30"
"2023-09-30","Bureau","Small Business Administration","Small Business Administration","18648730593","148450","18648730593","148450","0","0","100.0","100.0","null","2023","4","2023","3","09","30"
"2023-09-30","Agency","Smithsonian Institution","null","783","12","0","0","783","12","0.0","0.0","Non-CFO","2023","4","2023","3","09","30"
"2023-09-30","Bureau","Smithsonian Institution","Administrative Conference of the US","0","0","0","0","0","0","0.0","0.0","null","2023","4","2023","3","09","30"
"2023-09-30","Bureau","Smithsonian Institution","JFK Center for the Performing Arts","0","0","0","0","0","0","0.0","0.0","null","2023","4","2023","3","09","30"
"2023-09-30","Bureau","Smithsonian Institution","National Gallery of Art","0","0","0","0","0","0","0.0","0.0","null","2023","4","2023","3","09","30"
"2023-09-30","Bureau","Smithsonian Institution","Smithsonian Institution","783","12","0","0","783","12","0.0","0.0","null","2023","4","2023","3","09","30"
"2023-09-30","Agency","Social Security Administration","null","4239136715","1307764","2414015437","411685","1825121278","896079","56.94592081586121","31.48006826919842","CFO","2023","4","2023","3","09","30"
"2023-09-30","Bureau","Social Security Administration","Social Security Administration","4239136715","1307764","2414015437","411685","1825121278","896079","56.94592081586121","31.48006826919842","null","2023","4","2023","3","09","30"
"2023-09-30","Agency","Tennessee Valley Authority","null","0","0","0","0","0","0","0.0","0.0","Non-CFO","2023","4","2023","3","09","30"
"2023-09-30","Bureau","Tennessee Valley Authority","Tennessee Valley Authority","0","0","0","0","0","0","0.0","0.0","null","2023","4","2023","3","09","30"
"2023-09-30","Agency","The Judiciary","null","1046423","307","1034456","180","11967","127","98.85638981559083","58.63192182410423","Non-CFO","2023","4","2023","3","09","30"
"2023-09-30","Bureau","The Judiciary","Administrative Office of the U.S. Courts","1046423","307","1034456","180","11967","127","98.85638981559083","58.63192182410423","null","2023","4","2023","3","09","30"
"2023-09-30","Agency","U.S. Court of Appeals / Veterans Claims","null","0","0","0","0","0","0","0.0","0.0","Non-CFO","2023","4","2023","3","09","30"
"2023-09-30","Bureau","U.S. Court of Appeals / Veterans Claims","U.S. Court of Appeals / Veterans Claims","0","0","0","0","0","0","0.0","0.0","null","2023","4","2023","3","09","30"
"2023-09-30","Agency","U.S. Postal Service","null","82151519","78279","68790509","64604","13361010","13675","83.73613761177076","82.53043600454784","Non-CFO","2023","4","2023","3","09","30"
"2023-09-30","Bureau","U.S. Postal Service","U.S. Postal Service","82151519","78279","68790509","64604","13361010","13675","83.73613761177076","82.53043600454784","null","2023","4","2023","3","09","30"
"2023-09-30","Agency","U.S. Tax Court","null","0","0","0","0","0","0","0.0","0.0","Non-CFO","2023","4","2023","3","09","30"
"2023-09-30","Bureau","U.S. Tax Court","U.S. Tax Court","0","0","0","0","0","0","0.0","0.0","null","2023","4","2023","3","09","30"
"2023-09-30","Agency","US International Development Fin. Corp.","null","76307492","11","76307492","11","0","0","100.0","100.0","Non-CFO","2023","4","2023","3","09","30"
"2023-09-30","Bureau","US International Development Fin. Corp.","US International Development Fin. Corp.","76307492","11","76307492","11","0","0","100.0","100.0","null","2023","4","2023","3","09","30"
"2023-06-30","Agency","Agency for International Development","null","25881204","53","25880932","52","272","1","99.99894904425621","98.11320754716981","CFO","2023","3","2023","2","06","30"
"2023-06-30","Bureau","Agency for International Development","Agency for International Development","25881204","53","25880932","52","272","1","99.99894904425621","98.11320754716981","null","2023","3","2023","2","06","30"
"2023-06-30","Agency","American Battle Monuments Commission","null","0","0","0","0","0","0","0.0","0.0","Non-CFO","2023","3","2023","2","06","30"
"2023-06-30","Bureau","American Battle Monuments Commission","American Battle Monuments Commission","0","0","0","0","0","0","0.0","0.0","null","2023","3","2023","2","06","30"
"2023-06-30","Agency","Armed Forces Retirement Home","null","84736","105","77021","102","7715","3","90.89525113293051","97.14285714285714","Non-CFO","2023","3","2023","2","06","30"
"2023-06-30","Bureau","Armed Forces Retirement Home","Armed Forces Retirement Home","84736","105","77021","102","7715","3","90.89525113293051","97.14285714285714","null","2023","3","2023","2","06","30"
"2023-06-30","Agency","Commodity Futures Trading Commission","null","627349991","360","627349991","360","0","0","100.0","100.0","Non-CFO","2023","3","2023","2","06","30"
"2023-06-30","Bureau","Commodity Futures Trading Commission","Commodity Futures Trading Commission","627349991","360","627349991","360","0","0","100.0","100.0","null","2023","3","2023","2","06","30"
"2023-06-30","Agency","Consumer Product Safety Commission","null","531","3","531","3","0","0","100.0","100.0","Non-CFO","2023","3","2023","2","06","30"
"2023-06-30","Bureau","Consumer Product Safety Commission","Consumer Product Safety Commission","531","3","531","3","0","0","100.0","100.0","null","2023","3","2023","2","06","30"
"2023-06-30","Agency","Corp. for National and Community Service","null","3758350","324","3602948","148","155402","176","95.86515359133662","45.67901234567901","Non-CFO","2023","3","2023","2","06","30"
"2023-06-30","Bureau","Corp. for National and Community Service","Corp. for National and Community Service","3758350","324","3602948","148","155402","176","95.86515359133662","45.67901234567901","null","2023","3","2023","2","06","30"
"2023-06-30","Agency","Department of Agriculture","null","1329884406","48279","1309479344","44542","20405062","3737","98.46565145752976","92.25957455622527","CFO","2023","3","2023","2","06","30"
"2023-06-30","Bureau","Department of Agriculture","Agricultural Marketing Service","6637434","2202","3847193","1204","2790241","998","57.96205280534616","54.677565849227975","null","2023","3","2023","2","06","30"
"2023-06-30","Bureau","Department of Agriculture","Commodity Credit Corporation","114338049","9365","114338049","9365","0","0","100.0","100.0","null","2023","3","2023","2","06","30"
"2023-06-30","Bureau","Department of Agriculture","Farm Service Agency","327586870","3153","327586870","3153","0","0","100.0","100.0","null","2023","3","2023","2","06","30"
"2023-06-30","Bureau","Department of Agriculture","Federal Crop Insurance Corporation","7857","5","7857","5","0","0","100.0","100.0","null","2023","3","2023","2","06","30"
"2023-06-30","Bureau","Department of Agriculture","Food Safety and Inspection Service","1139412","1184","1100662","1145","38750","39","96.59912305645368","96.70608108108108","null","2023","3","2023","2","06","30"
"2023-06-30","Bureau","Department of Agriculture","Food and Nutrition Service","4107055","39","40975","18","4066080","21","0.9976735154508523","46.15384615384615","null","2023","3","2023","2","06","30"
"2023-06-30","Bureau","Department of Agriculture","Forest Service","10220684","1406","0","0","10220684","1406","0.0","0.0","null","2023","3","2023","2","06","30"
"2023-06-30","Bureau","Department of Agriculture","Rural Development","844309075","27225","844299987","27217","9088","8","99.99892361692311","99.97061524334252","null","2023","3","2023","2","06","30"
"2023-06-30","Bureau","Department of Agriculture","U.S. Department of Agriculture","21537970","3700","18257751","2435","3280219","1265","84.77006421682266","65.8108108108108","null","2023","3","2023","2","06","30"
"2023-06-30","Agency","Department of Commerce","null","59859537","17691","59859537","17691","0","0","100.0","100.0","CFO","2023","3","2023","2","06","30"
"2023-06-30","Bureau","Department of Commerce","Bureau of Industry and Security","37545771","27","37545771","27","0","0","100.0","100.0","null","2023","3","2023","2","06","30"
"2023-06-30","Bureau","Department of Commerce","Bureau of the Census","2199232","15933","2199232","15933","0","0","100.0","100.0","null","2023","3","2023","2","06","30"
"2023-06-30","Bureau","Department of Commerce","Economic Development Administration","5153780","13","5153780","13","0","0","100.0","100.0","null","2023","3","2023","2","06","30"
"2023-06-30","Bureau","Department of Commerce","Economic and Statistical Analysis","0","0","0","0","0","0","0.0","0.0","null","2023","3","2023","2","06","30"
"2023-06-30","Bureau","Department of Commerce","General Administration","4660","1","4660","1","0","0","100.0","100.0","null","2023","3","2023","2","06","30"
"2023-06-30","Bureau","Department of Commerce","International Trade Administration","0","0","0","0","0","0","0.0","0.0","null","2023","3","2023","2","06","30"
"2023-06-30","Bureau","Department of Commerce","Minority Business Development Agency","0","0","0","0","0","0","0.0","0.0","null","2023","3","2023","2","06","30"
"2023-06-30","Bureau","Department of Commerce","NOAA","13080057","1009","13080057","1009","0","0","100.0","100.0","null","2023","3","2023","2","06","30"
"2023-06-30","Bureau","Department of Commerce","Nat'l Institute of Standards& Technology","1087068","4","1087068","4","0","0","100.0","100.0","null","2023","3","2023","2","06","30"
"2023-06-30","Bureau","Department of Commerce","Nat'l Telecomm & Information Admin.","296093","1","296093","1","0","0","100.0","100.0","null","2023","3","2023","2","06","30"
"2023-06-30","Bureau","Department of Commerce","National Technical Information Service","0","0","0","0","0","0","0.0","0.0","null","2023","3","2023","2","06","30"
"2023-06-30","Bureau","Department of Commerce","Office of the Inspector General","0","0","0","0","0","0","0.0","0.0","null","2023","3","2023","2","06","30"
"2023-06-30","Bureau","Department of Commerce","Patent and Trademark Office","492876","703","492876","703","0","0","100.0","100.0","null","2023","3","2023","2","06","30"
"2023-06-30","Agency","Department of Defense","null","3211484923","1738597","1076130710","294827","2135354213","1443770","33.50882024365026","16.957753867054873","CFO","2023","3","2023","2","06","30"
"2023-06-30","Bureau","Department of Defense","Consolidated Report","3211484923","1738597","1076130710","294827","2135354213","1443770","33.50882024365026","16.957753867054873","null","2023","3","2023","2","06","30"
"2023-06-30","Agency","Department of Education","null","119638749294","20304812","119633234646","20304738","5514648","74","99.99539058370925","99.99963555437007","CFO","2023","3","2023","2","06","30"
"2023-06-30","Bureau","Department of Education","Departmental Management","1444061503","2052","1438546855","1978","5514648","74","99.6181154342427","96.39376218323586","null","2023","3","2023","2","06","30"
"2023-06-30","Bureau","Department of Education","Federal Student Aid","118194687791","20302760","118194687791","20302760","0","0","100.0","100.0","null","2023","3","2023","2","06","30"
"2023-06-30","Bureau","Department of Education","Office of Postsecondary Education","0","0","0","0","0","0","0.0","0.0","null","2023","3","2023","2","06","30"
"2023-06-30","Agency","Department of Energy","null","14276675","95","14276675","95","0","0","100.0","100.0","CFO","2023","3","2023","2","06","30"
"2023-06-30","Bureau","Department of Energy","Bonneville Power Administration","1058470","28","1058470","28","0","0","100.0","100.0","null","2023","3","2023","2","06","30"
"2023-06-30","Bureau","Department of Energy","Energy Consolidated Reports","13218205","67","13218205","67","0","0","100.0","100.0","null","2023","3","2023","2","06","30"
"2023-06-30","Agency","Department of Health & Human Services","null","10813842379","1183866","10569310688","1153983","244531691","29883","97.73871596764837","97.47581229632408","CFO","2023","3","2023","2","06","30"
"2023-06-30","Bureau","Department of Health & Human Services","Administration for Children and Families","37371711","1606","37371711","1606","0","0","100.0","100.0","null","2023","3","2023","2","06","30"
"2023-06-30","Bureau","Department of Health & Human Services","Administration for Community Living","0","0","0","0","0","0","0.0","0.0","null","2023","3","2023","2","06","30"
"2023-06-30","Bureau","Department of Health & Human Services","Centers for Disease Control","7785027","97","200379","20","7584648","77","2.5739024411861386","20.61855670103093","null","2023","3","2023","2","06","30"
"2023-06-30","Bureau","Department of Health & Human Services","Centers for Medicare & Medicaid Services","10352280295","1151000","10274687838","1145016","77592457","5984","99.25047955823341","99.48010425716768","null","2023","3","2023","2","06","30"
"2023-06-30","Bureau","Department of Health & Human Services","Food and Drug Administration","196849385","25045","56537473","2007","140311912","23038","28.72118345708827","8.013575563984828","null","2023","3","2023","2","06","30"
"2023-06-30","Bureau","Department of Health & Human Services","Health Resources and Services Admin","112964023","642","112964023","642","0","0","100.0","100.0","null","2023","3","2023","2","06","30"
"2023-06-30","Bureau","Department of Health & Human Services","Indian Health Services","72455132","4280","72455132","4280","0","0","100.0","100.0","null","2023","3","2023","2","06","30"
"2023-06-30","Bureau","Department of Health & Human Services","National Institutes of Health","26627049","912","7584375","128","19042674","784","28.483723449789725","14.035087719298245","null","2023","3","2023","2","06","30"
"2023-06-30","Bureau","Department of Health & Human Services","Office of the Inspector General","33600","1","33600","1","0","0","100.0","100.0","null","2023","3","2023","2","06","30"
"2023-06-30","Bureau","Department of Health & Human Services","Office of the Secretary","8375","7","8375","7","0","0","100.0","100.0","null","2023","3","2023","2","06","30"
"2023-06-30","Bureau","Department of Health & Human Services","Program Support Center","6409009","265","6409009","265","0","0","100.0","100.0","null","2023","3","2023","2","06","30"
"2023-06-30","Bureau","Department of Health & Human Services","Substance Abuse & Mental Health Admin.","1058773","11","1058773","11","0","0","100.0","100.0","null","2023","3","2023","2","06","30"
"2023-06-30","Agency","Department of Homeland Security","null","262832054","71193","245650528","56215","17181526","14978","93.46292594890272","78.96141474583175","CFO","2023","3","2023","2","06","30"
"2023-06-30","Bureau","Department of Homeland Security","Bureau of Customs & Border Protection","9556269","916","9556269","916","0","0","100.0","100.0","null","2023","3","2023","2","06","30"
"2023-06-30","Bureau","Department of Homeland Security","Citizenship and Immigration Services","1121143","1348","1121143","1348","0","0","100.0","100.0","null","2023","3","2023","2","06","30"
"2023-06-30","Bureau","Department of Homeland Security","Domestic Nuclear Detection Office","2069","20","0","0","2069","20","0.0","0.0","null","2023","3","2023","2","06","30"
"2023-06-30","Bureau","Department of Homeland Security","Emergency Preparedness & Resp","205717987","38982","205717987","38982","0","0","100.0","100.0","null","2023","3","2023","2","06","30"
"2023-06-30","Bureau","Department of Homeland Security","Federal Law Enforcement Training Ctr.","8562","1","8562","1","0","0","100.0","100.0","null","2023","3","2023","2","06","30"
"2023-06-30","Bureau","Department of Homeland Security","Immigration and Customs Enforcement","16436204","645","16436204","645","0","0","100.0","100.0","null","2023","3","2023","2","06","30"
"2023-06-30","Bureau","Department of Homeland Security","Info Analysis Infrastructure Prot-NPPD","0","0","0","0","0","0","0.0","0.0","null","2023","3","2023","2","06","30"
"2023-06-30","Bureau","Department of Homeland Security","Management Headquarters","0","0","0","0","0","0","0.0","0.0","null","2023","3","2023","2","06","30"
"2023-06-30","Bureau","Department of Homeland Security","Office of Biometric Identity Management","0","0","0","0","0","0","0.0","0.0","null","2023","3","2023","2","06","30"
"2023-06-30","Bureau","Department of Homeland Security","Office of the Inspector General DHS","100","1","100","1","0","0","100.0","100.0","null","2023","3","2023","2","06","30"
"2023-06-30","Bureau","Department of Homeland Security","Science and Technology","0","0","0","0","0","0","0.0","0.0","null","2023","3","2023","2","06","30"
"2023-06-30","Bureau","Department of Homeland Security","Transportation Safety Administration","11550989","12895","11550989","12895","0","0","100.0","100.0","null","2023","3","2023","2","06","30"
"2023-06-30","Bureau","Department of Homeland Security","U.S. Coast Guard","18438731","16385","1259274","1427","17179457","14958","6.829504698560871","8.709185230393652","null","2023","3","2023","2","06","30"
"2023-06-30","Bureau","Department of Homeland Security","U.S. Secret Service","0","0","0","0","0","0","0.0","0.0","null","2023","3","2023","2","06","30"
"2023-06-30","Agency","Department of Housing and Urban Development","null","56498075","2265","56475737","2262","22338","3","99.96046236973561","99.86754966887418","CFO","2023","3","2023","2","06","30"
"2023-06-30","Bureau","Department of Housing and Urban Development","Community Planning and Development","0","0","0","0","0","0","0.0","0.0","null","2023","3","2023","2","06","30"
"2023-06-30","Bureau","Department of Housing and Urban Development","Government National Mortgage Association","0","0","0","0","0","0","0.0","0.0","null","2023","3","2023","2","06","30"
"2023-06-30","Bureau","Department of Housing and Urban Development","Housing Programs","56493369","2264","56471031","2261","22338","3","99.96045907617936","99.86749116607774","null","2023","3","2023","2","06","30"
"2023-06-30","Bureau","Department of Housing and Urban Development","Management and Administration","4706","1","4706","1","0","0","100.0","100.0","null","2023","3","2023","2","06","30"
"2023-06-30","Bureau","Department of Housing and Urban Development","Policy, Development and Research","0","0","0","0","0","0","0.0","0.0","null","2023","3","2023","2","06","30"
"2023-06-30","Bureau","Department of Housing and Urban Development","Public and Indian Housing Programs","0","0","0","0","0","0","0.0","0.0","null","2023","3","2023","2","06","30"
"2023-06-30","Agency","Department of Justice","null","92624177","39273","89308886","38805","3315291","468","96.4207066584786","98.80834160873883","CFO","2023","3","2023","2","06","30"
"2023-06-30","Bureau","Department of Justice","Bureau of ATF and Explosives","19881","1","19881","1","0","0","100.0","100.0","null","2023","3","2023","2","06","30"
"2023-06-30","Bureau","Department of Justice","Drug Enforcement Administration","343044","15","343044","15","0","0","100.0","100.0","null","2023","3","2023","2","06","30"
"2023-06-30","Bureau","Department of Justice","Federal Bureau of Investigation","478036","112","478036","112","0","0","100.0","100.0","null","2023","3","2023","2","06","30"
"2023-06-30","Bureau","Department of Justice","Federal Prison Industries","237857","62","0","0","237857","62","0.0","0.0","null","2023","3","2023","2","06","30"
"2023-06-30","Bureau","Department of Justice","Federal Prison System","0","0","0","0","0","0","0.0","0.0","null","2023","3","2023","2","06","30"
"2023-06-30","Bureau","Department of Justice","General Administration","0","0","0","0","0","0","0.0","0.0","null","2023","3","2023","2","06","30"
"2023-06-30","Bureau","Department of Justice","Legal Activities","90161552","39077","87084118","38671","3077434","406","96.58675573818871","98.96102566727231","null","2023","3","2023","2","06","30"
"2023-06-30","Bureau","Department of Justice","Office of Justice Assistance Programs","1383807","6","1383807","6","0","0","100.0","100.0","null","2023","3","2023","2","06","30"
"2023-06-30","Bureau","Department of Justice","U.S. Marshals Service","0","0","0","0","0","0","0.0","0.0","null","2023","3","2023","2","06","30"
"2023-06-30","Agency","Department of Labor","null","155892035","12000","141693187","9320","14198848","2680","90.89187077453957","77.66666666666667","CFO","2023","3","2023","2","06","30"
"2023-06-30","Bureau","Department of Labor","Bureau of Labor Statistics","4781","1","4781","1","0","0","100.0","100.0","null","2023","3","2023","2","06","30"
"2023-06-30","Bureau","Department of Labor","Departmental Management","0","0","0","0","0","0","0.0","0.0","null","2023","3","2023","2","06","30"
"2023-06-30","Bureau","Department of Labor","Employee Benefit Security Administration","21587961","469","21587961","469","0","0","100.0","100.0","null","2023","3","2023","2","06","30"
"2023-06-30","Bureau","Department of Labor","Employment Standards Administration","64302798","3509","57483262","2091","6819536","1418","89.3946512249747","59.58962667426617","null","2023","3","2023","2","06","30"
"2023-06-30","Bureau","Department of Labor","Employment and Training Administration","885054","10","885054","10","0","0","100.0","100.0","null","2023","3","2023","2","06","30"
"2023-06-30","Bureau","Department of Labor","Mine Safety and Health Administration","10297508","3871","8914002","3575","1383506","296","86.56465234112953","92.35339705502454","null","2023","3","2023","2","06","30"
"2023-06-30","Bureau","Department of Labor","Occupational Safety and Health Admin","58813933","4140","52818127","3174","5995806","966","89.80546667402774","76.66666666666667","null","2023","3","2023","2","06","30"
"2023-06-30","Agency","Department of State","null","22314789","20917","21984580","20878","330209","39","98.52022351634156","99.81354878806712","CFO","2023","3","2023","2","06","30"
"2023-06-30","Bureau","Department of State","Department of State","20524467","9378","20194258","9339","330209","39","98.39114457880927","99.58413307741523","null","2023","3","2023","2","06","30"
"2023-06-30","Bureau","Department of State","International Commissions","0","0","0","0","0","0","0.0","0.0","null","2023","3","2023","2","06","30"
"2023-06-30","Bureau","Department of State","Passport NSF","1790322","11539","1790322","11539","0","0","100.0","100.0","null","2023","3","2023","2","06","30"
"2023-06-30","Agency","Department of Transportation","null","80519033","8713","80519033","8713","0","0","100.0","100.0","CFO","2023","3","2023","2","06","30"
"2023-06-30","Bureau","Department of Transportation","Federal Aviation Administration","2144034","266","2144034","266","0","0","100.0","100.0","null","2023","3","2023","2","06","30"
"2023-06-30","Bureau","Department of Transportation","Federal Highway Administration","12219","10","12219","10","0","0","100.0","100.0","null","2023","3","2023","2","06","30"
"2023-06-30","Bureau","Department of Transportation","Federal Motor Carrier Safety Admin","74850288","8281","74850288","8281","0","0","100.0","100.0","null","2023","3","2023","2","06","30"
"2023-06-30","Bureau","Department of Transportation","Federal Railroad Administration","145373","14","145373","14","0","0","100.0","100.0","null","2023","3","2023","2","06","30"
"2023-06-30","Bureau","Department of Transportation","Federal Transit Administration","787343","4","787343","4","0","0","100.0","100.0","null","2023","3","2023","2","06","30"
"2023-06-30","Bureau","Department of Transportation","Maritime Administration","61389","12","61389","12","0","0","100.0","100.0","null","2023","3","2023","2","06","30"
"2023-06-30","Bureau","Department of Transportation","National Highway Traffic Safety Admin.","36618","6","36618","6","0","0","100.0","100.0","null","2023","3","2023","2","06","30"
"2023-06-30","Bureau","Department of Transportation","Office of the Inspector General","3288","1","3288","1","0","0","100.0","100.0","null","2023","3","2023","2","06","30"
"2023-06-30","Bureau","Department of Transportation","Office of the Secretary","1197151","16","1197151","16","0","0","100.0","100.0","null","2023","3","2023","2","06","30"
"2023-06-30","Bureau","Department of Transportation","Pipeline Hazardous Material Safety Admin","1250652","95","1250652","95","0","0","100.0","100.0","null","2023","3","2023","2","06","30"
"2023-06-30","Bureau","Department of Transportation","Research Innovative Technology Admin","22950","6","22950","6","0","0","100.0","100.0","null","2023","3","2023","2","06","30"
"2023-06-30","Bureau","Department of Transportation","St. Lawrence Seaway Development Corp.","7728","2","7728","2","0","0","100.0","100.0","null","2023","3","2023","2","06","30"
"2023-06-30","Agency","Department of Veterans Affairs","null","209980991","3078149","207204798","3074069","2776193","4080","98.67788365662109","99.86745281011413","CFO","2023","3","2023","2","06","30"
"2023-06-30","Bureau","Department of Veterans Affairs","Administration and Cemeteries","3355743","779","2844718","461","511025","318","84.77162881662869","59.178433889602054","null","2023","3","2023","2","06","30"
"2023-06-30","Bureau","Department of Veterans Affairs","Housing Credit Assistance","378701","14","0","0","378701","14","0.0","0.0","null","2023","3","2023","2","06","30"
"2023-06-30","Bureau","Department of Veterans Affairs","Life Insurance","1222848","255","1222848","255","0","0","100.0","100.0","null","2023","3","2023","2","06","30"
"2023-06-30","Bureau","Department of Veterans Affairs","Medical and Construction","203799648","3075475","203137232","3073353","662416","2122","99.67496705391758","99.93100252806477","null","2023","3","2023","2","06","30"
"2023-06-30","Bureau","Department of Veterans Affairs","Veterans Benefits","1224051","1626","0","0","1224051","1626","0.0","0.0","null","2023","3","2023","2","06","30"
"2023-06-30","Agency","Department of the Interior","null","86449328","30777","86428869","30669","20459","108","99.97633411332012","99.6490886051272","CFO","2023","3","2023","2","06","30"
"2023-06-30","Bureau","Department of the Interior","Bureau of Indian Affairs","24401906","26243","24392376","26137","9530","106","99.96094567366991","99.59608276492779","null","2023","3","2023","2","06","30"
"2023-06-30","Bureau","Department of the Interior","Bureau of Land Management","9053672","377","9053672","377","0","0","100.0","100.0","null","2023","3","2023","2","06","30"
"2023-06-30","Bureau","Department of the Interior","Bureau of Ocean Energy Mgmt., Reg & Enf","1333","1","1333","1","0","0","100.0","100.0","null","2023","3","2023","2","06","30"
"2023-06-30","Bureau","Department of the Interior","Bureau of Reclamation","7386879","65","7386879","65","0","0","100.0","100.0","null","2023","3","2023","2","06","30"
"2023-06-30","Bureau","Department of the Interior","Bureau of Safety and Environmental Enf.","7653","3","7653","3","0","0","100.0","100.0","null","2023","3","2023","2","06","30"
"2023-06-30","Bureau","Department of the Interior","Fish and Wildlife Service","796491","96","796491","96","0","0","100.0","100.0","null","2023","3","2023","2","06","30"
"2023-06-30","Bureau","Department of the Interior","Geological Survey","222765","1051","222765","1051","0","0","100.0","100.0","null","2023","3","2023","2","06","30"
"2023-06-30","Bureau","Department of the Interior","National Park Service","8671607","1983","8671607","1983","0","0","100.0","100.0","null","2023","3","2023","2","06","30"
"2023-06-30","Bureau","Department of the Interior","Office of Natural Resources Revenue","27597245","568","27597245","568","0","0","100.0","100.0","null","2023","3","2023","2","06","30"
"2023-06-30","Bureau","Department of the Interior","Office of Surface Mining","8289085","374","8278156","372","10929","2","99.8681519130278","99.46524064171123","null","2023","3","2023","2","06","30"
"2023-06-30","Bureau","Department of the Interior","Office of the Secretary","20692","16","20692","16","0","0","100.0","100.0","null","2023","3","2023","2","06","30"
"2023-06-30","Agency","Department of the Treasury","null","45940908","4583","45565059","4564","375849","19","99.18188600016352","99.58542439450142","CFO","2023","3","2023","2","06","30"
"2023-06-30","Bureau","Department of the Treasury","Bureau of Engraving and Printing","38345","2","38345","2","0","0","100.0","100.0","null","2023","3","2023","2","06","30"
"2023-06-30","Bureau","Department of the Treasury","Bureau of the Fiscal Service","13580224","3130","13580224","3130","0","0","100.0","100.0","null","2023","3","2023","2","06","30"
"2023-06-30","Bureau","Department of the Treasury","Community Dev Financial Inst Fund","3627497","8","3627497","8","0","0","100.0","100.0","null","2023","3","2023","2","06","30"
"2023-06-30","Bureau","Department of the Treasury","Comptroller of the Currency","1426568","28","1417017","21","9551","7","99.33049108069156","75.0","null","2023","3","2023","2","06","30"
"2023-06-30","Bureau","Department of the Treasury","D.C. Pension Program","428404","18","428404","18","0","0","100.0","100.0","null","2023","3","2023","2","06","30"
"2023-06-30","Bureau","Department of the Treasury","Departmental Offices","20977477","1324","20757775","1315","219702","9","98.95267672084684","99.3202416918429","null","2023","3","2023","2","06","30"
"2023-06-30","Bureau","Department of the Treasury","Financial Crimes Enforcement Network","1544945","3","1544945","3","0","0","100.0","100.0","null","2023","3","2023","2","06","30"
"2023-06-30","Bureau","Department of the Treasury","Interest on Tax/Deposit of Earnings","0","0","0","0","0","0","0.0","0.0","null","2023","3","2023","2","06","30"
"2023-06-30","Bureau","Department of the Treasury","Internal Revenue Service","44464","34","44464","34","0","0","100.0","100.0","null","2023","3","2023","2","06","30"
"2023-06-30","Bureau","Department of the Treasury","International Monetary Funds","0","0","0","0","0","0","0.0","0.0","null","2023","3","2023","2","06","30"
"2023-06-30","Bureau","Department of the Treasury","Office of Financial Research","268","1","268","1","0","0","100.0","100.0","null","2023","3","2023","2","06","30"
"2023-06-30","Bureau","Department of the Treasury","Office of Sec International Affairs","0","0","0","0","0","0","0.0","0.0","null","2023","3","2023","2","06","30"
"2023-06-30","Bureau","Department of the Treasury","Office of the Secretary","0","0","0","0","0","0","0.0","0.0","null","2023","3","2023","2","06","30"
"2023-06-30","Bureau","Department of the Treasury","Pandemic Receivables","4099198","9","4099198","9","0","0","100.0","100.0","null","2023","3","2023","2","06","30"
"2023-06-30","Bureau","Department of the Treasury","Spec Insp Gen-Troubled Asset Rel Prog","3916","1","3916","1","0","0","100.0","100.0","null","2023","3","2023","2","06","30"
"2023-06-30","Bureau","Department of the Treasury","Tobacco Tax and Trade","1000","1","1000","1","0","0","100.0","100.0","null","2023","3","2023","2","06","30"
"2023-06-30","Bureau","Department of the Treasury","Treasury Forfeiture Fund","0","0","0","0","0","0","0.0","0.0","null","2023","3","2023","2","06","30"
"2023-06-30","Bureau","Department of the Treasury","Treasury Franchise Fund","0","0","0","0","0","0","0.0","0.0","null","2023","3","2023","2","06","30"
"2023-06-30","Bureau","Department of the Treasury","Treasury IG for Tax Admin","260","2","260","2","0","0","100.0","100.0","null","2023","3","2023","2","06","30"
"2023-06-30","Bureau","Department of the Treasury","U.S. Mint","168342","22","21746","19","146596","3","12.917750769267325","86.36363636363636","null","2023","3","2023","2","06","30"
"2023-06-30","Bureau","Department of the Treasury","U.S. Treasury IG Office","0","0","0","0","0","0","0.0","0.0","null","2023","3","2023","2","06","30"
"2023-06-30","Agency","Environmental Protection Agency","null","26318019","256","26318019","256","0","0","100.0","100.0","CFO","2023","3","2023","2","06","30"
"2023-06-30","Bureau","Environmental Protection Agency","Environmental Protection Agency","26318019","256","26318019","256","0","0","100.0","100.0","null","2023","3","2023","2","06","30"
"2023-06-30","Agency","Equal Employment Opportunity Commission","null","20935","19","20935","19","0","0","100.0","100.0","Non-CFO","2023","3","2023","2","06","30"
"2023-06-30","Bureau","Equal Employment Opportunity Commission","Equal Employment Opportunity Commission","20935","19","20935","19","0","0","100.0","100.0","null","2023","3","2023","2","06","30"
"2023-06-30","Agency","Export - Import  Bank","null","0","0","0","0","0","0","0.0","0.0","Non-CFO","2023","3","2023","2","06","30"
"2023-06-30","Bureau","Export - Import  Bank","Export-Import Bank","0","0","0","0","0","0","0.0","0.0","null","2023","3","2023","2","06","30"
"2023-06-30","Agency","Farm Credit Administration","null","630","1","630","1","0","0","100.0","100.0","Non-CFO","2023","3","2023","2","06","30"
"2023-06-30","Bureau","Farm Credit Administration","Farm Credit Administration","630","1","630","1","0","0","100.0","100.0","null","2023","3","2023","2","06","30"
"2023-06-30","Bureau","Farm Credit Administration","Farm Credit System Insurance Corporation","0","0","0","0","0","0","0.0","0.0","null","2023","3","2023","2","06","30"
"2023-06-30","Agency","Federal Communications Commission","null","235548812","13419","235548812","13419","0","0","100.0","100.0","Non-CFO","2023","3","2023","2","06","30"
"2023-06-30","Bureau","Federal Communications Commission","Federal Communications Commission","235548812","13419","235548812","13419","0","0","100.0","100.0","null","2023","3","2023","2","06","30"
"2023-06-30","Agency","Federal Deposit Insurance Corporation","null","0","0","0","0","0","0","0.0","0.0","Non-CFO","2023","3","2023","2","06","30"
"2023-06-30","Bureau","Federal Deposit Insurance Corporation","Federal Deposit Insurance Corporation","0","0","0","0","0","0","0.0","0.0","null","2023","3","2023","2","06","30"
"2023-06-30","Agency","Federal Election Commission","null","2285529","313","2285529","313","0","0","100.0","100.0","Non-CFO","2023","3","2023","2","06","30"
"2023-06-30","Bureau","Federal Election Commission","Federal Election Commission","2285529","313","2285529","313","0","0","100.0","100.0","null","2023","3","2023","2","06","30"
"2023-06-30","Agency","Federal Labor Relations Authority","null","0","0","0","0","0","0","0.0","0.0","Non-CFO","2023","3","2023","2","06","30"
"2023-06-30","Bureau","Federal Labor Relations Authority","Federal Labor Relations Authority","0","0","0","0","0","0","0.0","0.0","null","2023","3","2023","2","06","30"
"2023-06-30","Agency","Federal Maritime Commission","null","397569","6","397569","6","0","0","100.0","100.0","Non-CFO","2023","3","2023","2","06","30"
"2023-06-30","Bureau","Federal Maritime Commission","Salaries and Expenses","397569","6","397569","6","0","0","100.0","100.0","null","2023","3","2023","2","06","30"
"2023-06-30","Agency","Federal Mediation/Conciliation Service","null","0","0","0","0","0","0","0.0","0.0","Non-CFO","2023","3","2023","2","06","30"
"2023-06-30","Bureau","Federal Mediation/Conciliation Service","Federal Mediation/Conciliation Service","0","0","0","0","0","0","0.0","0.0","null","2023","3","2023","2","06","30"
"2023-06-30","Agency","Federal Trade Commission","null","380678869","57","380678869","57","0","0","100.0","100.0","Non-CFO","2023","3","2023","2","06","30"
"2023-06-30","Bureau","Federal Trade Commission","Federal Trade Commission","380678869","57","380678869","57","0","0","100.0","100.0","null","2023","3","2023","2","06","30"
"2023-06-30","Agency","Funds Appropriated to the President","null","1238427","14","2367","7","1236060","7","0.19112955386147104","50.0","Non-CFO","2023","3","2023","2","06","30"
"2023-06-30","Bureau","Funds Appropriated to the President","African Development Foundation","2367","7","2367","7","0","0","100.0","100.0","null","2023","3","2023","2","06","30"
"2023-06-30","Bureau","Funds Appropriated to the President","Defense Security Assistance Agency","0","0","0","0","0","0","0.0","0.0","null","2023","3","2023","2","06","30"
"2023-06-30","Bureau","Funds Appropriated to the President","Executive Branch","0","0","0","0","0","0","0.0","0.0","null","2023","3","2023","2","06","30"
"2023-06-30","Bureau","Funds Appropriated to the President","Inter-American Foundation","0","0","0","0","0","0","0.0","0.0","null","2023","3","2023","2","06","30"
"2023-06-30","Bureau","Funds Appropriated to the President","Peace Corps","0","0","0","0","0","0","0.0","0.0","null","2023","3","2023","2","06","30"
"2023-06-30","Bureau","Funds Appropriated to the President","Trade and Development Agency","1236060","7","0","0","1236060","7","0.0","0.0","null","2023","3","2023","2","06","30"
"2023-06-30","Agency","General Services Administration","null","18062817","1768","16006668","1625","2056149","143","88.61667590387479","91.91176470588235","CFO","2023","3","2023","2","06","30"
"2023-06-30","Bureau","General Services Administration","General Services Administration","18062817","1768","16006668","1625","2056149","143","88.61667590387479","91.91176470588235","null","2023","3","2023","2","06","30"
"2023-06-30","Agency","Legis Branch-Library of Congress","null","0","0","0","0","0","0","0.0","0.0","Non-CFO","2023","3","2023","2","06","30"
"2023-06-30","Bureau","Legis Branch-Library of Congress","Library of Congress","0","0","0","0","0","0","0.0","0.0","null","2023","3","2023","2","06","30"
"2023-06-30","Agency","Legislative Branch - U.S. House/Senate","null","351558","218","0","0","351558","218","0.0","0.0","Non-CFO","2023","3","2023","2","06","30"
"2023-06-30","Bureau","Legislative Branch - U.S. House/Senate","U.S. House of Representatives","351558","218","0","0","351558","218","0.0","0.0","null","2023","3","2023","2","06","30"
"2023-06-30","Agency","Legislative Branch-CBO","null","0","0","0","0","0","0","0.0","0.0","Non-CFO","2023","3","2023","2","06","30"
"2023-06-30","Bureau","Legislative Branch-CBO","Congressional Budget Office","0","0","0","0","0","0","0.0","0.0","null","2023","3","2023","2","06","30"
"2023-06-30","Agency","Legislative Branch-GAO","null","0","0","0","0","0","0","0.0","0.0","Non-CFO","2023","3","2023","2","06","30"
"2023-06-30","Bureau","Legislative Branch-GAO","Government Accountability Office","0","0","0","0","0","0","0.0","0.0","null","2023","3","2023","2","06","30"
"2023-06-30","Agency","Legislative Branch-GPO","null","0","0","0","0","0","0","0.0","0.0","Non-CFO","2023","3","2023","2","06","30"
"2023-06-30","Bureau","Legislative Branch-GPO","Government Publishing Office","0","0","0","0","0","0","0.0","0.0","null","2023","3","2023","2","06","30"
"2023-06-30","Agency","Legislative Branch-Office of Tech.","null","0","0","0","0","0","0","0.0","0.0","Non-CFO","2023","3","2023","2","06","30"
"2023-06-30","Bureau","Legislative Branch-Office of Tech.","Medicaid & CHIP Payment & Access Comm.","0","0","0","0","0","0","0.0","0.0","null","2023","3","2023","2","06","30"
"2023-06-30","Bureau","Legislative Branch-Office of Tech.","Open World Leadership","0","0","0","0","0","0","0.0","0.0","null","2023","3","2023","2","06","30"
"2023-06-30","Agency","Merit Systems Protection Board","null","144","1","144","1","0","0","100.0","100.0","Non-CFO","2023","3","2023","2","06","30"
"2023-06-30","Bureau","Merit Systems Protection Board","Merit Systems Protection Board","144","1","144","1","0","0","100.0","100.0","null","2023","3","2023","2","06","30"
"2023-06-30","Agency","National Aeronautics and Space Administration","null","1493206","123","1493206","123","0","0","100.0","100.0","CFO","2023","3","2023","2","06","30"
"2023-06-30","Bureau","National Aeronautics and Space Administration","National Aeronautics and Space Admin","1493206","123","1493206","123","0","0","100.0","100.0","null","2023","3","2023","2","06","30"
"2023-06-30","Agency","National Archives & Records Admin","null","131736","113","131736","113","0","0","100.0","100.0","Non-CFO","2023","3","2023","2","06","30"
"2023-06-30","Bureau","National Archives & Records Admin","Nat'l Archives & Records Administration","131736","113","131736","113","0","0","100.0","100.0","null","2023","3","2023","2","06","30"
"2023-06-30","Agency","National Credit Union Administration","null","1373","2","1373","2","0","0","100.0","100.0","Non-CFO","2023","3","2023","2","06","30"
"2023-06-30","Bureau","National Credit Union Administration","National Credit Union Administration","1373","2","1373","2","0","0","100.0","100.0","null","2023","3","2023","2","06","30"
"2023-06-30","Agency","National Foundation  Arts & Humanities","null","0","0","0","0","0","0","0.0","0.0","Non-CFO","2023","3","2023","2","06","30"
"2023-06-30","Bureau","National Foundation  Arts & Humanities","National Endowment for the Arts","0","0","0","0","0","0","0.0","0.0","null","2023","3","2023","2","06","30"
"2023-06-30","Bureau","National Foundation  Arts & Humanities","National Endowment for the Humanities","0","0","0","0","0","0","0.0","0.0","null","2023","3","2023","2","06","30"
"2023-06-30","Agency","National Labor Relations Board","null","0","0","0","0","0","0","0.0","0.0","Non-CFO","2023","3","2023","2","06","30"
"2023-06-30","Bureau","National Labor Relations Board","National Labor Relations Board","0","0","0","0","0","0","0.0","0.0","null","2023","3","2023","2","06","30"
"2023-06-30","Agency","National Science Foundation","null","711137","33","711137","33","0","0","100.0","100.0","CFO","2023","3","2023","2","06","30"
"2023-06-30","Bureau","National Science Foundation","National Science Foundation","711137","33","711137","33","0","0","100.0","100.0","null","2023","3","2023","2","06","30"
"2023-06-30","Agency","Neighborhood Reinvestment Corporation","null","0","0","0","0","0","0","0.0","0.0","Non-CFO","2023","3","2023","2","06","30"
"2023-06-30","Bureau","Neighborhood Reinvestment Corporation","Neighborhood Reinvestment Corporation","0","0","0","0","0","0","0.0","0.0","null","2023","3","2023","2","06","30"
"2023-06-30","Agency","Nuclear Regulatory Commission","null","2911495","354","2911495","354","0","0","100.0","100.0","CFO","2023","3","2023","2","06","30"
"2023-06-30","Bureau","Nuclear Regulatory Commission","Nuclear Regulatory Commission","2911495","354","2911495","354","0","0","100.0","100.0","null","2023","3","2023","2","06","30"
"2023-06-30","Agency","Occupational Safety & Health Rev Comm","null","0","0","0","0","0","0","0.0","0.0","Non-CFO","2023","3","2023","2","06","30"
"2023-06-30","Bureau","Occupational Safety & Health Rev Comm","Occupational Safety & Health Rev Comm","0","0","0","0","0","0","0.0","0.0","null","2023","3","2023","2","06","30"
"2023-06-30","Agency","Office of Compliance","null","0","0","0","0","0","0","0.0","0.0","Non-CFO","2023","3","2023","2","06","30"
"2023-06-30","Bureau","Office of Compliance","Office of Compliance","0","0","0","0","0","0","0.0","0.0","null","2023","3","2023","2","06","30"
"2023-06-30","Agency","Office of Government Ethics","null","0","0","0","0","0","0","0.0","0.0","Non-CFO","2023","3","2023","2","06","30"
"2023-06-30","Bureau","Office of Government Ethics","Office of Government Ethics","0","0","0","0","0","0","0.0","0.0","null","2023","3","2023","2","06","30"
"2023-06-30","Agency","Office of Personnel Management","null","21360898","1176","21360898","1176","0","0","100.0","100.0","CFO","2023","3","2023","2","06","30"
"2023-06-30","Bureau","Office of Personnel Management","Office of Personnel Management","21360898","1176","21360898","1176","0","0","100.0","100.0","null","2023","3","2023","2","06","30"
"2023-06-30","Agency","Office of Special Counsel","null","0","0","0","0","0","0","0.0","0.0","Non-CFO","2023","3","2023","2","06","30"
"2023-06-30","Bureau","Office of Special Counsel","Office of Special Counsel","0","0","0","0","0","0","0.0","0.0","null","2023","3","2023","2","06","30"
"2023-06-30","Agency","Other Agencies","null","769122","48","543001","8","226121","40","70.60011285595783","16.666666666666668","Non-CFO","2023","3","2023","2","06","30"
"2023-06-30","Bureau","Other Agencies","Advisory Council on Hist. Preservation","0","0","0","0","0","0","0.0","0.0","null","2023","3","2023","2","06","30"
"2023-06-30","Bureau","Other Agencies","Archit.&Trans. Barriers Compliance Bd","0","0","0","0","0","0","0.0","0.0","null","2023","3","2023","2","06","30"
"2023-06-30","Bureau","Other Agencies","Architect of the Capitol","0","0","0","0","0","0","0.0","0.0","null","2023","3","2023","2","06","30"
"2023-06-30","Bureau","Other Agencies","Chemical Safety Board","31538","2","31538","2","0","0","100.0","100.0","null","2023","3","2023","2","06","30"
"2023-06-30","Bureau","Other Agencies","Comm. for Purchase from Blind/Handic.","0","0","0","0","0","0","0.0","0.0","null","2023","3","2023","2","06","30"
"2023-06-30","Bureau","Other Agencies","Commission On Fine Arts","0","0","0","0","0","0","0.0","0.0","null","2023","3","2023","2","06","30"
"2023-06-30","Bureau","Other Agencies","Consumer Financial Protection Bureau","515837","13","511463","6","4374","7","99.15205772366077","46.15384615384615","null","2023","3","2023","2","06","30"
"2023-06-30","Bureau","Other Agencies","Council of Insps. Gen. of Intg. & Effy.","6782","5","0","0","6782","5","0.0","0.0","null","2023","3","2023","2","06","30"
"2023-06-30","Bureau","Other Agencies","Defense Nuclear Facilities Safety Board","0","0","0","0","0","0","0.0","0.0","null","2023","3","2023","2","06","30"
"2023-06-30","Bureau","Other Agencies","Delta Regional Authority","0","0","0","0","0","0","0.0","0.0","null","2023","3","2023","2","06","30"
"2023-06-30","Bureau","Other Agencies","Denali Commission","0","0","0","0","0","0","0.0","0.0","null","2023","3","2023","2","06","30"
"2023-06-30","Bureau","Other Agencies","District of Columbia Government","0","0","0","0","0","0","0.0","0.0","null","2023","3","2023","2","06","30"
"2023-06-30","Bureau","Other Agencies","Election Assistance Commission","5576","1","0","0","5576","1","0.0","0.0","null","2023","3","2023","2","06","30"
"2023-06-30","Bureau","Other Agencies","Federal Housing Finance Agency","0","0","0","0","0","0","0.0","0.0","null","2023","3","2023","2","06","30"
"2023-06-30","Bureau","Other Agencies","Federal Housing Finance Agency OIG","0","0","0","0","0","0","0.0","0.0","null","2023","3","2023","2","06","30"
"2023-06-30","Bureau","Other Agencies","Federal Mine Safety & Health Review Comm","0","0","0","0","0","0","0.0","0.0","null","2023","3","2023","2","06","30"
"2023-06-30","Bureau","Other Agencies","Gulf Coast Ecosystem Restoration Council","0","0","0","0","0","0","0.0","0.0","null","2023","3","2023","2","06","30"
"2023-06-30","Bureau","Other Agencies","James Madison Memorial Fellowship","197596","23","0","0","197596","23","0.0","0.0","null","2023","3","2023","2","06","30"
"2023-06-30","Bureau","Other Agencies","John C. Stennis","2934","2","0","0","2934","2","0.0","0.0","null","2023","3","2023","2","06","30"
"2023-06-30","Bureau","Other Agencies","Millennium Challenge Corporation","0","0","0","0","0","0","0.0","0.0","null","2023","3","2023","2","06","30"
"2023-06-30","Bureau","Other Agencies","Morris K. Udall Scholarship","0","0","0","0","0","0","0.0","0.0","null","2023","3","2023","2","06","30"
"2023-06-30","Bureau","Other Agencies","National Capital Planning Commission","0","0","0","0","0","0","0.0","0.0","null","2023","3","2023","2","06","30"
"2023-06-30","Bureau","Other Agencies","National Council on Disability","0","0","0","0","0","0","0.0","0.0","null","2023","3","2023","2","06","30"
"2023-06-30","Bureau","Other Agencies","National Mediation Board","0","0","0","0","0","0","0.0","0.0","null","2023","3","2023","2","06","30"
"2023-06-30","Bureau","Other Agencies","National Transportation Safety Board","0","0","0","0","0","0","0.0","0.0","null","2023","3","2023","2","06","30"
"2023-06-30","Bureau","Other Agencies","Privacy & Civil Liberties Oversight Bd","0","0","0","0","0","0","0.0","0.0","null","2023","3","2023","2","06","30"
"2023-06-30","Bureau","Other Agencies","Surface Transportation Board","0","0","0","0","0","0","0.0","0.0","null","2023","3","2023","2","06","30"
"2023-06-30","Bureau","Other Agencies","U.S.  Agency of Global Media","0","0","0","0","0","0","0.0","0.0","null","2023","3","2023","2","06","30"
"2023-06-30","Bureau","Other Agencies","U.S. Holocaust Memorial Council","0","0","0","0","0","0","0.0","0.0","null","2023","3","2023","2","06","30"
"2023-06-30","Bureau","Other Agencies","U.S. Inst. for Env. Conflict Resolution","8859","2","0","0","8859","2","0.0","0.0","null","2023","3","2023","2","06","30"
"2023-06-30","Bureau","Other Agencies","U.S. Institute of Peace","0","0","0","0","0","0","0.0","0.0","null","2023","3","2023","2","06","30"
"2023-06-30","Agency","Other Agencies/Boards/Commissions","null","1024","1","0","0","1024","1","0.0","0.0","Non-CFO","2023","3","2023","2","06","30"
"2023-06-30","Bureau","Other Agencies/Boards/Commissions","Medicare Payment Advisory Commission","0","0","0","0","0","0","0.0","0.0","null","2023","3","2023","2","06","30"
"2023-06-30","Bureau","Other Agencies/Boards/Commissions","Nuclear Waste Technical Review Board","0","0","0","0","0","0","0.0","0.0","null","2023","3","2023","2","06","30"
"2023-06-30","Bureau","Other Agencies/Boards/Commissions","U.S. Comm. on Int. Religious Freedom","1024","1","0","0","1024","1","0.0","0.0","null","2023","3","2023","2","06","30"
"2023-06-30","Bureau","Other Agencies/Boards/Commissions","U.S.-China Security Review Commission","0","0","0","0","0","0","0.0","0.0","null","2023","3","2023","2","06","30"
"2023-06-30","Agency","Pension Benefit Guaranty Corp","null","4436707","1606","4436707","1606","0","0","100.0","100.0","Non-CFO","2023","3","2023","2","06","30"
"2023-06-30","Bureau","Pension Benefit Guaranty Corp","Pension Benefit Guaranty Corporation","4436707","1606","4436707","1606","0","0","100.0","100.0","null","2023","3","2023","2","06","30"
"2023-06-30","Agency","Presidio Trust Corporation","null","1548205","61","1548205","61","0","0","100.0","100.0","Non-CFO","2023","3","2023","2","06","30"
"2023-06-30","Bureau","Presidio Trust Corporation","Presidio Trust Corporation","1548205","61","1548205","61","0","0","100.0","100.0","null","2023","3","2023","2","06","30"
"2023-06-30","Agency","Railroad Retirement Board","null","21471425","4023","21471425","4023","0","0","100.0","100.0","Non-CFO","2023","3","2023","2","06","30"
"2023-06-30","Bureau","Railroad Retirement Board","Railroad Retirement Board","21471425","4023","21471425","4023","0","0","100.0","100.0","null","2023","3","2023","2","06","30"
"2023-06-30","Agency","Securities & Exchange Commission","null","2539624850","1363","2539624850","1363","0","0","100.0","100.0","Non-CFO","2023","3","2023","2","06","30"
"2023-06-30","Bureau","Securities & Exchange Commission","SEC Enforcement","2539366889","1317","2539366889","1317","0","0","100.0","100.0","null","2023","3","2023","2","06","30"
"2023-06-30","Bureau","Securities & Exchange Commission","Securities and Exchange Commission","257961","46","257961","46","0","0","100.0","100.0","null","2023","3","2023","2","06","30"
"2023-06-30","Agency","Selective Service System","null","1301","4","0","0","1301","4","0.0","0.0","Non-CFO","2023","3","2023","2","06","30"
"2023-06-30","Bureau","Selective Service System","Selective Service System","1301","4","0","0","1301","4","0.0","0.0","null","2023","3","2023","2","06","30"
"2023-06-30","Agency","Small Business Administration","null","17230635410","143051","17230635410","143051","0","0","100.0","100.0","CFO","2023","3","2023","2","06","30"
"2023-06-30","Bureau","Small Business Administration","Small Business Administration","17230635410","143051","17230635410","143051","0","0","100.0","100.0","null","2023","3","2023","2","06","30"
"2023-06-30","Agency","Smithsonian Institution","null","898","8","0","0","898","8","0.0","0.0","Non-CFO","2023","3","2023","2","06","30"
"2023-06-30","Bureau","Smithsonian Institution","Administrative Conference of the US","0","0","0","0","0","0","0.0","0.0","null","2023","3","2023","2","06","30"
"2023-06-30","Bureau","Smithsonian Institution","JFK Center for the Performing Arts","0","0","0","0","0","0","0.0","0.0","null","2023","3","2023","2","06","30"
"2023-06-30","Bureau","Smithsonian Institution","National Gallery of Art","0","0","0","0","0","0","0.0","0.0","null","2023","3","2023","2","06","30"
"2023-06-30","Bureau","Smithsonian Institution","Smithsonian Institution","898","8","0","0","898","8","0.0","0.0","null","2023","3","2023","2","06","30"
"2023-06-30","Agency","Social Security Administration","null","4241885380","1306937","2448899178","418002","1792986202","888935","57.731384953169105","31.98333201982957","CFO","2023","3","2023","2","06","30"
"2023-06-30","Bureau","Social Security Administration","Social Security Administration","4241885380","1306937","2448899178","418002","1792986202","888935","57.731384953169105","31.98333201982957","null","2023","3","2023","2","06","30"
"2023-06-30","Agency","Tennessee Valley Authority","null","0","0","0","0","0","0","0.0","0.0","Non-CFO","2023","3","2023","2","06","30"
"2023-06-30","Bureau","Tennessee Valley Authority","Tennessee Valley Authority","0","0","0","0","0","0","0.0","0.0","null","2023","3","2023","2","06","30"
"2023-06-30","Agency","The Judiciary","null","1053315","312","1036051","176","17264","136","98.36098413105292","56.41025641025641","Non-CFO","2023","3","2023","2","06","30"
"2023-06-30","Bureau","The Judiciary","Administrative Office of the U.S. Courts","1053315","312","1036051","176","17264","136","98.36098413105292","56.41025641025641","null","2023","3","2023","2","06","30"
"2023-06-30","Agency","U.S. Court of Appeals / Veterans Claims","null","0","0","0","0","0","0","0.0","0.0","Non-CFO","2023","3","2023","2","06","30"
"2023-06-30","Bureau","U.S. Court of Appeals / Veterans Claims","U.S. Court of Appeals / Veterans Claims","0","0","0","0","0","0","0.0","0.0","null","2023","3","2023","2","06","30"
"2023-06-30","Agency","U.S. Postal Service","null","87587834","75239","61919194","55210","25668640","20029","70.693829464946","73.37949733515863","Non-CFO","2023","3","2023","2","06","30"
"2023-06-30","Bureau","U.S. Postal Service","U.S. Postal Service","87587834","75239","61919194","55210","25668640","20029","70.693829464946","73.37949733515863","null","2023","3","2023","2","06","30"
"2023-06-30","Agency","U.S. Tax Court","null","0","0","0","0","0","0","0.0","0.0","Non-CFO","2023","3","2023","2","06","30"
"2023-06-30","Bureau","U.S. Tax Court","U.S. Tax Court","0","0","0","0","0","0","0.0","0.0","null","2023","3","2023","2","06","30"
"2023-06-30","Agency","US International Development Fin. Corp.","null","0","0","0","0","0","0","0.0","0.0","Non-CFO","2023","3","2023","2","06","30"
"2023-06-30","Bureau","US International Development Fin. Corp.","US International Development Fin. Corp.","0","0","0","0","0","0","0.0","0.0","null","2023","3","2023","2","06","30"
"2023-03-31","Agency","Agency for International Development","null","25825311","52","25825039","51","272","1","99.99894676970202","98.07692307692308","CFO","2023","2","2023","1","03","31"
"2023-03-31","Bureau","Agency for International Development","Agency for International Development","25825311","52","25825039","51","272","1","99.99894676970202","98.07692307692308","null","2023","2","2023","1","03","31"
"2023-03-31","Agency","American Battle Monuments Commission","null","0","0","0","0","0","0","0.0","0.0","Non-CFO","2023","2","2023","1","03","31"
"2023-03-31","Bureau","American Battle Monuments Commission","American Battle Monuments Commission","0","0","0","0","0","0","0.0","0.0","null","2023","2","2023","1","03","31"
"2023-03-31","Agency","Armed Forces Retirement Home","null","77021","102","77021","102","0","0","100.0","100.0","Non-CFO","2023","2","2023","1","03","31"
"2023-03-31","Bureau","Armed Forces Retirement Home","Armed Forces Retirement Home","77021","102","77021","102","0","0","100.0","100.0","null","2023","2","2023","1","03","31"
"2023-03-31","Agency","Commodity Futures Trading Commission","null","624898894","360","624898894","360","0","0","100.0","100.0","Non-CFO","2023","2","2023","1","03","31"
"2023-03-31","Bureau","Commodity Futures Trading Commission","Commodity Futures Trading Commission","624898894","360","624898894","360","0","0","100.0","100.0","null","2023","2","2023","1","03","31"
"2023-03-31","Agency","Consumer Product Safety Commission","null","523","3","523","3","0","0","100.0","100.0","Non-CFO","2023","2","2023","1","03","31"
"2023-03-31","Bureau","Consumer Product Safety Commission","Consumer Product Safety Commission","523","3","523","3","0","0","100.0","100.0","null","2023","2","2023","1","03","31"
"2023-03-31","Agency","Corp. for National and Community Service","null","3821070","354","3606760","154","214310","200","94.39136158196526","43.50282485875706","Non-CFO","2023","2","2023","1","03","31"
"2023-03-31","Bureau","Corp. for National and Community Service","Corp. for National and Community Service","3821070","354","3606760","154","214310","200","94.39136158196526","43.50282485875706","null","2023","2","2023","1","03","31"
"2023-03-31","Agency","Department of Agriculture","null","1468979929","49179","1450685342","44921","18294587","4258","98.75460606106076","91.34183289615487","CFO","2023","2","2023","1","03","31"
"2023-03-31","Bureau","Department of Agriculture","Agricultural Marketing Service","6548648","2694","4115810","1282","2432838","1412","62.84976685263889","47.58723088344469","null","2023","2","2023","1","03","31"
"2023-03-31","Bureau","Department of Agriculture","Commodity Credit Corporation","135232596","9684","135232596","9684","0","0","100.0","100.0","null","2023","2","2023","1","03","31"
"2023-03-31","Bureau","Department of Agriculture","Farm Service Agency","377306237","3869","377306237","3869","0","0","100.0","100.0","null","2023","2","2023","1","03","31"
"2023-03-31","Bureau","Department of Agriculture","Federal Crop Insurance Corporation","7298","383","7298","383","0","0","100.0","100.0","null","2023","2","2023","1","03","31"
"2023-03-31","Bureau","Department of Agriculture","Food Safety and Inspection Service","1208011","942","1165824","898","42187","44","96.50773047596421","95.32908704883228","null","2023","2","2023","1","03","31"
"2023-03-31","Bureau","Department of Agriculture","Food and Nutrition Service","3362757","39","61718","20","3301039","19","1.8353392766708982","51.282051282051285","null","2023","2","2023","1","03","31"
"2023-03-31","Bureau","Department of Agriculture","Forest Service","78084709","1077","68673278","351","9411431","726","87.94715236756534","32.590529247910865","null","2023","2","2023","1","03","31"
"2023-03-31","Bureau","Department of Agriculture","Rural Development","846724025","26142","846707281","26055","16744","87","99.99802249617282","99.66720220335093","null","2023","2","2023","1","03","31"
"2023-03-31","Bureau","Department of Agriculture","U.S. Department of Agriculture","20505648","4349","17415300","2379","3090348","1970","84.92928387339917","54.7022303977926","null","2023","2","2023","1","03","31"
"2023-03-31","Agency","Department of Commerce","null","59687094","18288","59687094","18288","0","0","100.0","100.0","CFO","2023","2","2023","1","03","31"
"2023-03-31","Bureau","Department of Commerce","Bureau of Industry and Security","37545570","28","37545570","28","0","0","100.0","100.0","null","2023","2","2023","1","03","31"
"2023-03-31","Bureau","Department of Commerce","Bureau of the Census","2537828","16587","2537828","16587","0","0","100.0","100.0","null","2023","2","2023","1","03","31"
"2023-03-31","Bureau","Department of Commerce","Economic Development Administration","5137182","12","5137182","12","0","0","100.0","100.0","null","2023","2","2023","1","03","31"
"2023-03-31","Bureau","Department of Commerce","Economic and Statistical Analysis","0","0","0","0","0","0","0.0","0.0","null","2023","2","2023","1","03","31"
"2023-03-31","Bureau","Department of Commerce","General Administration","4660","1","4660","1","0","0","100.0","100.0","null","2023","2","2023","1","03","31"
"2023-03-31","Bureau","Department of Commerce","International Trade Administration","0","0","0","0","0","0","0.0","0.0","null","2023","2","2023","1","03","31"
"2023-03-31","Bureau","Department of Commerce","Minority Business Development Agency","0","0","0","0","0","0","0.0","0.0","null","2023","2","2023","1","03","31"
"2023-03-31","Bureau","Department of Commerce","NOAA","12991845","987","12991845","987","0","0","100.0","100.0","null","2023","2","2023","1","03","31"
"2023-03-31","Bureau","Department of Commerce","Nat'l Institute of Standards& Technology","667997","3","667997","3","0","0","100.0","100.0","null","2023","2","2023","1","03","31"
"2023-03-31","Bureau","Department of Commerce","Nat'l Telecomm & Information Admin.","296093","1","296093","1","0","0","100.0","100.0","null","2023","2","2023","1","03","31"
"2023-03-31","Bureau","Department of Commerce","National Technical Information Service","0","0","0","0","0","0","0.0","0.0","null","2023","2","2023","1","03","31"
"2023-03-31","Bureau","Department of Commerce","Office of the Inspector General","0","0","0","0","0","0","0.0","0.0","null","2023","2","2023","1","03","31"
"2023-03-31","Bureau","Department of Commerce","Patent and Trademark Office","505919","669","505919","669","0","0","100.0","100.0","null","2023","2","2023","1","03","31"
"2023-03-31","Agency","Department of Defense","null","3204347553","1701382","1083399947","297424","2120947606","1403958","33.81031330342711","17.481318128439117","CFO","2023","2","2023","1","03","31"
"2023-03-31","Bureau","Department of Defense","Consolidated Report","3204347553","1701382","1083399947","297424","2120947606","1403958","33.81031330342711","17.481318128439117","null","2023","2","2023","1","03","31"
"2023-03-31","Agency","Department of Education","null","122316684699","20767233","122230423277","20739795","86261422","27438","99.92947697837603","99.86787840248145","CFO","2023","2","2023","1","03","31"
"2023-03-31","Bureau","Department of Education","Departmental Management","1430632920","2088","1414813695","1988","15819225","100","98.894249896053","95.21072796934865","null","2023","2","2023","1","03","31"
"2023-03-31","Bureau","Department of Education","Federal Student Aid","120886051779","20765145","120815609582","20737807","70442197","27338","99.94172843271548","99.86834669346156","null","2023","2","2023","1","03","31"
"2023-03-31","Bureau","Department of Education","Office of Postsecondary Education","0","0","0","0","0","0","0.0","0.0","null","2023","2","2023","1","03","31"
"2023-03-31","Agency","Department of Energy","null","14363748","104","14363728","103","20","1","99.99986076057586","99.03846153846153","CFO","2023","2","2023","1","03","31"
"2023-03-31","Bureau","Department of Energy","Bonneville Power Administration","1059236","29","1059216","28","20","1","99.99811184665174","96.55172413793103","null","2023","2","2023","1","03","31"
"2023-03-31","Bureau","Department of Energy","Energy Consolidated Reports","13304512","75","13304512","75","0","0","100.0","100.0","null","2023","2","2023","1","03","31"
"2023-03-31","Agency","Department of Health & Human Services","null","10575134313","1131202","10334847532","1098503","240286781","32699","97.72781343585758","97.10935801032883","CFO","2023","2","2023","1","03","31"
"2023-03-31","Bureau","Department of Health & Human Services","Administration for Children and Families","37597246","1633","37597246","1633","0","0","100.0","100.0","null","2023","2","2023","1","03","31"
"2023-03-31","Bureau","Department of Health & Human Services","Administration for Community Living","0","0","0","0","0","0","0.0","0.0","null","2023","2","2023","1","03","31"
"2023-03-31","Bureau","Department of Health & Human Services","Centers for Disease Control","7747184","98","181883","16","7565301","82","2.3477304785842183","16.3265306122449","null","2023","2","2023","1","03","31"
"2023-03-31","Bureau","Department of Health & Human Services","Centers for Medicare & Medicaid Services","10109112655","1099978","10038867160","1089852","70245495","10126","99.30512699385879","99.07943613417723","null","2023","2","2023","1","03","31"
"2023-03-31","Bureau","Department of Health & Human Services","Food and Drug Administration","182195276","23518","42076536","1818","140118740","21700","23.094197019685627","7.730249170847861","null","2023","2","2023","1","03","31"
"2023-03-31","Bureau","Department of Health & Human Services","Health Resources and Services Admin","108788414","620","108788414","620","0","0","100.0","100.0","null","2023","2","2023","1","03","31"
"2023-03-31","Bureau","Department of Health & Human Services","Indian Health Services","92757849","4230","92757849","4230","0","0","100.0","100.0","null","2023","2","2023","1","03","31"
"2023-03-31","Bureau","Department of Health & Human Services","National Institutes of Health","29840058","916","7482813","125","22357245","791","25.07640233138957","13.646288209606986","null","2023","2","2023","1","03","31"
"2023-03-31","Bureau","Department of Health & Human Services","Office of the Inspector General","33600","1","33600","1","0","0","100.0","100.0","null","2023","2","2023","1","03","31"
"2023-03-31","Bureau","Department of Health & Human Services","Office of the Secretary","8273","7","8273","7","0","0","100.0","100.0","null","2023","2","2023","1","03","31"
"2023-03-31","Bureau","Department of Health & Human Services","Program Support Center","5975888","189","5975888","189","0","0","100.0","100.0","null","2023","2","2023","1","03","31"
"2023-03-31","Bureau","Department of Health & Human Services","Substance Abuse & Mental Health Admin.","1077870","12","1077870","12","0","0","100.0","100.0","null","2023","2","2023","1","03","31"
"2023-03-31","Agency","Department of Homeland Security","null","291417930","71751","276429439","58964","14988491","12787","94.85670253714314","82.17864559378964","CFO","2023","2","2023","1","03","31"
"2023-03-31","Bureau","Department of Homeland Security","Bureau of Customs & Border Protection","9904897","890","9904897","890","0","0","100.0","100.0","null","2023","2","2023","1","03","31"
"2023-03-31","Bureau","Department of Homeland Security","Citizenship and Immigration Services","1112983","1308","1112983","1308","0","0","100.0","100.0","null","2023","2","2023","1","03","31"
"2023-03-31","Bureau","Department of Homeland Security","Domestic Nuclear Detection Office","30970","26","0","0","30970","26","0.0","0.0","null","2023","2","2023","1","03","31"
"2023-03-31","Bureau","Department of Homeland Security","Emergency Preparedness & Resp","236437560","41624","236437560","41624","0","0","100.0","100.0","null","2023","2","2023","1","03","31"
"2023-03-31","Bureau","Department of Homeland Security","Federal Law Enforcement Training Ctr.","8562","1","8562","1","0","0","100.0","100.0","null","2023","2","2023","1","03","31"
"2023-03-31","Bureau","Department of Homeland Security","Immigration and Customs Enforcement","16200820","632","16200820","632","0","0","100.0","100.0","null","2023","2","2023","1","03","31"
"2023-03-31","Bureau","Department of Homeland Security","Info Analysis Infrastructure Prot-NPPD","0","0","0","0","0","0","0.0","0.0","null","2023","2","2023","1","03","31"
"2023-03-31","Bureau","Department of Homeland Security","Management Headquarters","0","0","0","0","0","0","0.0","0.0","null","2023","2","2023","1","03","31"
"2023-03-31","Bureau","Department of Homeland Security","Office of Biometric Identity Management","0","0","0","0","0","0","0.0","0.0","null","2023","2","2023","1","03","31"
"2023-03-31","Bureau","Department of Homeland Security","Office of the Inspector General DHS","100","1","100","1","0","0","100.0","100.0","null","2023","2","2023","1","03","31"
"2023-03-31","Bureau","Department of Homeland Security","Science and Technology","0","0","0","0","0","0","0.0","0.0","null","2023","2","2023","1","03","31"
"2023-03-31","Bureau","Department of Homeland Security","Transportation Safety Administration","11504446","13106","11504446","13106","0","0","100.0","100.0","null","2023","2","2023","1","03","31"
"2023-03-31","Bureau","Department of Homeland Security","U.S. Coast Guard","16217592","14163","1260071","1402","14957521","12761","7.769778645313065","9.899032690814092","null","2023","2","2023","1","03","31"
"2023-03-31","Bureau","Department of Homeland Security","U.S. Secret Service","0","0","0","0","0","0","0.0","0.0","null","2023","2","2023","1","03","31"
"2023-03-31","Agency","Department of Housing and Urban Development","null","52039409","2050","52019800","2046","19609","4","99.96231894178506","99.8048780487805","CFO","2023","2","2023","1","03","31"
"2023-03-31","Bureau","Department of Housing and Urban Development","Community Planning and Development","0","0","0","0","0","0","0.0","0.0","null","2023","2","2023","1","03","31"
"2023-03-31","Bureau","Department of Housing and Urban Development","Government National Mortgage Association","0","0","0","0","0","0","0.0","0.0","null","2023","2","2023","1","03","31"
"2023-03-31","Bureau","Department of Housing and Urban Development","Housing Programs","52034703","2048","52015094","2044","19609","4","99.96231553392359","99.8046875","null","2023","2","2023","1","03","31"
"2023-03-31","Bureau","Department of Housing and Urban Development","Management and Administration","4706","2","4706","2","0","0","100.0","100.0","null","2023","2","2023","1","03","31"
"2023-03-31","Bureau","Department of Housing and Urban Development","Policy, Development and Research","0","0","0","0","0","0","0.0","0.0","null","2023","2","2023","1","03","31"
"2023-03-31","Bureau","Department of Housing and Urban Development","Public and Indian Housing Programs","0","0","0","0","0","0","0.0","0.0","null","2023","2","2023","1","03","31"
"2023-03-31","Agency","Department of Justice","null","89958286","39203","87492403","38735","2465883","468","97.25885951184085","98.80621381016759","CFO","2023","2","2023","1","03","31"
"2023-03-31","Bureau","Department of Justice","Bureau of ATF and Explosives","19881","1","19881","1","0","0","100.0","100.0","null","2023","2","2023","1","03","31"
"2023-03-31","Bureau","Department of Justice","Drug Enforcement Administration","280860","13","280860","13","0","0","100.0","100.0","null","2023","2","2023","1","03","31"
"2023-03-31","Bureau","Department of Justice","Federal Bureau of Investigation","479823","111","479823","111","0","0","100.0","100.0","null","2023","2","2023","1","03","31"
"2023-03-31","Bureau","Department of Justice","Federal Prison Industries","87994","50","0","0","87994","50","0.0","0.0","null","2023","2","2023","1","03","31"
"2023-03-31","Bureau","Department of Justice","Federal Prison System","0","0","0","0","0","0","0.0","0.0","null","2023","2","2023","1","03","31"
"2023-03-31","Bureau","Department of Justice","General Administration","0","0","0","0","0","0","0.0","0.0","null","2023","2","2023","1","03","31"
"2023-03-31","Bureau","Department of Justice","Legal Activities","87689746","39022","85311857","38604","2377889","418","97.28829297783574","98.92880938957511","null","2023","2","2023","1","03","31"
"2023-03-31","Bureau","Department of Justice","Office of Justice Assistance Programs","1399982","6","1399982","6","0","0","100.0","100.0","null","2023","2","2023","1","03","31"
"2023-03-31","Bureau","Department of Justice","U.S. Marshals Service","0","0","0","0","0","0","0.0","0.0","null","2023","2","2023","1","03","31"
"2023-03-31","Agency","Department of Labor","null","162319293","12904","146641480","10115","15677813","2789","90.34137426904638","78.38654680719156","CFO","2023","2","2023","1","03","31"
"2023-03-31","Bureau","Department of Labor","Bureau of Labor Statistics","5128","1","5128","1","0","0","100.0","100.0","null","2023","2","2023","1","03","31"
"2023-03-31","Bureau","Department of Labor","Departmental Management","0","0","0","0","0","0","0.0","0.0","null","2023","2","2023","1","03","31"
"2023-03-31","Bureau","Department of Labor","Employee Benefit Security Administration","21985422","493","21985422","493","0","0","100.0","100.0","null","2023","2","2023","1","03","31"
"2023-03-31","Bureau","Department of Labor","Employment Standards Administration","68938171","4192","61564837","2637","7373334","1555","89.30442468512835","62.905534351145036","null","2023","2","2023","1","03","31"
"2023-03-31","Bureau","Department of Labor","Employment and Training Administration","1257939","11","1257939","11","0","0","100.0","100.0","null","2023","2","2023","1","03","31"
"2023-03-31","Bureau","Department of Labor","Mine Safety and Health Administration","12540522","4279","10056694","3756","2483828","523","80.19358364827238","87.77751811170835","null","2023","2","2023","1","03","31"
"2023-03-31","Bureau","Department of Labor","Occupational Safety and Health Admin","57592111","3928","51771460","3217","5820651","711","89.89331889570778","81.89918533604887","null","2023","2","2023","1","03","31"
"2023-03-31","Agency","Department of State","null","22718772","21669","22476801","21582","241971","87","98.93492922944955","99.59850477640869","CFO","2023","2","2023","1","03","31"
"2023-03-31","Bureau","Department of State","Department of State","20875526","9776","20633555","9689","241971","87","98.84088669190899","99.11006546644845","null","2023","2","2023","1","03","31"
"2023-03-31","Bureau","Department of State","International Commissions","0","0","0","0","0","0","0.0","0.0","null","2023","2","2023","1","03","31"
"2023-03-31","Bureau","Department of State","Passport NSF","1843246","11893","1843246","11893","0","0","100.0","100.0","null","2023","2","2023","1","03","31"
"2023-03-31","Agency","Department of Transportation","null","78058387","8520","78057401","8518","986","2","99.99873684297371","99.97652582159624","CFO","2023","2","2023","1","03","31"
"2023-03-31","Bureau","Department of Transportation","Federal Aviation Administration","2177443","274","2177443","274","0","0","100.0","100.0","null","2023","2","2023","1","03","31"
"2023-03-31","Bureau","Department of Transportation","Federal Highway Administration","13157","10","13157","10","0","0","100.0","100.0","null","2023","2","2023","1","03","31"
"2023-03-31","Bureau","Department of Transportation","Federal Motor Carrier Safety Admin","72426722","8077","72425736","8075","986","2","99.99863862401504","99.97523833106351","null","2023","2","2023","1","03","31"
"2023-03-31","Bureau","Department of Transportation","Federal Railroad Administration","146022","16","146022","16","0","0","100.0","100.0","null","2023","2","2023","1","03","31"
"2023-03-31","Bureau","Department of Transportation","Federal Transit Administration","783405","1","783405","1","0","0","100.0","100.0","null","2023","2","2023","1","03","31"
"2023-03-31","Bureau","Department of Transportation","Maritime Administration","65458","14","65458","14","0","0","100.0","100.0","null","2023","2","2023","1","03","31"
"2023-03-31","Bureau","Department of Transportation","National Highway Traffic Safety Admin.","36529","6","36529","6","0","0","100.0","100.0","null","2023","2","2023","1","03","31"
"2023-03-31","Bureau","Department of Transportation","Office of the Inspector General","845","1","845","1","0","0","100.0","100.0","null","2023","2","2023","1","03","31"
"2023-03-31","Bureau","Department of Transportation","Office of the Secretary","1120697","16","1120697","16","0","0","100.0","100.0","null","2023","2","2023","1","03","31"
"2023-03-31","Bureau","Department of Transportation","Pipeline Hazardous Material Safety Admin","1259292","98","1259292","98","0","0","100.0","100.0","null","2023","2","2023","1","03","31"
"2023-03-31","Bureau","Department of Transportation","Research Innovative Technology Admin","21089","5","21089","5","0","0","100.0","100.0","null","2023","2","2023","1","03","31"
"2023-03-31","Bureau","Department of Transportation","St. Lawrence Seaway Development Corp.","7728","2","7728","2","0","0","100.0","100.0","null","2023","2","2023","1","03","31"
"2023-03-31","Agency","Department of Veterans Affairs","null","197176555","2779228","194584875","2774917","2591680","4311","98.68560438131196","99.84488498244836","CFO","2023","2","2023","1","03","31"
"2023-03-31","Bureau","Department of Veterans Affairs","Administration and Cemeteries","3821844","802","3503742","370","318102","432","91.67674033791018","46.13466334164588","null","2023","2","2023","1","03","31"
"2023-03-31","Bureau","Department of Veterans Affairs","Housing Credit Assistance","374072","19","0","0","374072","19","0.0","0.0","null","2023","2","2023","1","03","31"
"2023-03-31","Bureau","Department of Veterans Affairs","Life Insurance","1220876","254","1220876","254","0","0","100.0","100.0","null","2023","2","2023","1","03","31"
"2023-03-31","Bureau","Department of Veterans Affairs","Medical and Construction","190532183","2776526","189860257","2774293","671926","2233","99.64734251745806","99.91957575761941","null","2023","2","2023","1","03","31"
"2023-03-31","Bureau","Department of Veterans Affairs","Veterans Benefits","1227580","1627","0","0","1227580","1627","0.0","0.0","null","2023","2","2023","1","03","31"
"2023-03-31","Agency","Department of the Interior","null","74239160","31908","74233621","31843","5539","65","99.99253897808111","99.796289331829","CFO","2023","2","2023","1","03","31"
"2023-03-31","Bureau","Department of the Interior","Bureau of Indian Affairs","18883812","27280","18878273","27215","5539","65","99.97066799860113","99.7617302052786","null","2023","2","2023","1","03","31"
"2023-03-31","Bureau","Department of the Interior","Bureau of Land Management","9029752","351","9029752","351","0","0","100.0","100.0","null","2023","2","2023","1","03","31"
"2023-03-31","Bureau","Department of the Interior","Bureau of Ocean Energy Mgmt., Reg & Enf","1333","1","1333","1","0","0","100.0","100.0","null","2023","2","2023","1","03","31"
"2023-03-31","Bureau","Department of the Interior","Bureau of Reclamation","7398393","69","7398393","69","0","0","100.0","100.0","null","2023","2","2023","1","03","31"
"2023-03-31","Bureau","Department of the Interior","Bureau of Safety and Environmental Enf.","14790","3","14790","3","0","0","100.0","100.0","null","2023","2","2023","1","03","31"
"2023-03-31","Bureau","Department of the Interior","Fish and Wildlife Service","797471","114","797471","114","0","0","100.0","100.0","null","2023","2","2023","1","03","31"
"2023-03-31","Bureau","Department of the Interior","Geological Survey","164593","1089","164593","1089","0","0","100.0","100.0","null","2023","2","2023","1","03","31"
"2023-03-31","Bureau","Department of the Interior","National Park Service","8767549","2042","8767549","2042","0","0","100.0","100.0","null","2023","2","2023","1","03","31"
"2023-03-31","Bureau","Department of the Interior","Office of Natural Resources Revenue","21283380","584","21283380","584","0","0","100.0","100.0","null","2023","2","2023","1","03","31"
"2023-03-31","Bureau","Department of the Interior","Office of Surface Mining","7871953","355","7871953","355","0","0","100.0","100.0","null","2023","2","2023","1","03","31"
"2023-03-31","Bureau","Department of the Interior","Office of the Secretary","26134","20","26134","20","0","0","100.0","100.0","null","2023","2","2023","1","03","31"
"2023-03-31","Agency","Department of the Treasury","null","54755323","4690","54364885","4677","390438","13","99.28694055918545","99.7228144989339","CFO","2023","2","2023","1","03","31"
"2023-03-31","Bureau","Department of the Treasury","Bureau of Engraving and Printing","38345","2","38345","2","0","0","100.0","100.0","null","2023","2","2023","1","03","31"
"2023-03-31","Bureau","Department of the Treasury","Bureau of the Fiscal Service","13433476","3240","13433476","3240","0","0","100.0","100.0","null","2023","2","2023","1","03","31"
"2023-03-31","Bureau","Department of the Treasury","Community Dev Financial Inst Fund","3642572","8","3642572","8","0","0","100.0","100.0","null","2023","2","2023","1","03","31"
"2023-03-31","Bureau","Department of the Treasury","Comptroller of the Currency","1431806","25","1424060","21","7746","4","99.45900492105774","84.0","null","2023","2","2023","1","03","31"
"2023-03-31","Bureau","Department of the Treasury","D.C. Pension Program","428403","18","428403","18","0","0","100.0","100.0","null","2023","2","2023","1","03","31"
"2023-03-31","Bureau","Department of the Treasury","Departmental Offices","33870564","1324","33758288","1320","112276","4","99.66851452488362","99.69788519637463","null","2023","2","2023","1","03","31"
"2023-03-31","Bureau","Department of the Treasury","Financial Crimes Enforcement Network","1544945","3","1544945","3","0","0","100.0","100.0","null","2023","2","2023","1","03","31"
"2023-03-31","Bureau","Department of the Treasury","Interest on Tax/Deposit of Earnings","0","0","0","0","0","0","0.0","0.0","null","2023","2","2023","1","03","31"
"2023-03-31","Bureau","Department of the Treasury","Internal Revenue Service","43721","41","43721","41","0","0","100.0","100.0","null","2023","2","2023","1","03","31"
"2023-03-31","Bureau","Department of the Treasury","International Monetary Funds","0","0","0","0","0","0","0.0","0.0","null","2023","2","2023","1","03","31"
"2023-03-31","Bureau","Department of the Treasury","Office of Financial Research","268","1","268","1","0","0","100.0","100.0","null","2023","2","2023","1","03","31"
"2023-03-31","Bureau","Department of the Treasury","Office of Sec International Affairs","0","0","0","0","0","0","0.0","0.0","null","2023","2","2023","1","03","31"
"2023-03-31","Bureau","Department of the Treasury","Office of the Secretary","0","0","0","0","0","0","0.0","0.0","null","2023","2","2023","1","03","31"
"2023-03-31","Bureau","Department of the Treasury","Pandemic Receivables","289770","4","22518","1","267252","3","7.770990785795631","25.0","null","2023","2","2023","1","03","31"
"2023-03-31","Bureau","Department of the Treasury","Spec Insp Gen-Troubled Asset Rel Prog","3916","1","3916","1","0","0","100.0","100.0","null","2023","2","2023","1","03","31"
"2023-03-31","Bureau","Department of the Treasury","Tobacco Tax and Trade","1000","1","1000","1","0","0","100.0","100.0","null","2023","2","2023","1","03","31"
"2023-03-31","Bureau","Department of the Treasury","Treasury Forfeiture Fund","0","0","0","0","0","0","0.0","0.0","null","2023","2","2023","1","03","31"
"2023-03-31","Bureau","Department of the Treasury","Treasury Franchise Fund","0","0","0","0","0","0","0.0","0.0","null","2023","2","2023","1","03","31"
"2023-03-31","Bureau","Department of the Treasury","Treasury IG for Tax Admin","195","1","195","1","0","0","100.0","100.0","null","2023","2","2023","1","03","31"
"2023-03-31","Bureau","Department of the Treasury","U.S. Mint","26342","21","23178","19","3164","2","87.98876319186091","90.47619047619048","null","2023","2","2023","1","03","31"
"2023-03-31","Bureau","Department of the Treasury","U.S. Treasury IG Office","0","0","0","0","0","0","0.0","0.0","null","2023","2","2023","1","03","31"
"2023-03-31","Agency","Environmental Protection Agency","null","26123455","255","26123455","255","0","0","100.0","100.0","CFO","2023","2","2023","1","03","31"
"2023-03-31","Bureau","Environmental Protection Agency","Environmental Protection Agency","26123455","255","26123455","255","0","0","100.0","100.0","null","2023","2","2023","1","03","31"
"2023-03-31","Agency","Equal Employment Opportunity Commission","null","22760","19","22760","19","0","0","100.0","100.0","Non-CFO","2023","2","2023","1","03","31"
"2023-03-31","Bureau","Equal Employment Opportunity Commission","Equal Employment Opportunity Commission","22760","19","22760","19","0","0","100.0","100.0","null","2023","2","2023","1","03","31"
"2023-03-31","Agency","Export - Import  Bank","null","0","0","0","0","0","0","0.0","0.0","Non-CFO","2023","2","2023","1","03","31"
"2023-03-31","Bureau","Export - Import  Bank","Export-Import Bank","0","0","0","0","0","0","0.0","0.0","null","2023","2","2023","1","03","31"
"2023-03-31","Agency","Farm Credit Administration","null","630","1","630","1","0","0","100.0","100.0","Non-CFO","2023","2","2023","1","03","31"
"2023-03-31","Bureau","Farm Credit Administration","Farm Credit Administration","630","1","630","1","0","0","100.0","100.0","null","2023","2","2023","1","03","31"
"2023-03-31","Bureau","Farm Credit Administration","Farm Credit System Insurance Corporation","0","0","0","0","0","0","0.0","0.0","null","2023","2","2023","1","03","31"
"2023-03-31","Agency","Federal Communications Commission","null","234290204","13639","234290204","13639","0","0","100.0","100.0","Non-CFO","2023","2","2023","1","03","31"
"2023-03-31","Bureau","Federal Communications Commission","Federal Communications Commission","234290204","13639","234290204","13639","0","0","100.0","100.0","null","2023","2","2023","1","03","31"
"2023-03-31","Agency","Federal Deposit Insurance Corporation","null","0","0","0","0","0","0","0.0","0.0","Non-CFO","2023","2","2023","1","03","31"
"2023-03-31","Bureau","Federal Deposit Insurance Corporation","Federal Deposit Insurance Corporation","0","0","0","0","0","0","0.0","0.0","null","2023","2","2023","1","03","31"
"2023-03-31","Agency","Federal Election Commission","null","2191216","302","2191216","302","0","0","100.0","100.0","Non-CFO","2023","2","2023","1","03","31"
"2023-03-31","Bureau","Federal Election Commission","Federal Election Commission","2191216","302","2191216","302","0","0","100.0","100.0","null","2023","2","2023","1","03","31"
"2023-03-31","Agency","Federal Labor Relations Authority","null","0","0","0","0","0","0","0.0","0.0","Non-CFO","2023","2","2023","1","03","31"
"2023-03-31","Bureau","Federal Labor Relations Authority","Federal Labor Relations Authority","0","0","0","0","0","0","0.0","0.0","null","2023","2","2023","1","03","31"
"2023-03-31","Agency","Federal Maritime Commission","null","397687","6","397687","6","0","0","100.0","100.0","Non-CFO","2023","2","2023","1","03","31"
"2023-03-31","Bureau","Federal Maritime Commission","Salaries and Expenses","397687","6","397687","6","0","0","100.0","100.0","null","2023","2","2023","1","03","31"
"2023-03-31","Agency","Federal Mediation/Conciliation Service","null","0","0","0","0","0","0","0.0","0.0","Non-CFO","2023","2","2023","1","03","31"
"2023-03-31","Bureau","Federal Mediation/Conciliation Service","Federal Mediation/Conciliation Service","0","0","0","0","0","0","0.0","0.0","null","2023","2","2023","1","03","31"
"2023-03-31","Agency","Federal Trade Commission","null","481038032","62","481038032","62","0","0","100.0","100.0","Non-CFO","2023","2","2023","1","03","31"
"2023-03-31","Bureau","Federal Trade Commission","Federal Trade Commission","481038032","62","481038032","62","0","0","100.0","100.0","null","2023","2","2023","1","03","31"
"2023-03-31","Agency","Funds Appropriated to the President","null","1238427","14","2367","7","1236060","7","0.19112955386147104","50.0","Non-CFO","2023","2","2023","1","03","31"
"2023-03-31","Bureau","Funds Appropriated to the President","African Development Foundation","2367","7","2367","7","0","0","100.0","100.0","null","2023","2","2023","1","03","31"
"2023-03-31","Bureau","Funds Appropriated to the President","Defense Security Assistance Agency","0","0","0","0","0","0","0.0","0.0","null","2023","2","2023","1","03","31"
"2023-03-31","Bureau","Funds Appropriated to the President","Executive Branch","0","0","0","0","0","0","0.0","0.0","null","2023","2","2023","1","03","31"
"2023-03-31","Bureau","Funds Appropriated to the President","Inter-American Foundation","0","0","0","0","0","0","0.0","0.0","null","2023","2","2023","1","03","31"
"2023-03-31","Bureau","Funds Appropriated to the President","Peace Corps","0","0","0","0","0","0","0.0","0.0","null","2023","2","2023","1","03","31"
"2023-03-31","Bureau","Funds Appropriated to the President","Trade and Development Agency","1236060","7","0","0","1236060","7","0.0","0.0","null","2023","2","2023","1","03","31"
"2023-03-31","Agency","General Services Administration","null","12902545","1706","10762922","1582","2139623","124","83.41704679193136","92.73153575615474","CFO","2023","2","2023","1","03","31"
"2023-03-31","Bureau","General Services Administration","General Services Administration","12902545","1706","10762922","1582","2139623","124","83.41704679193136","92.73153575615474","null","2023","2","2023","1","03","31"
"2023-03-31","Agency","Legis Branch-Library of Congress","null","0","0","0","0","0","0","0.0","0.0","Non-CFO","2023","2","2023","1","03","31"
"2023-03-31","Bureau","Legis Branch-Library of Congress","Library of Congress","0","0","0","0","0","0","0.0","0.0","null","2023","2","2023","1","03","31"
"2023-03-31","Agency","Legislative Branch - U.S. House/Senate","null","337584","203","0","0","337584","203","0.0","0.0","Non-CFO","2023","2","2023","1","03","31"
"2023-03-31","Bureau","Legislative Branch - U.S. House/Senate","U.S. House of Representatives","337584","203","0","0","337584","203","0.0","0.0","null","2023","2","2023","1","03","31"
"2023-03-31","Agency","Legislative Branch-CBO","null","0","0","0","0","0","0","0.0","0.0","Non-CFO","2023","2","2023","1","03","31"
"2023-03-31","Bureau","Legislative Branch-CBO","Congressional Budget Office","0","0","0","0","0","0","0.0","0.0","null","2023","2","2023","1","03","31"
"2023-03-31","Agency","Legislative Branch-GAO","null","0","0","0","0","0","0","0.0","0.0","Non-CFO","2023","2","2023","1","03","31"
"2023-03-31","Bureau","Legislative Branch-GAO","Government Accountability Office","0","0","0","0","0","0","0.0","0.0","null","2023","2","2023","1","03","31"
"2023-03-31","Agency","Legislative Branch-GPO","null","0","0","0","0","0","0","0.0","0.0","Non-CFO","2023","2","2023","1","03","31"
"2023-03-31","Bureau","Legislative Branch-GPO","Government Publishing Office","0","0","0","0","0","0","0.0","0.0","null","2023","2","2023","1","03","31"
"2023-03-31","Agency","Legislative Branch-Office of Tech.","null","0","0","0","0","0","0","0.0","0.0","Non-CFO","2023","2","2023","1","03","31"
"2023-03-31","Bureau","Legislative Branch-Office of Tech.","Medicaid & CHIP Payment & Access Comm.","0","0","0","0","0","0","0.0","0.0","null","2023","2","2023","1","03","31"
"2023-03-31","Bureau","Legislative Branch-Office of Tech.","Open World Leadership","0","0","0","0","0","0","0.0","0.0","null","2023","2","2023","1","03","31"
"2023-03-31","Agency","Merit Systems Protection Board","null","144","1","144","1","0","0","100.0","100.0","Non-CFO","2023","2","2023","1","03","31"
"2023-03-31","Bureau","Merit Systems Protection Board","Merit Systems Protection Board","144","1","144","1","0","0","100.0","100.0","null","2023","2","2023","1","03","31"
"2023-03-31","Agency","National Aeronautics and Space Administration","null","1518126","127","1518126","127","0","0","100.0","100.0","CFO","2023","2","2023","1","03","31"
"2023-03-31","Bureau","National Aeronautics and Space Administration","National Aeronautics and Space Admin","1518126","127","1518126","127","0","0","100.0","100.0","null","2023","2","2023","1","03","31"
"2023-03-31","Agency","National Archives & Records Admin","null","136398","135","136398","135","0","0","100.0","100.0","Non-CFO","2023","2","2023","1","03","31"
"2023-03-31","Bureau","National Archives & Records Admin","Nat'l Archives & Records Administration","136398","135","136398","135","0","0","100.0","100.0","null","2023","2","2023","1","03","31"
"2023-03-31","Agency","National Credit Union Administration","null","2059","3","2059","3","0","0","100.0","100.0","Non-CFO","2023","2","2023","1","03","31"
"2023-03-31","Bureau","National Credit Union Administration","National Credit Union Administration","2059","3","2059","3","0","0","100.0","100.0","null","2023","2","2023","1","03","31"
"2023-03-31","Agency","National Foundation  Arts & Humanities","null","0","0","0","0","0","0","0.0","0.0","Non-CFO","2023","2","2023","1","03","31"
"2023-03-31","Bureau","National Foundation  Arts & Humanities","National Endowment for the Arts","0","0","0","0","0","0","0.0","0.0","null","2023","2","2023","1","03","31"
"2023-03-31","Bureau","National Foundation  Arts & Humanities","National Endowment for the Humanities","0","0","0","0","0","0","0.0","0.0","null","2023","2","2023","1","03","31"
"2023-03-31","Agency","National Labor Relations Board","null","0","0","0","0","0","0","0.0","0.0","Non-CFO","2023","2","2023","1","03","31"
"2023-03-31","Bureau","National Labor Relations Board","National Labor Relations Board","0","0","0","0","0","0","0.0","0.0","null","2023","2","2023","1","03","31"
"2023-03-31","Agency","National Science Foundation","null","723090","36","723090","36","0","0","100.0","100.0","CFO","2023","2","2023","1","03","31"
"2023-03-31","Bureau","National Science Foundation","National Science Foundation","723090","36","723090","36","0","0","100.0","100.0","null","2023","2","2023","1","03","31"
"2023-03-31","Agency","Neighborhood Reinvestment Corporation","null","0","0","0","0","0","0","0.0","0.0","Non-CFO","2023","2","2023","1","03","31"
"2023-03-31","Bureau","Neighborhood Reinvestment Corporation","Neighborhood Reinvestment Corporation","0","0","0","0","0","0","0.0","0.0","null","2023","2","2023","1","03","31"
"2023-03-31","Agency","Nuclear Regulatory Commission","null","3403607","400","3403607","400","0","0","100.0","100.0","CFO","2023","2","2023","1","03","31"
"2023-03-31","Bureau","Nuclear Regulatory Commission","Nuclear Regulatory Commission","3403607","400","3403607","400","0","0","100.0","100.0","null","2023","2","2023","1","03","31"
"2023-03-31","Agency","Occupational Safety & Health Rev Comm","null","0","0","0","0","0","0","0.0","0.0","Non-CFO","2023","2","2023","1","03","31"
"2023-03-31","Bureau","Occupational Safety & Health Rev Comm","Occupational Safety & Health Rev Comm","0","0","0","0","0","0","0.0","0.0","null","2023","2","2023","1","03","31"
"2023-03-31","Agency","Office of Compliance","null","0","0","0","0","0","0","0.0","0.0","Non-CFO","2023","2","2023","1","03","31"
"2023-03-31","Bureau","Office of Compliance","Office of Compliance","0","0","0","0","0","0","0.0","0.0","null","2023","2","2023","1","03","31"
"2023-03-31","Agency","Office of Government Ethics","null","0","0","0","0","0","0","0.0","0.0","Non-CFO","2023","2","2023","1","03","31"
"2023-03-31","Bureau","Office of Government Ethics","Office of Government Ethics","0","0","0","0","0","0","0.0","0.0","null","2023","2","2023","1","03","31"
"2023-03-31","Agency","Office of Personnel Management","null","20818481","1142","20818481","1142","0","0","100.0","100.0","CFO","2023","2","2023","1","03","31"
"2023-03-31","Bureau","Office of Personnel Management","Office of Personnel Management","20818481","1142","20818481","1142","0","0","100.0","100.0","null","2023","2","2023","1","03","31"
"2023-03-31","Agency","Office of Special Counsel","null","0","0","0","0","0","0","0.0","0.0","Non-CFO","2023","2","2023","1","03","31"
"2023-03-31","Bureau","Office of Special Counsel","Office of Special Counsel","0","0","0","0","0","0","0.0","0.0","null","2023","2","2023","1","03","31"
"2023-03-31","Agency","Other Agencies","null","3455905","51","544901","8","2911004","43","15.767244759332215","15.686274509803921","Non-CFO","2023","2","2023","1","03","31"
"2023-03-31","Bureau","Other Agencies","Advisory Council on Hist. Preservation","0","0","0","0","0","0","0.0","0.0","null","2023","2","2023","1","03","31"
"2023-03-31","Bureau","Other Agencies","Archit.&Trans. Barriers Compliance Bd","0","0","0","0","0","0","0.0","0.0","null","2023","2","2023","1","03","31"
"2023-03-31","Bureau","Other Agencies","Architect of the Capitol","0","0","0","0","0","0","0.0","0.0","null","2023","2","2023","1","03","31"
"2023-03-31","Bureau","Other Agencies","Chemical Safety Board","33438","2","33438","2","0","0","100.0","100.0","null","2023","2","2023","1","03","31"
"2023-03-31","Bureau","Other Agencies","Comm. for Purchase from Blind/Handic.","0","0","0","0","0","0","0.0","0.0","null","2023","2","2023","1","03","31"
"2023-03-31","Bureau","Other Agencies","Commission On Fine Arts","0","0","0","0","0","0","0.0","0.0","null","2023","2","2023","1","03","31"
"2023-03-31","Bureau","Other Agencies","Consumer Financial Protection Bureau","3200649","14","511463","6","2689186","8","15.979977810750258","42.857142857142854","null","2023","2","2023","1","03","31"
"2023-03-31","Bureau","Other Agencies","Council of Insps. Gen. of Intg. & Effy.","2569","6","0","0","2569","6","0.0","0.0","null","2023","2","2023","1","03","31"
"2023-03-31","Bureau","Other Agencies","Defense Nuclear Facilities Safety Board","0","0","0","0","0","0","0.0","0.0","null","2023","2","2023","1","03","31"
"2023-03-31","Bureau","Other Agencies","Delta Regional Authority","0","0","0","0","0","0","0.0","0.0","null","2023","2","2023","1","03","31"
"2023-03-31","Bureau","Other Agencies","Denali Commission","0","0","0","0","0","0","0.0","0.0","null","2023","2","2023","1","03","31"
"2023-03-31","Bureau","Other Agencies","District of Columbia Government","0","0","0","0","0","0","0.0","0.0","null","2023","2","2023","1","03","31"
"2023-03-31","Bureau","Other Agencies","Election Assistance Commission","5576","1","0","0","5576","1","0.0","0.0","null","2023","2","2023","1","03","31"
"2023-03-31","Bureau","Other Agencies","Federal Housing Finance Agency","0","0","0","0","0","0","0.0","0.0","null","2023","2","2023","1","03","31"
"2023-03-31","Bureau","Other Agencies","Federal Housing Finance Agency OIG","0","0","0","0","0","0","0.0","0.0","null","2023","2","2023","1","03","31"
"2023-03-31","Bureau","Other Agencies","Federal Mine Safety & Health Review Comm","0","0","0","0","0","0","0.0","0.0","null","2023","2","2023","1","03","31"
"2023-03-31","Bureau","Other Agencies","Gulf Coast Ecosystem Restoration Council","0","0","0","0","0","0","0.0","0.0","null","2023","2","2023","1","03","31"
"2023-03-31","Bureau","Other Agencies","James Madison Memorial Fellowship","201880","24","0","0","201880","24","0.0","0.0","null","2023","2","2023","1","03","31"
"2023-03-31","Bureau","Other Agencies","John C. Stennis","2934","2","0","0","2934","2","0.0","0.0","null","2023","2","2023","1","03","31"
"2023-03-31","Bureau","Other Agencies","Millennium Challenge Corporation","0","0","0","0","0","0","0.0","0.0","null","2023","2","2023","1","03","31"
"2023-03-31","Bureau","Other Agencies","Morris K. Udall Scholarship","0","0","0","0","0","0","0.0","0.0","null","2023","2","2023","1","03","31"
"2023-03-31","Bureau","Other Agencies","National Capital Planning Commission","0","0","0","0","0","0","0.0","0.0","null","2023","2","2023","1","03","31"
"2023-03-31","Bureau","Other Agencies","National Council on Disability","0","0","0","0","0","0","0.0","0.0","null","2023","2","2023","1","03","31"
"2023-03-31","Bureau","Other Agencies","National Mediation Board","0","0","0","0","0","0","0.0","0.0","null","2023","2","2023","1","03","31"
"2023-03-31","Bureau","Other Agencies","National Transportation Safety Board","0","0","0","0","0","0","0.0","0.0","null","2023","2","2023","1","03","31"
"2023-03-31","Bureau","Other Agencies","Privacy & Civil Liberties Oversight Bd","0","0","0","0","0","0","0.0","0.0","null","2023","2","2023","1","03","31"
"2023-03-31","Bureau","Other Agencies","Surface Transportation Board","0","0","0","0","0","0","0.0","0.0","null","2023","2","2023","1","03","31"
"2023-03-31","Bureau","Other Agencies","U.S.  Agency of Global Media","0","0","0","0","0","0","0.0","0.0","null","2023","2","2023","1","03","31"
"2023-03-31","Bureau","Other Agencies","U.S. Holocaust Memorial Council","0","0","0","0","0","0","0.0","0.0","null","2023","2","2023","1","03","31"
"2023-03-31","Bureau","Other Agencies","U.S. Inst. for Env. Conflict Resolution","8859","2","0","0","8859","2","0.0","0.0","null","2023","2","2023","1","03","31"
"2023-03-31","Bureau","Other Agencies","U.S. Institute of Peace","0","0","0","0","0","0","0.0","0.0","null","2023","2","2023","1","03","31"
"2023-03-31","Agency","Other Agencies/Boards/Commissions","null","1024","1","0","0","1024","1","0.0","0.0","Non-CFO","2023","2","2023","1","03","31"
"2023-03-31","Bureau","Other Agencies/Boards/Commissions","Medicare Payment Advisory Commission","0","0","0","0","0","0","0.0","0.0","null","2023","2","2023","1","03","31"
"2023-03-31","Bureau","Other Agencies/Boards/Commissions","Nuclear Waste Technical Review Board","0","0","0","0","0","0","0.0","0.0","null","2023","2","2023","1","03","31"
"2023-03-31","Bureau","Other Agencies/Boards/Commissions","U.S. Comm. on Int. Religious Freedom","1024","1","0","0","1024","1","0.0","0.0","null","2023","2","2023","1","03","31"
"2023-03-31","Bureau","Other Agencies/Boards/Commissions","U.S.-China Security Review Commission","0","0","0","0","0","0","0.0","0.0","null","2023","2","2023","1","03","31"
"2023-03-31","Agency","Pension Benefit Guaranty Corp","null","4393578","1832","4393578","1832","0","0","100.0","100.0","Non-CFO","2023","2","2023","1","03","31"
"2023-03-31","Bureau","Pension Benefit Guaranty Corp","Pension Benefit Guaranty Corporation","4393578","1832","4393578","1832","0","0","100.0","100.0","null","2023","2","2023","1","03","31"
"2023-03-31","Agency","Presidio Trust Corporation","null","1536491","62","1536491","62","0","0","100.0","100.0","Non-CFO","2023","2","2023","1","03","31"
"2023-03-31","Bureau","Presidio Trust Corporation","Presidio Trust Corporation","1536491","62","1536491","62","0","0","100.0","100.0","null","2023","2","2023","1","03","31"
"2023-03-31","Agency","Railroad Retirement Board","null","21469634","4059","21469634","4059","0","0","100.0","100.0","Non-CFO","2023","2","2023","1","03","31"
"2023-03-31","Bureau","Railroad Retirement Board","Railroad Retirement Board","21469634","4059","21469634","4059","0","0","100.0","100.0","null","2023","2","2023","1","03","31"
"2023-03-31","Agency","Securities & Exchange Commission","null","2503848184","1310","2503848184","1310","0","0","100.0","100.0","Non-CFO","2023","2","2023","1","03","31"
"2023-03-31","Bureau","Securities & Exchange Commission","SEC Enforcement","2503576364","1263","2503576364","1263","0","0","100.0","100.0","null","2023","2","2023","1","03","31"
"2023-03-31","Bureau","Securities & Exchange Commission","Securities and Exchange Commission","271820","47","271820","47","0","0","100.0","100.0","null","2023","2","2023","1","03","31"
"2023-03-31","Agency","Selective Service System","null","1746","10","0","0","1746","10","0.0","0.0","Non-CFO","2023","2","2023","1","03","31"
"2023-03-31","Bureau","Selective Service System","Selective Service System","1746","10","0","0","1746","10","0.0","0.0","null","2023","2","2023","1","03","31"
"2023-03-31","Agency","Small Business Administration","null","17077256847","145761","17077256847","145761","0","0","100.0","100.0","CFO","2023","2","2023","1","03","31"
"2023-03-31","Bureau","Small Business Administration","Small Business Administration","17077256847","145761","17077256847","145761","0","0","100.0","100.0","null","2023","2","2023","1","03","31"
"2023-03-31","Agency","Smithsonian Institution","null","1072","2","0","0","1072","2","0.0","0.0","Non-CFO","2023","2","2023","1","03","31"
"2023-03-31","Bureau","Smithsonian Institution","Administrative Conference of the US","0","0","0","0","0","0","0.0","0.0","null","2023","2","2023","1","03","31"
"2023-03-31","Bureau","Smithsonian Institution","JFK Center for the Performing Arts","0","0","0","0","0","0","0.0","0.0","null","2023","2","2023","1","03","31"
"2023-03-31","Bureau","Smithsonian Institution","National Gallery of Art","0","0","0","0","0","0","0.0","0.0","null","2023","2","2023","1","03","31"
"2023-03-31","Bureau","Smithsonian Institution","Smithsonian Institution","1072","2","0","0","1072","2","0.0","0.0","null","2023","2","2023","1","03","31"
"2023-03-31","Agency","Social Security Administration","null","4267946717","1316732","2479596037","423349","1788350680","893383","58.09810200121109","32.15149324236063","CFO","2023","2","2023","1","03","31"
"2023-03-31","Bureau","Social Security Administration","Social Security Administration","4267946717","1316732","2479596037","423349","1788350680","893383","58.09810200121109","32.15149324236063","null","2023","2","2023","1","03","31"
"2023-03-31","Agency","Tennessee Valley Authority","null","0","0","0","0","0","0","0.0","0.0","Non-CFO","2023","2","2023","1","03","31"
"2023-03-31","Bureau","Tennessee Valley Authority","Tennessee Valley Authority","0","0","0","0","0","0","0.0","0.0","null","2023","2","2023","1","03","31"
"2023-03-31","Agency","The Judiciary","null","1049654","305","1027309","170","22345","135","97.87120327269749","55.73770491803279","Non-CFO","2023","2","2023","1","03","31"
"2023-03-31","Bureau","The Judiciary","Administrative Office of the U.S. Courts","1049654","305","1027309","170","22345","135","97.87120327269749","55.73770491803279","null","2023","2","2023","1","03","31"
"2023-03-31","Agency","U.S. Court of Appeals / Veterans Claims","null","0","0","0","0","0","0","0.0","0.0","Non-CFO","2023","2","2023","1","03","31"
"2023-03-31","Bureau","U.S. Court of Appeals / Veterans Claims","U.S. Court of Appeals / Veterans Claims","0","0","0","0","0","0","0.0","0.0","null","2023","2","2023","1","03","31"
"2023-03-31","Agency","U.S. Postal Service","null","74931124","70842","64695889","59703","10235235","11139","86.34047582150242","84.27627678495807","Non-CFO","2023","2","2023","1","03","31"
"2023-03-31","Bureau","U.S. Postal Service","U.S. Postal Service","74931124","70842","64695889","59703","10235235","11139","86.34047582150242","84.27627678495807","null","2023","2","2023","1","03","31"
"2023-03-31","Agency","U.S. Tax Court","null","0","0","0","0","0","0","0.0","0.0","Non-CFO","2023","2","2023","1","03","31"
"2023-03-31","Bureau","U.S. Tax Court","U.S. Tax Court","0","0","0","0","0","0","0.0","0.0","null","2023","2","2023","1","03","31"
"2023-03-31","Agency","US International Development Fin. Corp.","null","0","0","0","0","0","0","0.0","0.0","Non-CFO","2023","2","2023","1","03","31"
"2023-03-31","Bureau","US International Development Fin. Corp.","US International Development Fin. Corp.","0","0","0","0","0","0","0.0","0.0","null","2023","2","2023","1","03","31"
"2022-12-31","Agency","Agency for International Development","null","25351903","51","25351631","50","272","1","99.99892710223764","98.03921568627452","CFO","2023","1","2022","4","12","31"
"2022-12-31","Bureau","Agency for International Development","Agency for International Development","25351903","51","25351631","50","272","1","99.99892710223764","98.03921568627452","null","2023","1","2022","4","12","31"
"2022-12-31","Agency","American Battle Monuments Commission","null","0","0","0","0","0","0","0.0","0.0","Non-CFO","2023","1","2022","4","12","31"
"2022-12-31","Bureau","American Battle Monuments Commission","American Battle Monuments Commission","0","0","0","0","0","0","0.0","0.0","null","2023","1","2022","4","12","31"
"2022-12-31","Agency","Armed Forces Retirement Home","null","89570","102","76892","101","12678","1","85.8457072680585","99.01960784313725","Non-CFO","2023","1","2022","4","12","31"
"2022-12-31","Bureau","Armed Forces Retirement Home","Armed Forces Retirement Home","89570","102","76892","101","12678","1","85.8457072680585","99.01960784313725","null","2023","1","2022","4","12","31"
"2022-12-31","Agency","Commodity Futures Trading Commission","null","622455680","360","622455680","360","0","0","100.0","100.0","Non-CFO","2023","1","2022","4","12","31"
"2022-12-31","Bureau","Commodity Futures Trading Commission","Commodity Futures Trading Commission","622455680","360","622455680","360","0","0","100.0","100.0","null","2023","1","2022","4","12","31"
"2022-12-31","Agency","Consumer Product Safety Commission","null","265","2","265","2","0","0","100.0","100.0","Non-CFO","2023","1","2022","4","12","31"
"2022-12-31","Bureau","Consumer Product Safety Commission","Consumer Product Safety Commission","265","2","265","2","0","0","100.0","100.0","null","2023","1","2022","4","12","31"
"2022-12-31","Agency","Corp. for National and Community Service","null","3772562","329","3608435","157","164127","172","95.64945519782047","47.72036474164134","Non-CFO","2023","1","2022","4","12","31"
"2022-12-31","Bureau","Corp. for National and Community Service","Corp. for National and Community Service","3772562","329","3608435","157","164127","172","95.64945519782047","47.72036474164134","null","2023","1","2022","4","12","31"
"2022-12-31","Agency","Department of Agriculture","null","1540202245","53709","1527649309","49393","12552936","4316","99.18498132042393","91.96410285054647","CFO","2023","1","2022","4","12","31"
"2022-12-31","Bureau","Department of Agriculture","Agricultural Marketing Service","6392464","3054","4282555","1307","2109909","1747","66.99380708284005","42.79633267845448","null","2023","1","2022","4","12","31"
"2022-12-31","Bureau","Department of Agriculture","Commodity Credit Corporation","133287779","9302","133287779","9302","0","0","100.0","100.0","null","2023","1","2022","4","12","31"
"2022-12-31","Bureau","Department of Agriculture","Farm Service Agency","444918565","4504","444918565","4504","0","0","100.0","100.0","null","2023","1","2022","4","12","31"
"2022-12-31","Bureau","Department of Agriculture","Federal Crop Insurance Corporation","22231","389","20237","384","1994","5","91.03054293554047","98.7146529562982","null","2023","1","2022","4","12","31"
"2022-12-31","Bureau","Department of Agriculture","Food Safety and Inspection Service","1253519","1105","1200239","1045","53280","60","95.74956582229707","94.57013574660634","null","2023","1","2022","4","12","31"
"2022-12-31","Bureau","Department of Agriculture","Food and Nutrition Service","2837982","42","61718","20","2776264","22","2.174714286419012","47.61904761904762","null","2023","1","2022","4","12","31"
"2022-12-31","Bureau","Department of Agriculture","Forest Service","72459705","741","68128210","345","4331495","396","94.02220171887258","46.558704453441294","null","2023","1","2022","4","12","31"
"2022-12-31","Bureau","Department of Agriculture","Rural Development","858327027","30134","858303970","30036","23057","98","99.99731372783627","99.67478595606292","null","2023","1","2022","4","12","31"
"2022-12-31","Bureau","Department of Agriculture","U.S. Department of Agriculture","20702973","4438","17446036","2450","3256937","1988","84.26826427296214","55.20504731861199","null","2023","1","2022","4","12","31"
"2022-12-31","Agency","Department of Commerce","null","60359754","18226","60359754","18226","0","0","100.0","100.0","CFO","2023","1","2022","4","12","31"
"2022-12-31","Bureau","Department of Commerce","Bureau of Industry and Security","37612305","28","37612305","28","0","0","100.0","100.0","null","2023","1","2022","4","12","31"
"2022-12-31","Bureau","Department of Commerce","Bureau of the Census","3028059","16479","3028059","16479","0","0","100.0","100.0","null","2023","1","2022","4","12","31"
"2022-12-31","Bureau","Department of Commerce","Economic Development Administration","5137182","12","5137182","12","0","0","100.0","100.0","null","2023","1","2022","4","12","31"
"2022-12-31","Bureau","Department of Commerce","Economic and Statistical Analysis","0","0","0","0","0","0","0.0","0.0","null","2023","1","2022","4","12","31"
"2022-12-31","Bureau","Department of Commerce","General Administration","4660","1","4660","1","0","0","100.0","100.0","null","2023","1","2022","4","12","31"
"2022-12-31","Bureau","Department of Commerce","International Trade Administration","0","0","0","0","0","0","0.0","0.0","null","2023","1","2022","4","12","31"
"2022-12-31","Bureau","Department of Commerce","Minority Business Development Agency","0","0","0","0","0","0","0.0","0.0","null","2023","1","2022","4","12","31"
"2022-12-31","Bureau","Department of Commerce","NOAA","12995655","989","12995655","989","0","0","100.0","100.0","null","2023","1","2022","4","12","31"
"2022-12-31","Bureau","Department of Commerce","Nat'l Institute of Standards& Technology","673458","5","673458","5","0","0","100.0","100.0","null","2023","1","2022","4","12","31"
"2022-12-31","Bureau","Department of Commerce","Nat'l Telecomm & Information Admin.","296093","1","296093","1","0","0","100.0","100.0","null","2023","1","2022","4","12","31"
"2022-12-31","Bureau","Department of Commerce","National Technical Information Service","0","0","0","0","0","0","0.0","0.0","null","2023","1","2022","4","12","31"
"2022-12-31","Bureau","Department of Commerce","Office of the Inspector General","0","0","0","0","0","0","0.0","0.0","null","2023","1","2022","4","12","31"
"2022-12-31","Bureau","Department of Commerce","Patent and Trademark Office","612342","711","612342","711","0","0","100.0","100.0","null","2023","1","2022","4","12","31"
"2022-12-31","Agency","Department of Defense","null","3257830863","1685237","1276544844","312494","1981286019","1372743","39.183889455344016","18.543029852774417","CFO","2023","1","2022","4","12","31"
"2022-12-31","Bureau","Department of Defense","Consolidated Report","3257830863","1685237","1276544844","312494","1981286019","1372743","39.183889455344016","18.543029852774417","null","2023","1","2022","4","12","31"
"2022-12-31","Agency","Department of Education","null","124304579573","21170973","124290511607","21170892","14067966","81","99.98868266475111","99.99961740067403","CFO","2023","1","2022","4","12","31"
"2022-12-31","Bureau","Department of Education","Departmental Management","1433486573","2090","1419418607","2009","14067966","81","99.01861892082054","96.1244019138756","null","2023","1","2022","4","12","31"
"2022-12-31","Bureau","Department of Education","Federal Student Aid","122871093000","21168883","122871093000","21168883","0","0","100.0","100.0","null","2023","1","2022","4","12","31"
"2022-12-31","Bureau","Department of Education","Office of Postsecondary Education","0","0","0","0","0","0","0.0","0.0","null","2023","1","2022","4","12","31"
"2022-12-31","Agency","Department of Energy","null","14274376","118","13728440","111","545936","7","96.1754125013941","94.0677966101695","CFO","2023","1","2022","4","12","31"
"2022-12-31","Bureau","Department of Energy","Bonneville Power Administration","1603428","31","1057492","24","545936","7","65.95194795151389","77.41935483870968","null","2023","1","2022","4","12","31"
"2022-12-31","Bureau","Department of Energy","Energy Consolidated Reports","12670948","87","12670948","87","0","0","100.0","100.0","null","2023","1","2022","4","12","31"
"2022-12-31","Agency","Department of Health & Human Services","null","10293433621","1129824","9937387699","1098420","356045922","31404","96.5410383443517","97.22045203500723","CFO","2023","1","2022","4","12","31"
"2022-12-31","Bureau","Department of Health & Human Services","Administration for Children and Families","37066448","1657","37066448","1657","0","0","100.0","100.0","null","2023","1","2022","4","12","31"
"2022-12-31","Bureau","Department of Health & Human Services","Administration for Community Living","8321","1","8321","1","0","0","100.0","100.0","null","2023","1","2022","4","12","31"
"2022-12-31","Bureau","Department of Health & Human Services","Centers for Disease Control","9180655","104","891933","17","8288722","87","9.71535255382105","16.346153846153847","null","2023","1","2022","4","12","31"
"2022-12-31","Bureau","Department of Health & Human Services","Centers for Medicare & Medicaid Services","9752567667","1100009","9642651691","1089381","109915976","10628","98.87295346463551","99.03382608687747","null","2023","1","2022","4","12","31"
"2022-12-31","Bureau","Department of Health & Human Services","Food and Drug Administration","260807653","21778","41566917","1880","219240736","19898","15.937767362984552","8.632564973826797","null","2023","1","2022","4","12","31"
"2022-12-31","Bureau","Department of Health & Human Services","Health Resources and Services Admin","108894444","633","108894444","633","0","0","100.0","100.0","null","2023","1","2022","4","12","31"
"2022-12-31","Bureau","Department of Health & Human Services","Indian Health Services","91046252","4415","91046252","4415","0","0","100.0","100.0","null","2023","1","2022","4","12","31"
"2022-12-31","Bureau","Department of Health & Human Services","National Institutes of Health","26060513","914","7460025","123","18600488","791","28.625779546243006","13.457330415754923","null","2023","1","2022","4","12","31"
"2022-12-31","Bureau","Department of Health & Human Services","Office of the Inspector General","0","0","0","0","0","0","0.0","0.0","null","2023","1","2022","4","12","31"
"2022-12-31","Bureau","Department of Health & Human Services","Office of the Secretary","466825","7","466825","7","0","0","100.0","100.0","null","2023","1","2022","4","12","31"
"2022-12-31","Bureau","Department of Health & Human Services","Program Support Center","6269932","294","6269932","294","0","0","100.0","100.0","null","2023","1","2022","4","12","31"
"2022-12-31","Bureau","Department of Health & Human Services","Substance Abuse & Mental Health Admin.","1064911","12","1064911","12","0","0","100.0","100.0","null","2023","1","2022","4","12","31"
"2022-12-31","Agency","Department of Homeland Security","null","280434253","70568","275248954","58089","5185299","12479","98.1509751592292","82.31634735290784","CFO","2023","1","2022","4","12","31"
"2022-12-31","Bureau","Department of Homeland Security","Bureau of Customs & Border Protection","9396552","777","9396552","777","0","0","100.0","100.0","null","2023","1","2022","4","12","31"
"2022-12-31","Bureau","Department of Homeland Security","Citizenship and Immigration Services","1094952","1278","1094952","1278","0","0","100.0","100.0","null","2023","1","2022","4","12","31"
"2022-12-31","Bureau","Department of Homeland Security","Domestic Nuclear Detection Office","1493","17","0","0","1493","17","0.0","0.0","null","2023","1","2022","4","12","31"
"2022-12-31","Bureau","Department of Homeland Security","Emergency Preparedness & Resp","235879654","41080","235879654","41080","0","0","100.0","100.0","null","2023","1","2022","4","12","31"
"2022-12-31","Bureau","Department of Homeland Security","Federal Law Enforcement Training Ctr.","8562","1","8562","1","0","0","100.0","100.0","null","2023","1","2022","4","12","31"
"2022-12-31","Bureau","Department of Homeland Security","Immigration and Customs Enforcement","15802534","628","15802534","628","0","0","100.0","100.0","null","2023","1","2022","4","12","31"
"2022-12-31","Bureau","Department of Homeland Security","Info Analysis Infrastructure Prot-NPPD","0","0","0","0","0","0","0.0","0.0","null","2023","1","2022","4","12","31"
"2022-12-31","Bureau","Department of Homeland Security","Management Headquarters","0","0","0","0","0","0","0.0","0.0","null","2023","1","2022","4","12","31"
"2022-12-31","Bureau","Department of Homeland Security","Office of Biometric Identity Management","0","0","0","0","0","0","0.0","0.0","null","2023","1","2022","4","12","31"
"2022-12-31","Bureau","Department of Homeland Security","Office of the Inspector General DHS","100","1","100","1","0","0","100.0","100.0","null","2023","1","2022","4","12","31"
"2022-12-31","Bureau","Department of Homeland Security","Science and Technology","0","0","0","0","0","0","0.0","0.0","null","2023","1","2022","4","12","31"
"2022-12-31","Bureau","Department of Homeland Security","Transportation Safety Administration","11801911","12920","11801911","12920","0","0","100.0","100.0","null","2023","1","2022","4","12","31"
"2022-12-31","Bureau","Department of Homeland Security","U.S. Coast Guard","6448495","13866","1264689","1404","5183806","12462","19.612157565447443","10.125486802250109","null","2023","1","2022","4","12","31"
"2022-12-31","Bureau","Department of Homeland Security","U.S. Secret Service","0","0","0","0","0","0","0.0","0.0","null","2023","1","2022","4","12","31"
"2022-12-31","Agency","Department of Housing and Urban Development","null","64536366","2484","62473306","2472","2063060","12","96.80325973111036","99.51690821256038","CFO","2023","1","2022","4","12","31"
"2022-12-31","Bureau","Department of Housing and Urban Development","Community Planning and Development","0","0","0","0","0","0","0.0","0.0","null","2023","1","2022","4","12","31"
"2022-12-31","Bureau","Department of Housing and Urban Development","Government National Mortgage Association","0","0","0","0","0","0","0.0","0.0","null","2023","1","2022","4","12","31"
"2022-12-31","Bureau","Department of Housing and Urban Development","Housing Programs","63421779","2477","62468600","2470","953179","7","98.4970793707947","99.71740008074283","null","2023","1","2022","4","12","31"
"2022-12-31","Bureau","Department of Housing and Urban Development","Management and Administration","4706","2","4706","2","0","0","100.0","100.0","null","2023","1","2022","4","12","31"
"2022-12-31","Bureau","Department of Housing and Urban Development","Policy, Development and Research","0","0","0","0","0","0","0.0","0.0","null","2023","1","2022","4","12","31"
"2022-12-31","Bureau","Department of Housing and Urban Development","Public and Indian Housing Programs","1109881","5","0","0","1109881","5","0.0","0.0","null","2023","1","2022","4","12","31"
"2022-12-31","Agency","Department of Justice","null","91544767","39054","89057094","38633","2487673","421","97.28256121947419","98.92200542838121","CFO","2023","1","2022","4","12","31"
"2022-12-31","Bureau","Department of Justice","Bureau of ATF and Explosives","20073","3","20073","3","0","0","100.0","100.0","null","2023","1","2022","4","12","31"
"2022-12-31","Bureau","Department of Justice","Drug Enforcement Administration","307536","21","307536","21","0","0","100.0","100.0","null","2023","1","2022","4","12","31"
"2022-12-31","Bureau","Department of Justice","Federal Bureau of Investigation","448751","100","448751","100","0","0","100.0","100.0","null","2023","1","2022","4","12","31"
"2022-12-31","Bureau","Department of Justice","Federal Prison Industries","26508","16","0","0","26508","16","0.0","0.0","null","2023","1","2022","4","12","31"
"2022-12-31","Bureau","Department of Justice","Federal Prison System","0","0","0","0","0","0","0.0","0.0","null","2023","1","2022","4","12","31"
"2022-12-31","Bureau","Department of Justice","General Administration","0","0","0","0","0","0","0.0","0.0","null","2023","1","2022","4","12","31"
"2022-12-31","Bureau","Department of Justice","Legal Activities","89511092","38908","87049927","38503","2461165","405","97.25043573370773","98.95908296494294","null","2023","1","2022","4","12","31"
"2022-12-31","Bureau","Department of Justice","Office of Justice Assistance Programs","1230807","6","1230807","6","0","0","100.0","100.0","null","2023","1","2022","4","12","31"
"2022-12-31","Bureau","Department of Justice","U.S. Marshals Service","0","0","0","0","0","0","0.0","0.0","null","2023","1","2022","4","12","31"
"2022-12-31","Agency","Department of Labor","null","172044423","14305","154987719","11235","17056704","3070","90.0858721819771","78.53897238727717","CFO","2023","1","2022","4","12","31"
"2022-12-31","Bureau","Department of Labor","Bureau of Labor Statistics","5608","1","5608","1","0","0","100.0","100.0","null","2023","1","2022","4","12","31"
"2022-12-31","Bureau","Department of Labor","Departmental Management","0","0","0","0","0","0","0.0","0.0","null","2023","1","2022","4","12","31"
"2022-12-31","Bureau","Department of Labor","Employee Benefit Security Administration","21655166","481","21655166","481","0","0","100.0","100.0","null","2023","1","2022","4","12","31"
"2022-12-31","Bureau","Department of Labor","Employment Standards Administration","71778006","4260","62520239","2784","9257767","1476","87.10222320748225","65.35211267605634","null","2023","1","2022","4","12","31"
"2022-12-31","Bureau","Department of Labor","Employment and Training Administration","1257939","11","1257939","11","0","0","100.0","100.0","null","2023","1","2022","4","12","31"
"2022-12-31","Bureau","Department of Labor","Mine Safety and Health Administration","12422003","4451","11466981","3756","955022","695","92.31185180039","84.38553134127163","null","2023","1","2022","4","12","31"
"2022-12-31","Bureau","Department of Labor","Occupational Safety and Health Admin","64925701","5101","58081786","4202","6843915","899","89.45885081779863","82.37600470495981","null","2023","1","2022","4","12","31"
"2022-12-31","Agency","Department of State","null","24450821","22467","23616490","22427","834331","40","96.58771785209176","99.82196109850003","CFO","2023","1","2022","4","12","31"
"2022-12-31","Bureau","Department of State","Civil Monetary Penalties","null","null","null","null","null","null","null","null","null","2023","1","2022","4","12","31"
"2022-12-31","Bureau","Department of State","Department of State","22566954","10315","21732623","10275","834331","40","96.30286391331325","99.6122152205526","null","2023","1","2022","4","12","31"
"2022-12-31","Bureau","Department of State","International Commissions","0","0","0","0","0","0","0.0","0.0","null","2023","1","2022","4","12","31"
"2022-12-31","Bureau","Department of State","Passport NSF","1883867","12152","1883867","12152","0","0","100.0","100.0","null","2023","1","2022","4","12","31"
"2022-12-31","Agency","Department of Transportation","null","75330343","8190","75329795","8189","548","1","99.99927253749529","99.98778998778998","CFO","2023","1","2022","4","12","31"
"2022-12-31","Bureau","Department of Transportation","Federal Aviation Administration","2185286","282","2185286","282","0","0","100.0","100.0","null","2023","1","2022","4","12","31"
"2022-12-31","Bureau","Department of Transportation","Federal Highway Administration","14174","12","14174","12","0","0","100.0","100.0","null","2023","1","2022","4","12","31"
"2022-12-31","Bureau","Department of Transportation","Federal Motor Carrier Safety Admin","70097903","7765","70097355","7764","548","1","99.9992182362431","99.98712169993561","null","2023","1","2022","4","12","31"
"2022-12-31","Bureau","Department of Transportation","Federal Railroad Administration","144217","16","144217","16","0","0","100.0","100.0","null","2023","1","2022","4","12","31"
"2022-12-31","Bureau","Department of Transportation","Federal Transit Administration","783405","1","783405","1","0","0","100.0","100.0","null","2023","1","2022","4","12","31"
"2022-12-31","Bureau","Department of Transportation","Maritime Administration","66630","15","66630","15","0","0","100.0","100.0","null","2023","1","2022","4","12","31"
"2022-12-31","Bureau","Department of Transportation","National Highway Traffic Safety Admin.","37085","6","37085","6","0","0","100.0","100.0","null","2023","1","2022","4","12","31"
"2022-12-31","Bureau","Department of Transportation","Office of the Inspector General","0","0","0","0","0","0","0.0","0.0","null","2023","1","2022","4","12","31"
"2022-12-31","Bureau","Department of Transportation","Office of the Secretary","1111148","16","1111148","16","0","0","100.0","100.0","null","2023","1","2022","4","12","31"
"2022-12-31","Bureau","Department of Transportation","Pipeline Hazardous Material Safety Admin","881782","74","881782","74","0","0","100.0","100.0","null","2023","1","2022","4","12","31"
"2022-12-31","Bureau","Department of Transportation","Research Innovative Technology Admin","985","1","985","1","0","0","100.0","100.0","null","2023","1","2022","4","12","31"
"2022-12-31","Bureau","Department of Transportation","St. Lawrence Seaway Development Corp.","7728","2","7728","2","0","0","100.0","100.0","null","2023","1","2022","4","12","31"
"2022-12-31","Agency","Department of Veterans Affairs","null","405338120","10557015","401135916","10552235","4202204","4780","98.96328428226785","99.95472204974607","CFO","2023","1","2022","4","12","31"
"2022-12-31","Bureau","Department of Veterans Affairs","Administration and Cemeteries","1891356","943","114543","106","1776813","837","6.056131156693928","11.240721102863203","null","2023","1","2022","4","12","31"
"2022-12-31","Bureau","Department of Veterans Affairs","Housing Credit Assistance","449668","58","671","1","448997","57","0.14922120319880444","1.7241379310344827","null","2023","1","2022","4","12","31"
"2022-12-31","Bureau","Department of Veterans Affairs","Life Insurance","1223579","252","1223579","252","0","0","100.0","100.0","null","2023","1","2022","4","12","31"
"2022-12-31","Bureau","Department of Veterans Affairs","Medical and Construction","400542119","10554130","399797123","10551876","744996","2254","99.81400308115911","99.9786434315287","null","2023","1","2022","4","12","31"
"2022-12-31","Bureau","Department of Veterans Affairs","Veterans Benefits","1231398","1632","0","0","1231398","1632","0.0","0.0","null","2023","1","2022","4","12","31"
"2022-12-31","Agency","Department of the Interior","null","72318961","35034","72315774","34999","3187","35","99.99559313359052","99.90009704858137","CFO","2023","1","2022","4","12","31"
"2022-12-31","Bureau","Department of the Interior","Bureau of Indian Affairs","16547632","30908","16544445","30873","3187","35","99.98074044672978","99.8867607092015","null","2023","1","2022","4","12","31"
"2022-12-31","Bureau","Department of the Interior","Bureau of Land Management","9070965","427","9070965","427","0","0","100.0","100.0","null","2023","1","2022","4","12","31"
"2022-12-31","Bureau","Department of the Interior","Bureau of Ocean Energy Mgmt., Reg & Enf","1724","1","1724","1","0","0","100.0","100.0","null","2023","1","2022","4","12","31"
"2022-12-31","Bureau","Department of the Interior","Bureau of Reclamation","7339232","68","7339232","68","0","0","100.0","100.0","null","2023","1","2022","4","12","31"
"2022-12-31","Bureau","Department of the Interior","Bureau of Safety and Environmental Enf.","14790","3","14790","3","0","0","100.0","100.0","null","2023","1","2022","4","12","31"
"2022-12-31","Bureau","Department of the Interior","Fish and Wildlife Service","811631","113","811631","113","0","0","100.0","100.0","null","2023","1","2022","4","12","31"
"2022-12-31","Bureau","Department of the Interior","Geological Survey","170576","493","170576","493","0","0","100.0","100.0","null","2023","1","2022","4","12","31"
"2022-12-31","Bureau","Department of the Interior","National Park Service","8661935","2056","8661935","2056","0","0","100.0","100.0","null","2023","1","2022","4","12","31"
"2022-12-31","Bureau","Department of the Interior","Office of Natural Resources Revenue","21451244","579","21451244","579","0","0","100.0","100.0","null","2023","1","2022","4","12","31"
"2022-12-31","Bureau","Department of the Interior","Office of Surface Mining","8147070","359","8147070","359","0","0","100.0","100.0","null","2023","1","2022","4","12","31"
"2022-12-31","Bureau","Department of the Interior","Office of the Secretary","102162","27","102162","27","0","0","100.0","100.0","null","2023","1","2022","4","12","31"
"2022-12-31","Agency","Department of the Treasury","null","41823044","4806","41183954","4793","639090","13","98.47191897366437","99.72950478568455","CFO","2023","1","2022","4","12","31"
"2022-12-31","Bureau","Department of the Treasury","Bureau of Engraving and Printing","38345","2","38345","2","0","0","100.0","100.0","null","2023","1","2022","4","12","31"
"2022-12-31","Bureau","Department of the Treasury","Bureau of the Fiscal Service","13373149","3360","13373149","3360","0","0","100.0","100.0","null","2023","1","2022","4","12","31"
"2022-12-31","Bureau","Department of the Treasury","Community Dev Financial Inst Fund","3665183","8","3665183","8","0","0","100.0","100.0","null","2023","1","2022","4","12","31"
"2022-12-31","Bureau","Department of the Treasury","Comptroller of the Currency","1434067","25","1432024","22","2043","3","99.85753803692575","88.0","null","2023","1","2022","4","12","31"
"2022-12-31","Bureau","Department of the Treasury","D.C. Pension Program","455729","21","455729","21","0","0","100.0","100.0","null","2023","1","2022","4","12","31"
"2022-12-31","Bureau","Department of the Treasury","Departmental Offices","20980603","1320","20600933","1314","379670","6","98.19037612979952","99.54545454545455","null","2023","1","2022","4","12","31"
"2022-12-31","Bureau","Department of the Treasury","Financial Crimes Enforcement Network","1544945","3","1544945","3","0","0","100.0","100.0","null","2023","1","2022","4","12","31"
"2022-12-31","Bureau","Department of the Treasury","Interest on Tax/Deposit of Earnings","0","0","0","0","0","0","0.0","0.0","null","2023","1","2022","4","12","31"
"2022-12-31","Bureau","Department of the Treasury","Internal Revenue Service","44932","40","44932","40","0","0","100.0","100.0","null","2023","1","2022","4","12","31"
"2022-12-31","Bureau","Department of the Treasury","International Monetary Funds","0","0","0","0","0","0","0.0","0.0","null","2023","1","2022","4","12","31"
"2022-12-31","Bureau","Department of the Treasury","Office of Financial Research","268","1","268","1","0","0","100.0","100.0","null","2023","1","2022","4","12","31"
"2022-12-31","Bureau","Department of the Treasury","Office of Sec International Affairs","0","0","0","0","0","0","0.0","0.0","null","2023","1","2022","4","12","31"
"2022-12-31","Bureau","Department of the Treasury","Office of the Secretary","0","0","0","0","0","0","0.0","0.0","null","2023","1","2022","4","12","31"
"2022-12-31","Bureau","Department of the Treasury","Pandemic Receivables","256377","3","0","0","256377","3","0.0","0.0","null","2023","1","2022","4","12","31"
"2022-12-31","Bureau","Department of the Treasury","Spec Insp Gen-Troubled Asset Rel Prog","3916","1","3916","1","0","0","100.0","100.0","null","2023","1","2022","4","12","31"
"2022-12-31","Bureau","Department of the Treasury","Tobacco Tax and Trade","1000","1","1000","1","0","0","100.0","100.0","null","2023","1","2022","4","12","31"
"2022-12-31","Bureau","Department of the Treasury","Treasury Forfeiture Fund","0","0","0","0","0","0","0.0","0.0","null","2023","1","2022","4","12","31"
"2022-12-31","Bureau","Department of the Treasury","Treasury Franchise Fund","0","0","0","0","0","0","0.0","0.0","null","2023","1","2022","4","12","31"
"2022-12-31","Bureau","Department of the Treasury","Treasury IG for Tax Admin","193","1","193","1","0","0","100.0","100.0","null","2023","1","2022","4","12","31"
"2022-12-31","Bureau","Department of the Treasury","U.S. Mint","24337","20","23337","19","1000","1","95.89103011874923","95.0","null","2023","1","2022","4","12","31"
"2022-12-31","Bureau","Department of the Treasury","U.S. Treasury IG Office","0","0","0","0","0","0","0.0","0.0","null","2023","1","2022","4","12","31"
"2022-12-31","Agency","Environmental Protection Agency","null","26224070","261","26223693","259","377","2","99.9985623894384","99.23371647509579","CFO","2023","1","2022","4","12","31"
"2022-12-31","Bureau","Environmental Protection Agency","Environmental Protection Agency","26224070","261","26223693","259","377","2","99.9985623894384","99.23371647509579","null","2023","1","2022","4","12","31"
"2022-12-31","Agency","Equal Employment Opportunity Commission","null","24912","23","24912","23","0","0","100.0","100.0","Non-CFO","2023","1","2022","4","12","31"
"2022-12-31","Bureau","Equal Employment Opportunity Commission","Equal Employment Opportunity Commission","24912","23","24912","23","0","0","100.0","100.0","null","2023","1","2022","4","12","31"
"2022-12-31","Agency","Export - Import  Bank","null","0","0","0","0","0","0","0.0","0.0","Non-CFO","2023","1","2022","4","12","31"
"2022-12-31","Bureau","Export - Import  Bank","Export-Import Bank","0","0","0","0","0","0","0.0","0.0","null","2023","1","2022","4","12","31"
"2022-12-31","Agency","Farm Credit Administration","null","630","1","630","1","0","0","100.0","100.0","Non-CFO","2023","1","2022","4","12","31"
"2022-12-31","Bureau","Farm Credit Administration","Farm Credit Administration","630","1","630","1","0","0","100.0","100.0","null","2023","1","2022","4","12","31"
"2022-12-31","Bureau","Farm Credit Administration","Farm Credit System Insurance Corporation","0","0","0","0","0","0","0.0","0.0","null","2023","1","2022","4","12","31"
"2022-12-31","Agency","Federal Communications Commission","null","236974371","13124","236974371","13124","0","0","100.0","100.0","Non-CFO","2023","1","2022","4","12","31"
"2022-12-31","Bureau","Federal Communications Commission","Federal Communications Commission","236974371","13124","236974371","13124","0","0","100.0","100.0","null","2023","1","2022","4","12","31"
"2022-12-31","Agency","Federal Deposit Insurance Corporation","null","0","0","0","0","0","0","0.0","0.0","Non-CFO","2023","1","2022","4","12","31"
"2022-12-31","Bureau","Federal Deposit Insurance Corporation","Federal Deposit Insurance Corporation","0","0","0","0","0","0","0.0","0.0","null","2023","1","2022","4","12","31"
"2022-12-31","Agency","Federal Election Commission","null","2126001","300","2126001","300","0","0","100.0","100.0","Non-CFO","2023","1","2022","4","12","31"
"2022-12-31","Bureau","Federal Election Commission","Federal Election Commission","2126001","300","2126001","300","0","0","100.0","100.0","null","2023","1","2022","4","12","31"
"2022-12-31","Agency","Federal Labor Relations Authority","null","0","0","0","0","0","0","0.0","0.0","Non-CFO","2023","1","2022","4","12","31"
"2022-12-31","Bureau","Federal Labor Relations Authority","Federal Labor Relations Authority","0","0","0","0","0","0","0.0","0.0","null","2023","1","2022","4","12","31"
"2022-12-31","Agency","Federal Maritime Commission","null","397899","6","397899","6","0","0","100.0","100.0","Non-CFO","2023","1","2022","4","12","31"
"2022-12-31","Bureau","Federal Maritime Commission","Salaries and Expenses","397899","6","397899","6","0","0","100.0","100.0","null","2023","1","2022","4","12","31"
"2022-12-31","Agency","Federal Mediation/Conciliation Service","null","0","0","0","0","0","0","0.0","0.0","Non-CFO","2023","1","2022","4","12","31"
"2022-12-31","Bureau","Federal Mediation/Conciliation Service","Federal Mediation/Conciliation Service","0","0","0","0","0","0","0.0","0.0","null","2023","1","2022","4","12","31"
"2022-12-31","Agency","Federal Trade Commission","null","481040354","60","481040354","60","0","0","100.0","100.0","Non-CFO","2023","1","2022","4","12","31"
"2022-12-31","Bureau","Federal Trade Commission","Federal Trade Commission","481040354","60","481040354","60","0","0","100.0","100.0","null","2023","1","2022","4","12","31"
"2022-12-31","Agency","Funds Appropriated to the President","null","1238427","14","2367","7","1236060","7","0.19112955386147104","50.0","Non-CFO","2023","1","2022","4","12","31"
"2022-12-31","Bureau","Funds Appropriated to the President","African Development Foundation","2367","7","2367","7","0","0","100.0","100.0","null","2023","1","2022","4","12","31"
"2022-12-31","Bureau","Funds Appropriated to the President","Defense Security Assistance Agency","0","0","0","0","0","0","0.0","0.0","null","2023","1","2022","4","12","31"
"2022-12-31","Bureau","Funds Appropriated to the President","Executive Branch","0","0","0","0","0","0","0.0","0.0","null","2023","1","2022","4","12","31"
"2022-12-31","Bureau","Funds Appropriated to the President","Inter-American Foundation","0","0","0","0","0","0","0.0","0.0","null","2023","1","2022","4","12","31"
"2022-12-31","Bureau","Funds Appropriated to the President","Peace Corps","0","0","0","0","0","0","0.0","0.0","null","2023","1","2022","4","12","31"
"2022-12-31","Bureau","Funds Appropriated to the President","Trade and Development Agency","1236060","7","0","0","1236060","7","0.0","0.0","null","2023","1","2022","4","12","31"
"2022-12-31","Agency","General Services Administration","null","11448475","1242","9499645","961","1948830","281","82.97738345063425","77.37520128824477","CFO","2023","1","2022","4","12","31"
"2022-12-31","Bureau","General Services Administration","General Services Administration","11448475","1242","9499645","961","1948830","281","82.97738345063425","77.37520128824477","null","2023","1","2022","4","12","31"
"2022-12-31","Agency","Legis Branch-Library of Congress","null","0","0","0","0","0","0","0.0","0.0","Non-CFO","2023","1","2022","4","12","31"
"2022-12-31","Bureau","Legis Branch-Library of Congress","Library of Congress","0","0","0","0","0","0","0.0","0.0","null","2023","1","2022","4","12","31"
"2022-12-31","Agency","Legislative Branch - U.S. House/Senate","null","269543","234","0","0","269543","234","0.0","0.0","Non-CFO","2023","1","2022","4","12","31"
"2022-12-31","Bureau","Legislative Branch - U.S. House/Senate","U.S. House of Representatives","269543","234","0","0","269543","234","0.0","0.0","null","2023","1","2022","4","12","31"
"2022-12-31","Agency","Legislative Branch-CBO","null","0","0","0","0","0","0","0.0","0.0","Non-CFO","2023","1","2022","4","12","31"
"2022-12-31","Bureau","Legislative Branch-CBO","Congressional Budget Office","0","0","0","0","0","0","0.0","0.0","null","2023","1","2022","4","12","31"
"2022-12-31","Agency","Legislative Branch-GAO","null","0","0","0","0","0","0","0.0","0.0","Non-CFO","2023","1","2022","4","12","31"
"2022-12-31","Bureau","Legislative Branch-GAO","Government Accountability Office","0","0","0","0","0","0","0.0","0.0","null","2023","1","2022","4","12","31"
"2022-12-31","Agency","Legislative Branch-GPO","null","0","0","0","0","0","0","0.0","0.0","Non-CFO","2023","1","2022","4","12","31"
"2022-12-31","Bureau","Legislative Branch-GPO","Government Publishing Office","0","0","0","0","0","0","0.0","0.0","null","2023","1","2022","4","12","31"
"2022-12-31","Agency","Legislative Branch-Office of Tech.","null","0","0","0","0","0","0","0.0","0.0","Non-CFO","2023","1","2022","4","12","31"
"2022-12-31","Bureau","Legislative Branch-Office of Tech.","Medicaid & CHIP Payment & Access Comm.","0","0","0","0","0","0","0.0","0.0","null","2023","1","2022","4","12","31"
"2022-12-31","Bureau","Legislative Branch-Office of Tech.","Open World Leadership","0","0","0","0","0","0","0.0","0.0","null","2023","1","2022","4","12","31"
"2022-12-31","Agency","Merit Systems Protection Board","null","144","1","144","1","0","0","100.0","100.0","Non-CFO","2023","1","2022","4","12","31"
"2022-12-31","Bureau","Merit Systems Protection Board","Merit Systems Protection Board","144","1","144","1","0","0","100.0","100.0","null","2023","1","2022","4","12","31"
"2022-12-31","Agency","National Aeronautics and Space Administration","null","1523852","128","1523852","128","0","0","100.0","100.0","CFO","2023","1","2022","4","12","31"
"2022-12-31","Bureau","National Aeronautics and Space Administration","National Aeronautics and Space Admin","1523852","128","1523852","128","0","0","100.0","100.0","null","2023","1","2022","4","12","31"
"2022-12-31","Agency","National Archives & Records Admin","null","129348","138","117463","134","11885","4","90.81160899279463","97.10144927536231","Non-CFO","2023","1","2022","4","12","31"
"2022-12-31","Bureau","National Archives & Records Admin","Nat'l Archives & Records Administration","129348","138","117463","134","11885","4","90.81160899279463","97.10144927536231","null","2023","1","2022","4","12","31"
"2022-12-31","Agency","National Credit Union Administration","null","445","1","445","1","0","0","100.0","100.0","Non-CFO","2023","1","2022","4","12","31"
"2022-12-31","Bureau","National Credit Union Administration","National Credit Union Administration","445","1","445","1","0","0","100.0","100.0","null","2023","1","2022","4","12","31"
"2022-12-31","Agency","National Foundation  Arts & Humanities","null","0","0","0","0","0","0","0.0","0.0","Non-CFO","2023","1","2022","4","12","31"
"2022-12-31","Bureau","National Foundation  Arts & Humanities","National Endowment for the Arts","0","0","0","0","0","0","0.0","0.0","null","2023","1","2022","4","12","31"
"2022-12-31","Bureau","National Foundation  Arts & Humanities","National Endowment for the Humanities","0","0","0","0","0","0","0.0","0.0","null","2023","1","2022","4","12","31"
"2022-12-31","Agency","National Labor Relations Board","null","0","0","0","0","0","0","0.0","0.0","Non-CFO","2023","1","2022","4","12","31"
"2022-12-31","Bureau","National Labor Relations Board","National Labor Relations Board","0","0","0","0","0","0","0.0","0.0","null","2023","1","2022","4","12","31"
"2022-12-31","Agency","National Science Foundation","null","556441","50","556441","50","0","0","100.0","100.0","CFO","2023","1","2022","4","12","31"
"2022-12-31","Bureau","National Science Foundation","National Science Foundation","556441","50","556441","50","0","0","100.0","100.0","null","2023","1","2022","4","12","31"
"2022-12-31","Agency","Neighborhood Reinvestment Corporation","null","0","0","0","0","0","0","0.0","0.0","Non-CFO","2023","1","2022","4","12","31"
"2022-12-31","Bureau","Neighborhood Reinvestment Corporation","Neighborhood Reinvestment Corporation","0","0","0","0","0","0","0.0","0.0","null","2023","1","2022","4","12","31"
"2022-12-31","Agency","Nuclear Regulatory Commission","null","3380515","385","3380515","385","0","0","100.0","100.0","CFO","2023","1","2022","4","12","31"
"2022-12-31","Bureau","Nuclear Regulatory Commission","Nuclear Regulatory Commission","3380515","385","3380515","385","0","0","100.0","100.0","null","2023","1","2022","4","12","31"
"2022-12-31","Agency","Occupational Safety & Health Rev Comm","null","0","0","0","0","0","0","0.0","0.0","Non-CFO","2023","1","2022","4","12","31"
"2022-12-31","Bureau","Occupational Safety & Health Rev Comm","Occupational Safety & Health Rev Comm","0","0","0","0","0","0","0.0","0.0","null","2023","1","2022","4","12","31"
"2022-12-31","Agency","Office of Compliance","null","0","0","0","0","0","0","0.0","0.0","Non-CFO","2023","1","2022","4","12","31"
"2022-12-31","Bureau","Office of Compliance","Office of Compliance","0","0","0","0","0","0","0.0","0.0","null","2023","1","2022","4","12","31"
"2022-12-31","Agency","Office of Government Ethics","null","0","0","0","0","0","0","0.0","0.0","Non-CFO","2023","1","2022","4","12","31"
"2022-12-31","Bureau","Office of Government Ethics","Office of Government Ethics","0","0","0","0","0","0","0.0","0.0","null","2023","1","2022","4","12","31"
"2022-12-31","Agency","Office of Personnel Management","null","52402118","1141","18276867","1027","34125251","114","34.878107407796","90.00876424189308","CFO","2023","1","2022","4","12","31"
"2022-12-31","Bureau","Office of Personnel Management","Office of Personnel Management","52402118","1141","18276867","1027","34125251","114","34.878107407796","90.00876424189308","null","2023","1","2022","4","12","31"
"2022-12-31","Agency","Office of Special Counsel","null","0","0","0","0","0","0","0.0","0.0","Non-CFO","2023","1","2022","4","12","31"
"2022-12-31","Bureau","Office of Special Counsel","Office of Special Counsel","0","0","0","0","0","0","0.0","0.0","null","2023","1","2022","4","12","31"
"2022-12-31","Agency","Other Agencies","null","3451040","51","544684","9","2906356","42","15.783184199545644","17.647058823529413","Non-CFO","2023","1","2022","4","12","31"
"2022-12-31","Bureau","Other Agencies","Advisory Council on Hist. Preservation","0","0","0","0","0","0","0.0","0.0","null","2023","1","2022","4","12","31"
"2022-12-31","Bureau","Other Agencies","Archit.&Trans. Barriers Compliance Bd","0","0","0","0","0","0","0.0","0.0","null","2023","1","2022","4","12","31"
"2022-12-31","Bureau","Other Agencies","Architect of the Capitol","0","0","0","0","0","0","0.0","0.0","null","2023","1","2022","4","12","31"
"2022-12-31","Bureau","Other Agencies","Chemical Safety Board","33198","2","33198","2","0","0","100.0","100.0","null","2023","1","2022","4","12","31"
"2022-12-31","Bureau","Other Agencies","Comm. for Purchase from Blind/Handic.","0","0","0","0","0","0","0.0","0.0","null","2023","1","2022","4","12","31"
"2022-12-31","Bureau","Other Agencies","Commission On Fine Arts","0","0","0","0","0","0","0.0","0.0","null","2023","1","2022","4","12","31"
"2022-12-31","Bureau","Other Agencies","Consumer Financial Protection Bureau","3200597","14","511463","6","2689134","8","15.980237436953168","42.857142857142854","null","2023","1","2022","4","12","31"
"2022-12-31","Bureau","Other Agencies","Council of Insps. Gen. of Intg. & Effy.","2228","5","0","0","2228","5","0.0","0.0","null","2023","1","2022","4","12","31"
"2022-12-31","Bureau","Other Agencies","Defense Nuclear Facilities Safety Board","0","0","0","0","0","0","0.0","0.0","null","2023","1","2022","4","12","31"
"2022-12-31","Bureau","Other Agencies","Delta Regional Authority","0","0","0","0","0","0","0.0","0.0","null","2023","1","2022","4","12","31"
"2022-12-31","Bureau","Other Agencies","Denali Commission","0","0","0","0","0","0","0.0","0.0","null","2023","1","2022","4","12","31"
"2022-12-31","Bureau","Other Agencies","District of Columbia Government","0","0","0","0","0","0","0.0","0.0","null","2023","1","2022","4","12","31"
"2022-12-31","Bureau","Other Agencies","Election Assistance Commission","5576","1","0","0","5576","1","0.0","0.0","null","2023","1","2022","4","12","31"
"2022-12-31","Bureau","Other Agencies","Federal Housing Finance Agency","0","0","0","0","0","0","0.0","0.0","null","2023","1","2022","4","12","31"
"2022-12-31","Bureau","Other Agencies","Federal Housing Finance Agency OIG","0","0","0","0","0","0","0.0","0.0","null","2023","1","2022","4","12","31"
"2022-12-31","Bureau","Other Agencies","Federal Mine Safety & Health Review Comm","0","0","0","0","0","0","0.0","0.0","null","2023","1","2022","4","12","31"
"2022-12-31","Bureau","Other Agencies","Gulf Coast Ecosystem Restoration Council","0","0","0","0","0","0","0.0","0.0","null","2023","1","2022","4","12","31"
"2022-12-31","Bureau","Other Agencies","James Madison Memorial Fellowship","197595","23","0","0","197595","23","0.0","0.0","null","2023","1","2022","4","12","31"
"2022-12-31","Bureau","Other Agencies","John C. Stennis","2934","2","0","0","2934","2","0.0","0.0","null","2023","1","2022","4","12","31"
"2022-12-31","Bureau","Other Agencies","Millennium Challenge Corporation","0","0","0","0","0","0","0.0","0.0","null","2023","1","2022","4","12","31"
"2022-12-31","Bureau","Other Agencies","Morris K. Udall Scholarship","0","0","0","0","0","0","0.0","0.0","null","2023","1","2022","4","12","31"
"2022-12-31","Bureau","Other Agencies","National Capital Planning Commission","0","0","0","0","0","0","0.0","0.0","null","2023","1","2022","4","12","31"
"2022-12-31","Bureau","Other Agencies","National Council on Disability","53","2","23","1","30","1","43.39622641509434","50.0","null","2023","1","2022","4","12","31"
"2022-12-31","Bureau","Other Agencies","National Mediation Board","0","0","0","0","0","0","0.0","0.0","null","2023","1","2022","4","12","31"
"2022-12-31","Bureau","Other Agencies","National Transportation Safety Board","0","0","0","0","0","0","0.0","0.0","null","2023","1","2022","4","12","31"
"2022-12-31","Bureau","Other Agencies","Privacy & Civil Liberties Oversight Bd","0","0","0","0","0","0","0.0","0.0","null","2023","1","2022","4","12","31"
"2022-12-31","Bureau","Other Agencies","Surface Transportation Board","0","0","0","0","0","0","0.0","0.0","null","2023","1","2022","4","12","31"
"2022-12-31","Bureau","Other Agencies","U.S.  Agency of Global Media","0","0","0","0","0","0","0.0","0.0","null","2023","1","2022","4","12","31"
"2022-12-31","Bureau","Other Agencies","U.S. Holocaust Memorial Council","0","0","0","0","0","0","0.0","0.0","null","2023","1","2022","4","12","31"
"2022-12-31","Bureau","Other Agencies","U.S. Inst. for Env. Conflict Resolution","8859","2","0","0","8859","2","0.0","0.0","null","2023","1","2022","4","12","31"
"2022-12-31","Bureau","Other Agencies","U.S. Institute of Peace","0","0","0","0","0","0","0.0","0.0","null","2023","1","2022","4","12","31"
"2022-12-31","Agency","Other Agencies/Boards/Commissions","null","1024","1","0","0","1024","1","0.0","0.0","Non-CFO","2023","1","2022","4","12","31"
"2022-12-31","Bureau","Other Agencies/Boards/Commissions","Medicare Payment Advisory Commission","0","0","0","0","0","0","0.0","0.0","null","2023","1","2022","4","12","31"
"2022-12-31","Bureau","Other Agencies/Boards/Commissions","Nuclear Waste Technical Review Board","0","0","0","0","0","0","0.0","0.0","null","2023","1","2022","4","12","31"
"2022-12-31","Bureau","Other Agencies/Boards/Commissions","U.S. Comm. on Int. Religious Freedom","1024","1","0","0","1024","1","0.0","0.0","null","2023","1","2022","4","12","31"
"2022-12-31","Bureau","Other Agencies/Boards/Commissions","U.S.-China Security Review Commission","0","0","0","0","0","0","0.0","0.0","null","2023","1","2022","4","12","31"
"2022-12-31","Agency","Pension Benefit Guaranty Corp","null","3300663","1227","3300663","1227","0","0","100.0","100.0","Non-CFO","2023","1","2022","4","12","31"
"2022-12-31","Bureau","Pension Benefit Guaranty Corp","Pension Benefit Guaranty Corporation","3300663","1227","3300663","1227","0","0","100.0","100.0","null","2023","1","2022","4","12","31"
"2022-12-31","Agency","Presidio Trust Corporation","null","1520774","62","1520774","62","0","0","100.0","100.0","Non-CFO","2023","1","2022","4","12","31"
"2022-12-31","Bureau","Presidio Trust Corporation","Presidio Trust Corporation","1520774","62","1520774","62","0","0","100.0","100.0","null","2023","1","2022","4","12","31"
"2022-12-31","Agency","Railroad Retirement Board","null","21396551","4083","21396551","4083","0","0","100.0","100.0","Non-CFO","2023","1","2022","4","12","31"
"2022-12-31","Bureau","Railroad Retirement Board","Railroad Retirement Board","21396551","4083","21396551","4083","0","0","100.0","100.0","null","2023","1","2022","4","12","31"
"2022-12-31","Agency","Securities & Exchange Commission","null","2167262880","1181","2167262880","1181","0","0","100.0","100.0","Non-CFO","2023","1","2022","4","12","31"
"2022-12-31","Bureau","Securities & Exchange Commission","SEC Enforcement","2167008682","1135","2167008682","1135","0","0","100.0","100.0","null","2023","1","2022","4","12","31"
"2022-12-31","Bureau","Securities & Exchange Commission","Securities and Exchange Commission","254198","46","254198","46","0","0","100.0","100.0","null","2023","1","2022","4","12","31"
"2022-12-31","Agency","Selective Service System","null","2358","11","0","0","2358","11","0.0","0.0","Non-CFO","2023","1","2022","4","12","31"
"2022-12-31","Bureau","Selective Service System","Selective Service System","2358","11","0","0","2358","11","0.0","0.0","null","2023","1","2022","4","12","31"
"2022-12-31","Agency","Small Business Administration","null","13906655806","128786","13906655806","128786","0","0","100.0","100.0","CFO","2023","1","2022","4","12","31"
"2022-12-31","Bureau","Small Business Administration","Small Business Administration","13906655806","128786","13906655806","128786","0","0","100.0","100.0","null","2023","1","2022","4","12","31"
"2022-12-31","Agency","Smithsonian Institution","null","0","0","0","0","0","0","0.0","0.0","Non-CFO","2023","1","2022","4","12","31"
"2022-12-31","Bureau","Smithsonian Institution","Administrative Conference of the US","0","0","0","0","0","0","0.0","0.0","null","2023","1","2022","4","12","31"
"2022-12-31","Bureau","Smithsonian Institution","JFK Center for the Performing Arts","0","0","0","0","0","0","0.0","0.0","null","2023","1","2022","4","12","31"
"2022-12-31","Bureau","Smithsonian Institution","National Gallery of Art","0","0","0","0","0","0","0.0","0.0","null","2023","1","2022","4","12","31"
"2022-12-31","Bureau","Smithsonian Institution","Smithsonian Institution","0","0","0","0","0","0","0.0","0.0","null","2023","1","2022","4","12","31"
"2022-12-31","Agency","Social Security Administration","null","4420467503","1353317","2532269288","432682","1888198215","920635","57.285101322008295","31.971962223189394","CFO","2023","1","2022","4","12","31"
"2022-12-31","Bureau","Social Security Administration","Social Security Administration","4420467503","1353317","2532269288","432682","1888198215","920635","57.285101322008295","31.971962223189394","null","2023","1","2022","4","12","31"
"2022-12-31","Agency","Tennessee Valley Authority","null","0","0","0","0","0","0","0.0","0.0","Non-CFO","2023","1","2022","4","12","31"
"2022-12-31","Bureau","Tennessee Valley Authority","Tennessee Valley Authority","0","0","0","0","0","0","0.0","0.0","null","2023","1","2022","4","12","31"
"2022-12-31","Agency","The Judiciary","null","1064771","303","992066","166","72705","137","93.1717712071422","54.78547854785479","Non-CFO","2023","1","2022","4","12","31"
"2022-12-31","Bureau","The Judiciary","Administrative Office of the U.S. Courts","1064771","303","992066","166","72705","137","93.1717712071422","54.78547854785479","null","2023","1","2022","4","12","31"
"2022-12-31","Agency","U.S. Court of Appeals / Veterans Claims","null","0","0","0","0","0","0","0.0","0.0","Non-CFO","2023","1","2022","4","12","31"
"2022-12-31","Bureau","U.S. Court of Appeals / Veterans Claims","U.S. Court of Appeals / Veterans Claims","0","0","0","0","0","0","0.0","0.0","null","2023","1","2022","4","12","31"
"2022-12-31","Agency","U.S. Postal Service","null","69005576","72308","68867984","61098","137592","11210","99.80060741758028","84.49687448138519","Non-CFO","2023","1","2022","4","12","31"
"2022-12-31","Bureau","U.S. Postal Service","U.S. Postal Service","69005576","72308","68867984","61098","137592","11210","99.80060741758028","84.49687448138519","null","2023","1","2022","4","12","31"
"2022-12-31","Agency","U.S. Tax Court","null","0","0","0","0","0","0","0.0","0.0","Non-CFO","2023","1","2022","4","12","31"
"2022-12-31","Bureau","U.S. Tax Court","U.S. Tax Court","0","0","0","0","0","0","0.0","0.0","null","2023","1","2022","4","12","31"
"2022-12-31","Agency","US International Development Fin. Corp.","null","265967767","72","0","0","265967767","72","0.0","0.0","Non-CFO","2023","1","2022","4","12","31"
"2022-12-31","Bureau","US International Development Fin. Corp.","US International Development Fin. Corp.","265967767","72","0","0","265967767","72","0.0","0.0","null","2023","1","2022","4","12","31"
"2022-09-30","Agency","Agency for International Development","null","25778269","50","25777997","49","272","1","99.99894484769322","98.0","CFO","2022","4","2022","3","09","30"
"2022-09-30","Bureau","Agency for International Development","Agency for International Development","25778269","50","25777997","49","272","1","99.99894484769322","98.0","null","2022","4","2022","3","09","30"
"2022-09-30","Agency","American Battle Monuments Commission","null","0","0","0","0","0","0","0.0","0.0","Non-CFO","2022","4","2022","3","09","30"
"2022-09-30","Bureau","American Battle Monuments Commission","American Battle Monuments Commission","0","0","0","0","0","0","0.0","0.0","null","2022","4","2022","3","09","30"
"2022-09-30","Agency","Armed Forces Retirement Home","null","744738","104","77060","102","667678","2","10.347263064325977","98.07692307692308","Non-CFO","2022","4","2022","3","09","30"
"2022-09-30","Bureau","Armed Forces Retirement Home","Armed Forces Retirement Home","744738","104","77060","102","667678","2","10.347263064325977","98.07692307692308","null","2022","4","2022","3","09","30"
"2022-09-30","Agency","Commodity Futures Trading Commission","null","649446964","361","649446964","361","0","0","100.0","100.0","Non-CFO","2022","4","2022","3","09","30"
"2022-09-30","Bureau","Commodity Futures Trading Commission","Commodity Futures Trading Commission","649446964","361","649446964","361","0","0","100.0","100.0","null","2022","4","2022","3","09","30"
"2022-09-30","Agency","Consumer Product Safety Commission","null","262","2","262","2","0","0","100.0","100.0","Non-CFO","2022","4","2022","3","09","30"
"2022-09-30","Bureau","Consumer Product Safety Commission","Consumer Product Safety Commission","262","2","262","2","0","0","100.0","100.0","null","2022","4","2022","3","09","30"
"2022-09-30","Agency","Corp. for National and Community Service","null","3759318","315","3611912","165","147406","150","96.07891644175885","52.38095238095238","Non-CFO","2022","4","2022","3","09","30"
"2022-09-30","Bureau","Corp. for National and Community Service","Corp. for National and Community Service","3759318","315","3611912","165","147406","150","96.07891644175885","52.38095238095238","null","2022","4","2022","3","09","30"
"2022-09-30","Agency","Department of Agriculture","null","1892900877","65502","1879712890","60420","13187987","5082","99.30329225580469","92.24145827608318","CFO","2022","4","2022","3","09","30"
"2022-09-30","Bureau","Department of Agriculture","Agricultural Marketing Service","5956549","3041","3930718","1369","2025831","1672","65.98985419241913","45.01808615586978","null","2022","4","2022","3","09","30"
"2022-09-30","Bureau","Department of Agriculture","Commodity Credit Corporation","140937138","9780","140937138","9780","0","0","100.0","100.0","null","2022","4","2022","3","09","30"
"2022-09-30","Bureau","Department of Agriculture","Farm Service Agency","803161622","13057","803161622","13057","0","0","100.0","100.0","null","2022","4","2022","3","09","30"
"2022-09-30","Bureau","Department of Agriculture","Federal Crop Insurance Corporation","13865","413","13865","413","0","0","100.0","100.0","null","2022","4","2022","3","09","30"
"2022-09-30","Bureau","Department of Agriculture","Food Safety and Inspection Service","1281407","1265","1224959","1205","56448","60","95.59484223201528","95.25691699604744","null","2022","4","2022","3","09","30"
"2022-09-30","Bureau","Department of Agriculture","Food and Nutrition Service","2589481","131","68379","28","2521102","103","2.640644978665609","21.374045801526716","null","2022","4","2022","3","09","30"
"2022-09-30","Bureau","Department of Agriculture","Forest Service","72934552","1484","68038629","381","4895923","1103","93.28723785127247","25.673854447439354","null","2022","4","2022","3","09","30"
"2022-09-30","Bureau","Department of Agriculture","Rural Development","844815675","31541","844783165","31431","32510","110","99.99615182329566","99.65124758251166","null","2022","4","2022","3","09","30"
"2022-09-30","Bureau","Department of Agriculture","U.S. Department of Agriculture","21210588","4790","17554415","2756","3656173","2034","82.7625099313607","57.536534446764094","null","2022","4","2022","3","09","30"
"2022-09-30","Agency","Department of Commerce","null","60527147","15036","60527147","15036","0","0","100.0","100.0","CFO","2022","4","2022","3","09","30"
"2022-09-30","Bureau","Department of Commerce","Bureau of Industry and Security","37612463","29","37612463","29","0","0","100.0","100.0","null","2022","4","2022","3","09","30"
"2022-09-30","Bureau","Department of Commerce","Bureau of the Census","3340413","13279","3340413","13279","0","0","100.0","100.0","null","2022","4","2022","3","09","30"
"2022-09-30","Bureau","Department of Commerce","Economic Development Administration","5137182","12","5137182","12","0","0","100.0","100.0","null","2022","4","2022","3","09","30"
"2022-09-30","Bureau","Department of Commerce","Economic and Statistical Analysis","0","0","0","0","0","0","0.0","0.0","null","2022","4","2022","3","09","30"
"2022-09-30","Bureau","Department of Commerce","General Administration","4660","1","4660","1","0","0","100.0","100.0","null","2022","4","2022","3","09","30"
"2022-09-30","Bureau","Department of Commerce","International Trade Administration","0","0","0","0","0","0","0.0","0.0","null","2022","4","2022","3","09","30"
"2022-09-30","Bureau","Department of Commerce","Minority Business Development Agency","0","0","0","0","0","0","0.0","0.0","null","2022","4","2022","3","09","30"
"2022-09-30","Bureau","Department of Commerce","NOAA","12953025","1012","12953025","1012","0","0","100.0","100.0","null","2022","4","2022","3","09","30"
"2022-09-30","Bureau","Department of Commerce","Nat'l Institute of Standards& Technology","673458","5","673458","5","0","0","100.0","100.0","null","2022","4","2022","3","09","30"
"2022-09-30","Bureau","Department of Commerce","Nat'l Telecomm & Information Admin.","296093","1","296093","1","0","0","100.0","100.0","null","2022","4","2022","3","09","30"
"2022-09-30","Bureau","Department of Commerce","National Technical Information Service","0","0","0","0","0","0","0.0","0.0","null","2022","4","2022","3","09","30"
"2022-09-30","Bureau","Department of Commerce","Office of the Inspector General","0","0","0","0","0","0","0.0","0.0","null","2022","4","2022","3","09","30"
"2022-09-30","Bureau","Department of Commerce","Patent and Trademark Office","509853","697","509853","697","0","0","100.0","100.0","null","2022","4","2022","3","09","30"
"2022-09-30","Agency","Department of Defense","null","3106492834","1620175","1081353932","304332","2025138902","1315843","34.809477754616964","18.783896801271467","CFO","2022","4","2022","3","09","30"
"2022-09-30","Bureau","Department of Defense","Consolidated Report","3106492834","1620175","1081353932","304332","2025138902","1315843","34.809477754616964","18.783896801271467","null","2022","4","2022","3","09","30"
"2022-09-30","Agency","Department of Education","null","127350691418","21827562","127305536820","21827434","45154598","128","99.9645431073069","99.99941358544761","CFO","2022","4","2022","3","09","30"
"2022-09-30","Bureau","Department of Education","Departmental Management","1408490346","2108","1363335748","1980","45154598","128","96.79411377378372","93.92789373814041","null","2022","4","2022","3","09","30"
"2022-09-30","Bureau","Department of Education","Federal Student Aid","125942201072","21825454","125942201072","21825454","0","0","100.0","100.0","null","2022","4","2022","3","09","30"
"2022-09-30","Bureau","Department of Education","Office of Postsecondary Education","0","0","0","0","0","0","0.0","0.0","null","2022","4","2022","3","09","30"
"2022-09-30","Agency","Department of Energy","null","14656928","95","13680699","93","976229","2","93.33947059029013","97.89473684210526","CFO","2022","4","2022","3","09","30"
"2022-09-30","Bureau","Department of Energy","Bonneville Power Administration","2037514","26","1061285","24","976229","2","52.08724946184419","92.3076923076923","null","2022","4","2022","3","09","30"
"2022-09-30","Bureau","Department of Energy","Energy Consolidated Reports","12619414","69","12619414","69","0","0","100.0","100.0","null","2022","4","2022","3","09","30"
"2022-09-30","Agency","Department of Health & Human Services","null","10043105155","1139529","9842787752","1109203","200317403","30326","98.00542362239162","97.3387250346415","CFO","2022","4","2022","3","09","30"
"2022-09-30","Bureau","Department of Health & Human Services","Administration for Children and Families","35424713","1699","35424713","1699","0","0","100.0","100.0","null","2022","4","2022","3","09","30"
"2022-09-30","Bureau","Department of Health & Human Services","Administration for Community Living","0","0","0","0","0","0","0.0","0.0","null","2022","4","2022","3","09","30"
"2022-09-30","Bureau","Department of Health & Human Services","Centers for Disease Control","8459281","100","163577","16","8295704","84","1.9336986204855944","16.0","null","2022","4","2022","3","09","30"
"2022-09-30","Bureau","Department of Health & Human Services","Centers for Medicare & Medicaid Services","9648223361","1110416","9559340075","1100675","88883286","9741","99.0787600714212","99.12276119940636","null","2022","4","2022","3","09","30"
"2022-09-30","Bureau","Department of Health & Human Services","Food and Drug Administration","130000563","21209","41272692","1586","88727871","19623","31.748087121745773","7.477957470885002","null","2022","4","2022","3","09","30"
"2022-09-30","Bureau","Department of Health & Human Services","Health Resources and Services Admin","108340423","629","108340423","629","0","0","100.0","100.0","null","2022","4","2022","3","09","30"
"2022-09-30","Bureau","Department of Health & Human Services","Indian Health Services","83985277","4171","83985277","4171","0","0","100.0","100.0","null","2022","4","2022","3","09","30"
"2022-09-30","Bureau","Department of Health & Human Services","National Institutes of Health","21151318","986","6740776","108","14410542","878","31.869295331855916","10.953346855983773","null","2022","4","2022","3","09","30"
"2022-09-30","Bureau","Department of Health & Human Services","Office of the Inspector General","0","0","0","0","0","0","0.0","0.0","null","2022","4","2022","3","09","30"
"2022-09-30","Bureau","Department of Health & Human Services","Office of the Secretary","270127","7","270127","7","0","0","100.0","100.0","null","2022","4","2022","3","09","30"
"2022-09-30","Bureau","Department of Health & Human Services","Program Support Center","6198404","299","6198404","299","0","0","100.0","100.0","null","2022","4","2022","3","09","30"
"2022-09-30","Bureau","Department of Health & Human Services","Substance Abuse & Mental Health Admin.","1051688","13","1051688","13","0","0","100.0","100.0","null","2022","4","2022","3","09","30"
"2022-09-30","Agency","Department of Homeland Security","null","279055886","67457","274578586","55458","4477300","11999","98.39555435859899","82.21237232607439","CFO","2022","4","2022","3","09","30"
"2022-09-30","Bureau","Department of Homeland Security","Bureau of Customs & Border Protection","8628827","652","8628827","652","0","0","100.0","100.0","null","2022","4","2022","3","09","30"
"2022-09-30","Bureau","Department of Homeland Security","Citizenship and Immigration Services","1048328","1254","1048328","1254","0","0","100.0","100.0","null","2022","4","2022","3","09","30"
"2022-09-30","Bureau","Department of Homeland Security","Domestic Nuclear Detection Office","1348","16","0","0","1348","16","0.0","0.0","null","2022","4","2022","3","09","30"
"2022-09-30","Bureau","Department of Homeland Security","Emergency Preparedness & Resp","237796645","39723","237796645","39723","0","0","100.0","100.0","null","2022","4","2022","3","09","30"
"2022-09-30","Bureau","Department of Homeland Security","Federal Law Enforcement Training Ctr.","38302","4","38302","4","0","0","100.0","100.0","null","2022","4","2022","3","09","30"
"2022-09-30","Bureau","Department of Homeland Security","Immigration and Customs Enforcement","14888235","614","14888235","614","0","0","100.0","100.0","null","2022","4","2022","3","09","30"
"2022-09-30","Bureau","Department of Homeland Security","Info Analysis Infrastructure Prot-NPPD","0","0","0","0","0","0","0.0","0.0","null","2022","4","2022","3","09","30"
"2022-09-30","Bureau","Department of Homeland Security","Management Headquarters","0","0","0","0","0","0","0.0","0.0","null","2022","4","2022","3","09","30"
"2022-09-30","Bureau","Department of Homeland Security","Office of Biometric Identity Management","0","0","0","0","0","0","0.0","0.0","null","2022","4","2022","3","09","30"
"2022-09-30","Bureau","Department of Homeland Security","Office of Health Affairs","0","0","0","0","0","0","0.0","0.0","null","2022","4","2022","3","09","30"
"2022-09-30","Bureau","Department of Homeland Security","Office of the Inspector General DHS","100","1","100","1","0","0","100.0","100.0","null","2022","4","2022","3","09","30"
"2022-09-30","Bureau","Department of Homeland Security","Science and Technology","0","0","0","0","0","0","0.0","0.0","null","2022","4","2022","3","09","30"
"2022-09-30","Bureau","Department of Homeland Security","Transportation Safety Administration","10964892","11808","10964892","11808","0","0","100.0","100.0","null","2022","4","2022","3","09","30"
"2022-09-30","Bureau","Department of Homeland Security","U.S. Coast Guard","5689209","13385","1213257","1402","4475952","11983","21.325583222553433","10.474411654837505","null","2022","4","2022","3","09","30"
"2022-09-30","Bureau","Department of Homeland Security","U.S. Secret Service","0","0","0","0","0","0","0.0","0.0","null","2022","4","2022","3","09","30"
"2022-09-30","Agency","Department of Housing and Urban Development","null","80546942","3069","80522476","3065","24466","4","99.96962516590636","99.86966438579341","CFO","2022","4","2022","3","09","30"
"2022-09-30","Bureau","Department of Housing and Urban Development","Community Planning and Development","0","0","0","0","0","0","0.0","0.0","null","2022","4","2022","3","09","30"
"2022-09-30","Bureau","Department of Housing and Urban Development","Government National Mortgage Association","0","0","0","0","0","0","0.0","0.0","null","2022","4","2022","3","09","30"
"2022-09-30","Bureau","Department of Housing and Urban Development","Housing Programs","80542236","3067","80517770","3063","24466","4","99.96962339113605","99.86957939354419","null","2022","4","2022","3","09","30"
"2022-09-30","Bureau","Department of Housing and Urban Development","Management and Administration","4706","2","4706","2","0","0","100.0","100.0","null","2022","4","2022","3","09","30"
"2022-09-30","Bureau","Department of Housing and Urban Development","Policy, Development and Research","0","0","0","0","0","0","0.0","0.0","null","2022","4","2022","3","09","30"
"2022-09-30","Bureau","Department of Housing and Urban Development","Public and Indian Housing Programs","0","0","0","0","0","0","0.0","0.0","null","2022","4","2022","3","09","30"
"2022-09-30","Agency","Department of Justice","null","117881503","39774","114123494","39381","3758009","393","96.81204522816442","99.01191733293106","CFO","2022","4","2022","3","09","30"
"2022-09-30","Bureau","Department of Justice","Bureau of ATF and Explosives","20073","3","20073","3","0","0","100.0","100.0","null","2022","4","2022","3","09","30"
"2022-09-30","Bureau","Department of Justice","Drug Enforcement Administration","358350","21","358350","21","0","0","100.0","100.0","null","2022","4","2022","3","09","30"
"2022-09-30","Bureau","Department of Justice","Federal Bureau of Investigation","428355","96","428355","96","0","0","100.0","100.0","null","2022","4","2022","3","09","30"
"2022-09-30","Bureau","Department of Justice","Federal Prison Industries","178777","18","0","0","178777","18","0.0","0.0","null","2022","4","2022","3","09","30"
"2022-09-30","Bureau","Department of Justice","Federal Prison System","22540815","759","22540815","759","0","0","100.0","100.0","null","2022","4","2022","3","09","30"
"2022-09-30","Bureau","Department of Justice","General Administration","0","0","0","0","0","0","0.0","0.0","null","2022","4","2022","3","09","30"
"2022-09-30","Bureau","Department of Justice","Legal Activities","93417363","38874","89838131","38499","3579232","375","96.16855808700144","99.03534496064208","null","2022","4","2022","3","09","30"
"2022-09-30","Bureau","Department of Justice","Office of Justice Assistance Programs","937770","3","937770","3","0","0","100.0","100.0","null","2022","4","2022","3","09","30"
"2022-09-30","Bureau","Department of Justice","U.S. Marshals Service","0","0","0","0","0","0","0.0","0.0","null","2022","4","2022","3","09","30"
"2022-09-30","Agency","Department of Labor","null","182615516","16135","164750018","11173","17865498","4962","90.21687839493332","69.24697861791137","CFO","2022","4","2022","3","09","30"
"2022-09-30","Bureau","Department of Labor","Bureau of Labor Statistics","6048","1","6048","1","0","0","100.0","100.0","null","2022","4","2022","3","09","30"
"2022-09-30","Bureau","Department of Labor","Departmental Management","0","0","0","0","0","0","0.0","0.0","null","2022","4","2022","3","09","30"
"2022-09-30","Bureau","Department of Labor","Employee Benefit Security Administration","20837935","469","20837935","469","0","0","100.0","100.0","null","2022","4","2022","3","09","30"
"2022-09-30","Bureau","Department of Labor","Employment Standards Administration","76977634","4904","66911544","3132","10066090","1772","86.92335750407709","63.866231647634585","null","2022","4","2022","3","09","30"
"2022-09-30","Bureau","Department of Labor","Employment and Training Administration","925026","10","925026","10","0","0","100.0","100.0","null","2022","4","2022","3","09","30"
"2022-09-30","Bureau","Department of Labor","Mine Safety and Health Administration","13323903","4979","10156336","3080","3167567","1899","76.22643305043574","61.85981120706969","null","2022","4","2022","3","09","30"
"2022-09-30","Bureau","Department of Labor","Occupational Safety and Health Admin","70544970","5772","65913129","4481","4631841","1291","93.43420090759129","77.63340263340264","null","2022","4","2022","3","09","30"
"2022-09-30","Agency","Department of State","null","24699581","22815","24257193","22585","442388","230","98.20892508257529","98.99189129958361","CFO","2022","4","2022","3","09","30"
"2022-09-30","Bureau","Department of State","Civil Monetary Penalties","0","0","0","0","0","0","0.0","0.0","null","2022","4","2022","3","09","30"
"2022-09-30","Bureau","Department of State","Department of State","22778829","10396","22346909","10231","431920","165","98.1038533631382","98.41285109657561","null","2022","4","2022","3","09","30"
"2022-09-30","Bureau","Department of State","International Commissions","0","0","0","0","0","0","0.0","0.0","null","2022","4","2022","3","09","30"
"2022-09-30","Bureau","Department of State","Passport NSF","1920752","12419","1910284","12354","10468","65","99.4550051229935","99.47660842257831","null","2022","4","2022","3","09","30"
"2022-09-30","Agency","Department of Transportation","null","74530848","8219","74530553","8218","295","1","99.99960419073723","99.98783306971652","CFO","2022","4","2022","3","09","30"
"2022-09-30","Bureau","Department of Transportation","Federal Aviation Administration","2324083","305","2324083","305","0","0","100.0","100.0","null","2022","4","2022","3","09","30"
"2022-09-30","Bureau","Department of Transportation","Federal Highway Administration","13642","12","13642","12","0","0","100.0","100.0","null","2022","4","2022","3","09","30"
"2022-09-30","Bureau","Department of Transportation","Federal Motor Carrier Safety Admin","69609951","7810","69609656","7809","295","1","99.9995762100163","99.98719590268887","null","2022","4","2022","3","09","30"
"2022-09-30","Bureau","Department of Transportation","Federal Railroad Administration","143621","17","143621","17","0","0","100.0","100.0","null","2022","4","2022","3","09","30"
"2022-09-30","Bureau","Department of Transportation","Federal Transit Administration","783403","1","783403","1","0","0","100.0","100.0","null","2022","4","2022","3","09","30"
"2022-09-30","Bureau","Department of Transportation","Maritime Administration","6071","6","6071","6","0","0","100.0","100.0","null","2022","4","2022","3","09","30"
"2022-09-30","Bureau","Department of Transportation","National Highway Traffic Safety Admin.","36095","5","36095","5","0","0","100.0","100.0","null","2022","4","2022","3","09","30"
"2022-09-30","Bureau","Department of Transportation","Office of the Inspector General","0","0","0","0","0","0","0.0","0.0","null","2022","4","2022","3","09","30"
"2022-09-30","Bureau","Department of Transportation","Office of the Secretary","1102895","18","1102895","18","0","0","100.0","100.0","null","2022","4","2022","3","09","30"
"2022-09-30","Bureau","Department of Transportation","Pipeline Hazardous Material Safety Admin","503359","43","503359","43","0","0","100.0","100.0","null","2022","4","2022","3","09","30"
"2022-09-30","Bureau","Department of Transportation","Research Innovative Technology Admin","0","0","0","0","0","0","0.0","0.0","null","2022","4","2022","3","09","30"
"2022-09-30","Bureau","Department of Transportation","St. Lawrence Seaway Development Corp.","7728","2","7728","2","0","0","100.0","100.0","null","2022","4","2022","3","09","30"
"2022-09-30","Agency","Department of Veterans Affairs","null","521267749","3681237","208565281","3637182","312702468","44055","40.01116151922148","98.80325553611463","CFO","2022","4","2022","3","09","30"
"2022-09-30","Bureau","Department of Veterans Affairs","Administration and Cemeteries","1489131","937","31494","19","1457637","918","2.114924744700097","2.0277481323372464","null","2022","4","2022","3","09","30"
"2022-09-30","Bureau","Department of Veterans Affairs","Housing Credit Assistance","751251","26","1343","1","749908","25","0.1787684808406245","3.8461538461538463","null","2022","4","2022","3","09","30"
"2022-09-30","Bureau","Department of Veterans Affairs","Life Insurance","1205239","238","1205239","238","0","0","100.0","100.0","null","2022","4","2022","3","09","30"
"2022-09-30","Bureau","Department of Veterans Affairs","Medical and Construction","516574824","3678392","207327205","3636924","309247619","41468","40.13498052317006","98.87265957516219","null","2022","4","2022","3","09","30"
"2022-09-30","Bureau","Department of Veterans Affairs","Veterans Benefits","1247304","1644","0","0","1247304","1644","0.0","0.0","null","2022","4","2022","3","09","30"
"2022-09-30","Agency","Department of the Interior","null","61582272","35786","61437179","35680","145093","106","99.76439160932549","99.7037947800816","CFO","2022","4","2022","3","09","30"
"2022-09-30","Bureau","Department of the Interior","Bureau of Indian Affairs","16745265","31479","16739563","31375","5702","104","99.96594858307706","99.66962101718606","null","2022","4","2022","3","09","30"
"2022-09-30","Bureau","Department of the Interior","Bureau of Land Management","9034010","379","9034010","379","0","0","100.0","100.0","null","2022","4","2022","3","09","30"
"2022-09-30","Bureau","Department of the Interior","Bureau of Ocean Energy Mgmt., Reg & Enf","1724","1","1724","1","0","0","100.0","100.0","null","2022","4","2022","3","09","30"
"2022-09-30","Bureau","Department of the Interior","Bureau of Reclamation","7483157","72","7343766","70","139391","2","98.13727013879303","97.22222222222223","null","2022","4","2022","3","09","30"
"2022-09-30","Bureau","Department of the Interior","Bureau of Safety and Environmental Enf.","202","1","202","1","0","0","100.0","100.0","null","2022","4","2022","3","09","30"
"2022-09-30","Bureau","Department of the Interior","Fish and Wildlife Service","770993","108","770993","108","0","0","100.0","100.0","null","2022","4","2022","3","09","30"
"2022-09-30","Bureau","Department of the Interior","Geological Survey","175365","685","175365","685","0","0","100.0","100.0","null","2022","4","2022","3","09","30"
"2022-09-30","Bureau","Department of the Interior","National Park Service","8389555","2116","8389555","2116","0","0","100.0","100.0","null","2022","4","2022","3","09","30"
"2022-09-30","Bureau","Department of the Interior","Office of Natural Resources Revenue","10525108","551","10525108","551","0","0","100.0","100.0","null","2022","4","2022","3","09","30"
"2022-09-30","Bureau","Department of the Interior","Office of Surface Mining","8112307","369","8112307","369","0","0","100.0","100.0","null","2022","4","2022","3","09","30"
"2022-09-30","Bureau","Department of the Interior","Office of the Secretary","344586","25","344586","25","0","0","100.0","100.0","null","2022","4","2022","3","09","30"
"2022-09-30","Agency","Department of the Treasury","null","42753256","4728","42557664","4722","195592","6","99.54250969797482","99.8730964467005","CFO","2022","4","2022","3","09","30"
"2022-09-30","Bureau","Department of the Treasury","Bureau of Engraving and Printing","38345","2","38345","2","0","0","100.0","100.0","null","2022","4","2022","3","09","30"
"2022-09-30","Bureau","Department of the Treasury","Bureau of the Fiscal Service","13502993","3290","13502993","3290","0","0","100.0","100.0","null","2022","4","2022","3","09","30"
"2022-09-30","Bureau","Department of the Treasury","Community Dev Financial Inst Fund","3687238","7","3687238","7","0","0","100.0","100.0","null","2022","4","2022","3","09","30"
"2022-09-30","Bureau","Department of the Treasury","Comptroller of the Currency","1442625","22","1442625","22","0","0","100.0","100.0","null","2022","4","2022","3","09","30"
"2022-09-30","Bureau","Department of the Treasury","D.C. Pension Program","470701","22","470701","22","0","0","100.0","100.0","null","2022","4","2022","3","09","30"
"2022-09-30","Bureau","Department of the Treasury","Departmental Offices","21915208","1325","21720616","1320","194592","5","99.1120686602655","99.62264150943396","null","2022","4","2022","3","09","30"
"2022-09-30","Bureau","Department of the Treasury","Financial Crimes Enforcement Network","1544945","3","1544945","3","0","0","100.0","100.0","null","2022","4","2022","3","09","30"
"2022-09-30","Bureau","Department of the Treasury","Interest on Tax/Deposit of Earnings","0","0","0","0","0","0","0.0","0.0","null","2022","4","2022","3","09","30"
"2022-09-30","Bureau","Department of the Treasury","Internal Revenue Service","121490","33","121490","33","0","0","100.0","100.0","null","2022","4","2022","3","09","30"
"2022-09-30","Bureau","Department of the Treasury","International Monetary Funds","0","0","0","0","0","0","0.0","0.0","null","2022","4","2022","3","09","30"
"2022-09-30","Bureau","Department of the Treasury","Office of Financial Research","268","1","268","1","0","0","100.0","100.0","null","2022","4","2022","3","09","30"
"2022-09-30","Bureau","Department of the Treasury","Office of Sec International Affairs","0","0","0","0","0","0","0.0","0.0","null","2022","4","2022","3","09","30"
"2022-09-30","Bureau","Department of the Treasury","Office of the Secretary","0","0","0","0","0","0","0.0","0.0","null","2022","4","2022","3","09","30"
"2022-09-30","Bureau","Department of the Treasury","Pandemic Receivables","0","0","0","0","0","0","0.0","0.0","null","2022","4","2022","3","09","30"
"2022-09-30","Bureau","Department of the Treasury","Spec Insp Gen-Troubled Asset Rel Prog","3916","1","3916","1","0","0","100.0","100.0","null","2022","4","2022","3","09","30"
"2022-09-30","Bureau","Department of the Treasury","Tobacco Tax and Trade","1000","1","1000","1","0","0","100.0","100.0","null","2022","4","2022","3","09","30"
"2022-09-30","Bureau","Department of the Treasury","Treasury Forfeiture Fund","0","0","0","0","0","0","0.0","0.0","null","2022","4","2022","3","09","30"
"2022-09-30","Bureau","Department of the Treasury","Treasury Franchise Fund","0","0","0","0","0","0","0.0","0.0","null","2022","4","2022","3","09","30"
"2022-09-30","Bureau","Department of the Treasury","Treasury IG for Tax Admin","190","1","190","1","0","0","100.0","100.0","null","2022","4","2022","3","09","30"
"2022-09-30","Bureau","Department of the Treasury","U.S. Mint","24337","20","23337","19","1000","1","95.89103011874923","95.0","null","2022","4","2022","3","09","30"
"2022-09-30","Bureau","Department of the Treasury","U.S. Treasury IG Office","0","0","0","0","0","0","0.0","0.0","null","2022","4","2022","3","09","30"
"2022-09-30","Agency","Environmental Protection Agency","null","26158372","276","26104916","274","53456","2","99.79564477483538","99.27536231884058","CFO","2022","4","2022","3","09","30"
"2022-09-30","Bureau","Environmental Protection Agency","Environmental Protection Agency","26158372","276","26104916","274","53456","2","99.79564477483538","99.27536231884058","null","2022","4","2022","3","09","30"
"2022-09-30","Agency","Equal Employment Opportunity Commission","null","24834","20","24834","20","0","0","100.0","100.0","Non-CFO","2022","4","2022","3","09","30"
"2022-09-30","Bureau","Equal Employment Opportunity Commission","Equal Employment Opportunity Commission","24834","20","24834","20","0","0","100.0","100.0","null","2022","4","2022","3","09","30"
"2022-09-30","Agency","Export - Import  Bank","null","0","0","0","0","0","0","0.0","0.0","Non-CFO","2022","4","2022","3","09","30"
"2022-09-30","Bureau","Export - Import  Bank","Export-Import Bank","0","0","0","0","0","0","0.0","0.0","null","2022","4","2022","3","09","30"
"2022-09-30","Agency","Farm Credit Administration","null","630","1","630","1","0","0","100.0","100.0","Non-CFO","2022","4","2022","3","09","30"
"2022-09-30","Bureau","Farm Credit Administration","Farm Credit Administration","630","1","630","1","0","0","100.0","100.0","null","2022","4","2022","3","09","30"
"2022-09-30","Bureau","Farm Credit Administration","Farm Credit System Insurance Corporation","0","0","0","0","0","0","0.0","0.0","null","2022","4","2022","3","09","30"
"2022-09-30","Agency","Federal Communications Commission","null","237880836","12731","237880836","12731","0","0","100.0","100.0","Non-CFO","2022","4","2022","3","09","30"
"2022-09-30","Bureau","Federal Communications Commission","Federal Communications Commission","237880836","12731","237880836","12731","0","0","100.0","100.0","null","2022","4","2022","3","09","30"
"2022-09-30","Agency","Federal Deposit Insurance Corporation","null","0","0","0","0","0","0","0.0","0.0","Non-CFO","2022","4","2022","3","09","30"
"2022-09-30","Bureau","Federal Deposit Insurance Corporation","Federal Deposit Insurance Corporation","0","0","0","0","0","0","0.0","0.0","null","2022","4","2022","3","09","30"
"2022-09-30","Agency","Federal Election Commission","null","2024763","293","2024763","293","0","0","100.0","100.0","Non-CFO","2022","4","2022","3","09","30"
"2022-09-30","Bureau","Federal Election Commission","Federal Election Commission","2024763","293","2024763","293","0","0","100.0","100.0","null","2022","4","2022","3","09","30"
"2022-09-30","Agency","Federal Labor Relations Authority","null","0","0","0","0","0","0","0.0","0.0","Non-CFO","2022","4","2022","3","09","30"
"2022-09-30","Bureau","Federal Labor Relations Authority","Federal Labor Relations Authority","0","0","0","0","0","0","0.0","0.0","null","2022","4","2022","3","09","30"
"2022-09-30","Agency","Federal Maritime Commission","null","397826","6","397826","6","0","0","100.0","100.0","Non-CFO","2022","4","2022","3","09","30"
"2022-09-30","Bureau","Federal Maritime Commission","Salaries and Expenses","397826","6","397826","6","0","0","100.0","100.0","null","2022","4","2022","3","09","30"
"2022-09-30","Agency","Federal Mediation/Conciliation Service","null","0","0","0","0","0","0","0.0","0.0","Non-CFO","2022","4","2022","3","09","30"
"2022-09-30","Bureau","Federal Mediation/Conciliation Service","Federal Mediation/Conciliation Service","0","0","0","0","0","0","0.0","0.0","null","2022","4","2022","3","09","30"
"2022-09-30","Agency","Federal Trade Commission","null","482179661","66","482179661","66","0","0","100.0","100.0","Non-CFO","2022","4","2022","3","09","30"
"2022-09-30","Bureau","Federal Trade Commission","Federal Trade Commission","482179661","66","482179661","66","0","0","100.0","100.0","null","2022","4","2022","3","09","30"
"2022-09-30","Agency","Funds Appropriated to the President","null","1236060","7","0","0","1236060","7","0.0","0.0","Non-CFO","2022","4","2022","3","09","30"
"2022-09-30","Bureau","Funds Appropriated to the President","African Development Foundation","0","0","0","0","0","0","0.0","0.0","null","2022","4","2022","3","09","30"
"2022-09-30","Bureau","Funds Appropriated to the President","Defense Security Assistance Agency","0","0","0","0","0","0","0.0","0.0","null","2022","4","2022","3","09","30"
"2022-09-30","Bureau","Funds Appropriated to the President","Executive Branch","0","0","0","0","0","0","0.0","0.0","null","2022","4","2022","3","09","30"
"2022-09-30","Bureau","Funds Appropriated to the President","Inter-American Foundation","0","0","0","0","0","0","0.0","0.0","null","2022","4","2022","3","09","30"
"2022-09-30","Bureau","Funds Appropriated to the President","Peace Corps","0","0","0","0","0","0","0.0","0.0","null","2022","4","2022","3","09","30"
"2022-09-30","Bureau","Funds Appropriated to the President","Trade and Development Agency","1236060","7","0","0","1236060","7","0.0","0.0","null","2022","4","2022","3","09","30"
"2022-09-30","Agency","General Services Administration","null","14217397","1715","13251571","1615","965826","100","93.20673116182941","94.16909620991254","CFO","2022","4","2022","3","09","30"
"2022-09-30","Bureau","General Services Administration","General Services Administration","14217397","1715","13251571","1615","965826","100","93.20673116182941","94.16909620991254","null","2022","4","2022","3","09","30"
"2022-09-30","Agency","Legis Branch-Library of Congress","null","98421","49","0","0","98421","49","0.0","0.0","Non-CFO","2022","4","2022","3","09","30"
"2022-09-30","Bureau","Legis Branch-Library of Congress","Library of Congress","98421","49","0","0","98421","49","0.0","0.0","null","2022","4","2022","3","09","30"
"2022-09-30","Agency","Legislative Branch - U.S. House/Senate","null","268369","218","0","0","268369","218","0.0","0.0","Non-CFO","2022","4","2022","3","09","30"
"2022-09-30","Bureau","Legislative Branch - U.S. House/Senate","U.S. House of Representatives","268369","218","0","0","268369","218","0.0","0.0","null","2022","4","2022","3","09","30"
"2022-09-30","Agency","Legislative Branch-CBO","null","0","0","0","0","0","0","0.0","0.0","Non-CFO","2022","4","2022","3","09","30"
"2022-09-30","Bureau","Legislative Branch-CBO","Congressional Budget Office","0","0","0","0","0","0","0.0","0.0","null","2022","4","2022","3","09","30"
"2022-09-30","Agency","Legislative Branch-GAO","null","28645","8","28645","8","0","0","100.0","100.0","Non-CFO","2022","4","2022","3","09","30"
"2022-09-30","Bureau","Legislative Branch-GAO","Government Accountability Office","28645","8","28645","8","0","0","100.0","100.0","null","2022","4","2022","3","09","30"
"2022-09-30","Agency","Legislative Branch-GPO","null","0","0","0","0","0","0","0.0","0.0","Non-CFO","2022","4","2022","3","09","30"
"2022-09-30","Bureau","Legislative Branch-GPO","Government Publishing Office","0","0","0","0","0","0","0.0","0.0","null","2022","4","2022","3","09","30"
"2022-09-30","Agency","Legislative Branch-Office of Tech.","null","0","0","0","0","0","0","0.0","0.0","Non-CFO","2022","4","2022","3","09","30"
"2022-09-30","Bureau","Legislative Branch-Office of Tech.","Medicaid & CHIP Payment & Access Comm.","0","0","0","0","0","0","0.0","0.0","null","2022","4","2022","3","09","30"
"2022-09-30","Bureau","Legislative Branch-Office of Tech.","Open World Leadership","0","0","0","0","0","0","0.0","0.0","null","2022","4","2022","3","09","30"
"2022-09-30","Agency","Merit Systems Protection Board","null","144","1","144","1","0","0","100.0","100.0","Non-CFO","2022","4","2022","3","09","30"
"2022-09-30","Bureau","Merit Systems Protection Board","Merit Systems Protection Board","144","1","144","1","0","0","100.0","100.0","null","2022","4","2022","3","09","30"
"2022-09-30","Agency","National Aeronautics and Space Administration","null","1581797","130","1581797","130","0","0","100.0","100.0","CFO","2022","4","2022","3","09","30"
"2022-09-30","Bureau","National Aeronautics and Space Administration","National Aeronautics and Space Admin","1581797","130","1581797","130","0","0","100.0","100.0","null","2022","4","2022","3","09","30"
"2022-09-30","Agency","National Archives & Records Admin","null","122954","128","122954","128","0","0","100.0","100.0","Non-CFO","2022","4","2022","3","09","30"
"2022-09-30","Bureau","National Archives & Records Admin","Nat'l Archives & Records Administration","122954","128","122954","128","0","0","100.0","100.0","null","2022","4","2022","3","09","30"
"2022-09-30","Agency","National Credit Union Administration","null","445","1","445","1","0","0","100.0","100.0","Non-CFO","2022","4","2022","3","09","30"
"2022-09-30","Bureau","National Credit Union Administration","National Credit Union Administration","445","1","445","1","0","0","100.0","100.0","null","2022","4","2022","3","09","30"
"2022-09-30","Agency","National Foundation  Arts & Humanities","null","0","0","0","0","0","0","0.0","0.0","Non-CFO","2022","4","2022","3","09","30"
"2022-09-30","Bureau","National Foundation  Arts & Humanities","National Endowment for the Arts","0","0","0","0","0","0","0.0","0.0","null","2022","4","2022","3","09","30"
"2022-09-30","Bureau","National Foundation  Arts & Humanities","National Endowment for the Humanities","0","0","0","0","0","0","0.0","0.0","null","2022","4","2022","3","09","30"
"2022-09-30","Agency","National Labor Relations Board","null","0","0","0","0","0","0","0.0","0.0","Non-CFO","2022","4","2022","3","09","30"
"2022-09-30","Bureau","National Labor Relations Board","National Labor Relations Board","0","0","0","0","0","0","0.0","0.0","null","2022","4","2022","3","09","30"
"2022-09-30","Agency","National Science Foundation","null","556521","50","556521","50","0","0","100.0","100.0","CFO","2022","4","2022","3","09","30"
"2022-09-30","Bureau","National Science Foundation","National Science Foundation","556521","50","556521","50","0","0","100.0","100.0","null","2022","4","2022","3","09","30"
"2022-09-30","Agency","Neighborhood Reinvestment Corporation","null","0","0","0","0","0","0","0.0","0.0","Non-CFO","2022","4","2022","3","09","30"
"2022-09-30","Bureau","Neighborhood Reinvestment Corporation","Neighborhood Reinvestment Corporation","0","0","0","0","0","0","0.0","0.0","null","2022","4","2022","3","09","30"
"2022-09-30","Agency","Nuclear Regulatory Commission","null","3238856","373","3238856","373","0","0","100.0","100.0","CFO","2022","4","2022","3","09","30"
"2022-09-30","Bureau","Nuclear Regulatory Commission","Nuclear Regulatory Commission","3238856","373","3238856","373","0","0","100.0","100.0","null","2022","4","2022","3","09","30"
"2022-09-30","Agency","Occupational Safety & Health Rev Comm","null","0","0","0","0","0","0","0.0","0.0","Non-CFO","2022","4","2022","3","09","30"
"2022-09-30","Bureau","Occupational Safety & Health Rev Comm","Occupational Safety & Health Rev Comm","0","0","0","0","0","0","0.0","0.0","null","2022","4","2022","3","09","30"
"2022-09-30","Agency","Office of Compliance","null","0","0","0","0","0","0","0.0","0.0","Non-CFO","2022","4","2022","3","09","30"
"2022-09-30","Bureau","Office of Compliance","Office of Compliance","0","0","0","0","0","0","0.0","0.0","null","2022","4","2022","3","09","30"
"2022-09-30","Agency","Office of Government Ethics","null","0","0","0","0","0","0","0.0","0.0","Non-CFO","2022","4","2022","3","09","30"
"2022-09-30","Bureau","Office of Government Ethics","Office of Government Ethics","0","0","0","0","0","0","0.0","0.0","null","2022","4","2022","3","09","30"
"2022-09-30","Agency","Office of Personnel Management","null","13793795","994","13793795","994","0","0","100.0","100.0","CFO","2022","4","2022","3","09","30"
"2022-09-30","Bureau","Office of Personnel Management","Office of Personnel Management","13793795","994","13793795","994","0","0","100.0","100.0","null","2022","4","2022","3","09","30"
"2022-09-30","Agency","Office of Special Counsel","null","0","0","0","0","0","0","0.0","0.0","Non-CFO","2022","4","2022","3","09","30"
"2022-09-30","Bureau","Office of Special Counsel","Office of Special Counsel","0","0","0","0","0","0","0.0","0.0","null","2022","4","2022","3","09","30"
"2022-09-30","Agency","Other Agencies","null","3486265","68","249797","9","3236468","59","7.165175338076709","13.235294117647058","Non-CFO","2022","4","2022","3","09","30"
"2022-09-30","Bureau","Other Agencies","Advisory Council on Hist. Preservation","0","0","0","0","0","0","0.0","0.0","null","2022","4","2022","3","09","30"
"2022-09-30","Bureau","Other Agencies","Archit.&Trans. Barriers Compliance Bd","0","0","0","0","0","0","0.0","0.0","null","2022","4","2022","3","09","30"
"2022-09-30","Bureau","Other Agencies","Architect of the Capitol","22952","17","0","0","22952","17","0.0","0.0","null","2022","4","2022","3","09","30"
"2022-09-30","Bureau","Other Agencies","Chemical Safety Board","33381","2","33381","2","0","0","100.0","100.0","null","2022","4","2022","3","09","30"
"2022-09-30","Bureau","Other Agencies","Comm. for Purchase from Blind/Handic.","0","0","0","0","0","0","0.0","0.0","null","2022","4","2022","3","09","30"
"2022-09-30","Bureau","Other Agencies","Commission On Fine Arts","0","0","0","0","0","0","0.0","0.0","null","2022","4","2022","3","09","30"
"2022-09-30","Bureau","Other Agencies","Consumer Financial Protection Bureau","3200545","14","211463","4","2989082","10","6.607093479391791","28.571428571428573","null","2022","4","2022","3","09","30"
"2022-09-30","Bureau","Other Agencies","Council of Insps. Gen. of Intg. & Effy.","957","3","0","0","957","3","0.0","0.0","null","2022","4","2022","3","09","30"
"2022-09-30","Bureau","Other Agencies","Defense Nuclear Facilities Safety Board","0","0","0","0","0","0","0.0","0.0","null","2022","4","2022","3","09","30"
"2022-09-30","Bureau","Other Agencies","Delta Regional Authority","0","0","0","0","0","0","0.0","0.0","null","2022","4","2022","3","09","30"
"2022-09-30","Bureau","Other Agencies","Denali Commission","0","0","0","0","0","0","0.0","0.0","null","2022","4","2022","3","09","30"
"2022-09-30","Bureau","Other Agencies","District of Columbia Government","0","0","0","0","0","0","0.0","0.0","null","2022","4","2022","3","09","30"
"2022-09-30","Bureau","Other Agencies","Election Assistance Commission","5576","1","0","0","5576","1","0.0","0.0","null","2022","4","2022","3","09","30"
"2022-09-30","Bureau","Other Agencies","Federal Housing Finance Agency","0","0","0","0","0","0","0.0","0.0","null","2022","4","2022","3","09","30"
"2022-09-30","Bureau","Other Agencies","Federal Housing Finance Agency OIG","0","0","0","0","0","0","0.0","0.0","null","2022","4","2022","3","09","30"
"2022-09-30","Bureau","Other Agencies","Federal Mine Safety & Health Review Comm","0","0","0","0","0","0","0.0","0.0","null","2022","4","2022","3","09","30"
"2022-09-30","Bureau","Other Agencies","Gulf Coast Ecosystem Restoration Council","0","0","0","0","0","0","0.0","0.0","null","2022","4","2022","3","09","30"
"2022-09-30","Bureau","Other Agencies","James Madison Memorial Fellowship","210759","24","0","0","210759","24","0.0","0.0","null","2022","4","2022","3","09","30"
"2022-09-30","Bureau","Other Agencies","John C. Stennis","2934","2","0","0","2934","2","0.0","0.0","null","2022","4","2022","3","09","30"
"2022-09-30","Bureau","Other Agencies","Millennium Challenge Corporation","0","0","0","0","0","0","0.0","0.0","null","2022","4","2022","3","09","30"
"2022-09-30","Bureau","Other Agencies","Morris K. Udall Scholarship","0","0","0","0","0","0","0.0","0.0","null","2022","4","2022","3","09","30"
"2022-09-30","Bureau","Other Agencies","National Capital Planning Commission","0","0","0","0","0","0","0.0","0.0","null","2022","4","2022","3","09","30"
"2022-09-30","Bureau","Other Agencies","National Council on Disability","53","2","23","1","30","1","43.39622641509434","50.0","null","2022","4","2022","3","09","30"
"2022-09-30","Bureau","Other Agencies","National Mediation Board","0","0","0","0","0","0","0.0","0.0","null","2022","4","2022","3","09","30"
"2022-09-30","Bureau","Other Agencies","National Transportation Safety Board","0","0","0","0","0","0","0.0","0.0","null","2022","4","2022","3","09","30"
"2022-09-30","Bureau","Other Agencies","Privacy & Civil Liberties Oversight Bd","0","0","0","0","0","0","0.0","0.0","null","2022","4","2022","3","09","30"
"2022-09-30","Bureau","Other Agencies","Surface Transportation Board","0","0","0","0","0","0","0.0","0.0","null","2022","4","2022","3","09","30"
"2022-09-30","Bureau","Other Agencies","U.S.  Agency of Global Media","4930","2","4930","2","0","0","100.0","100.0","null","2022","4","2022","3","09","30"
"2022-09-30","Bureau","Other Agencies","U.S. Holocaust Memorial Council","0","0","0","0","0","0","0.0","0.0","null","2022","4","2022","3","09","30"
"2022-09-30","Bureau","Other Agencies","U.S. Inst. for Env. Conflict Resolution","4178","1","0","0","4178","1","0.0","0.0","null","2022","4","2022","3","09","30"
"2022-09-30","Bureau","Other Agencies","U.S. Institute of Peace","0","0","0","0","0","0","0.0","0.0","null","2022","4","2022","3","09","30"
"2022-09-30","Agency","Other Agencies/Boards/Commissions","null","1024","1","0","0","1024","1","0.0","0.0","Non-CFO","2022","4","2022","3","09","30"
"2022-09-30","Bureau","Other Agencies/Boards/Commissions","Medicare Payment Advisory Commission","0","0","0","0","0","0","0.0","0.0","null","2022","4","2022","3","09","30"
"2022-09-30","Bureau","Other Agencies/Boards/Commissions","Nuclear Waste Technical Review Board","0","0","0","0","0","0","0.0","0.0","null","2022","4","2022","3","09","30"
"2022-09-30","Bureau","Other Agencies/Boards/Commissions","U.S. Comm. on Int. Religious Freedom","1024","1","0","0","1024","1","0.0","0.0","null","2022","4","2022","3","09","30"
"2022-09-30","Bureau","Other Agencies/Boards/Commissions","U.S.-China Security Review Commission","0","0","0","0","0","0","0.0","0.0","null","2022","4","2022","3","09","30"
"2022-09-30","Agency","Pension Benefit Guaranty Corp","null","3270867","1060","3270867","1060","0","0","100.0","100.0","Non-CFO","2022","4","2022","3","09","30"
"2022-09-30","Bureau","Pension Benefit Guaranty Corp","Pension Benefit Guaranty Corporation","3270867","1060","3270867","1060","0","0","100.0","100.0","null","2022","4","2022","3","09","30"
"2022-09-30","Agency","Presidio Trust Corporation","null","1501343","62","1501343","62","0","0","100.0","100.0","Non-CFO","2022","4","2022","3","09","30"
"2022-09-30","Bureau","Presidio Trust Corporation","Presidio Trust Corporation","1501343","62","1501343","62","0","0","100.0","100.0","null","2022","4","2022","3","09","30"
"2022-09-30","Agency","Railroad Retirement Board","null","22349330","4052","22349330","4052","0","0","100.0","100.0","Non-CFO","2022","4","2022","3","09","30"
"2022-09-30","Bureau","Railroad Retirement Board","Railroad Retirement Board","22349330","4052","22349330","4052","0","0","100.0","100.0","null","2022","4","2022","3","09","30"
"2022-09-30","Agency","Securities & Exchange Commission","null","2161476048","1163","2161476048","1163","0","0","100.0","100.0","Non-CFO","2022","4","2022","3","09","30"
"2022-09-30","Bureau","Securities & Exchange Commission","SEC Enforcement","2161228791","1116","2161228791","1116","0","0","100.0","100.0","null","2022","4","2022","3","09","30"
"2022-09-30","Bureau","Securities & Exchange Commission","Securities and Exchange Commission","247257","47","247257","47","0","0","100.0","100.0","null","2022","4","2022","3","09","30"
"2022-09-30","Agency","Selective Service System","null","4615","8","0","0","4615","8","0.0","0.0","Non-CFO","2022","4","2022","3","09","30"
"2022-09-30","Bureau","Selective Service System","Selective Service System","4615","8","0","0","4615","8","0.0","0.0","null","2022","4","2022","3","09","30"
"2022-09-30","Agency","Small Business Administration","null","13846407520","122989","13846407520","122989","0","0","100.0","100.0","CFO","2022","4","2022","3","09","30"
"2022-09-30","Bureau","Small Business Administration","Small Business Administration","13846407520","122989","13846407520","122989","0","0","100.0","100.0","null","2022","4","2022","3","09","30"
"2022-09-30","Agency","Smithsonian Institution","null","0","0","0","0","0","0","0.0","0.0","Non-CFO","2022","4","2022","3","09","30"
"2022-09-30","Bureau","Smithsonian Institution","Administrative Conference of the US","0","0","0","0","0","0","0.0","0.0","null","2022","4","2022","3","09","30"
"2022-09-30","Bureau","Smithsonian Institution","JFK Center for the Performing Arts","0","0","0","0","0","0","0.0","0.0","null","2022","4","2022","3","09","30"
"2022-09-30","Bureau","Smithsonian Institution","National Gallery of Art","0","0","0","0","0","0","0.0","0.0","null","2022","4","2022","3","09","30"
"2022-09-30","Bureau","Smithsonian Institution","Smithsonian Institution","0","0","0","0","0","0","0.0","0.0","null","2022","4","2022","3","09","30"
"2022-09-30","Agency","Social Security Administration","null","4361025322","1322598","2566753825","439044","1794271497","883554","58.856659511962356","33.19557416539266","CFO","2022","4","2022","3","09","30"
"2022-09-30","Bureau","Social Security Administration","Social Security Administration","4361025322","1322598","2566753825","439044","1794271497","883554","58.856659511962356","33.19557416539266","null","2022","4","2022","3","09","30"
"2022-09-30","Agency","Tennessee Valley Authority","null","237230","75","0","0","237230","75","0.0","0.0","Non-CFO","2022","4","2022","3","09","30"
"2022-09-30","Bureau","Tennessee Valley Authority","Tennessee Valley Authority","237230","75","0","0","237230","75","0.0","0.0","null","2022","4","2022","3","09","30"
"2022-09-30","Agency","The Judiciary","null","1090024","299","1025578","170","64446","129","94.0876531158947","56.8561872909699","Non-CFO","2022","4","2022","3","09","30"
"2022-09-30","Bureau","The Judiciary","Administrative Office of the U.S. Courts","1090024","299","1025578","170","64446","129","94.0876531158947","56.8561872909699","null","2022","4","2022","3","09","30"
"2022-09-30","Agency","U.S. Court of Appeals / Veterans Claims","null","0","0","0","0","0","0","0.0","0.0","Non-CFO","2022","4","2022","3","09","30"
"2022-09-30","Bureau","U.S. Court of Appeals / Veterans Claims","U.S. Court of Appeals / Veterans Claims","0","0","0","0","0","0","0.0","0.0","null","2022","4","2022","3","09","30"
"2022-09-30","Agency","U.S. Postal Service","null","75913010","69458","57720064","49595","18192946","19863","76.03448209997207","71.40286216130612","Non-CFO","2022","4","2022","3","09","30"
"2022-09-30","Bureau","U.S. Postal Service","U.S. Postal Service","75913010","69458","57720064","49595","18192946","19863","76.03448209997207","71.40286216130612","null","2022","4","2022","3","09","30"
"2022-09-30","Agency","U.S. Tax Court","null","0","0","0","0","0","0","0.0","0.0","Non-CFO","2022","4","2022","3","09","30"
"2022-09-30","Bureau","U.S. Tax Court","U.S. Tax Court","0","0","0","0","0","0","0.0","0.0","null","2022","4","2022","3","09","30"
"2022-09-30","Agency","US International Development Fin. Corp.","null","34492","1","0","0","34492","1","0.0","0.0","Non-CFO","2022","4","2022","3","09","30"
"2022-09-30","Bureau","US International Development Fin. Corp.","US International Development Fin. Corp.","34492","1","0","0","34492","1","0.0","0.0","null","2022","4","2022","3","09","30"
"2022-06-30","Agency","Agency for International Development","null","38018886","56","38018886","56","0","0","100.0","100.0","CFO","2022","3","2022","2","06","30"
"2022-06-30","Bureau","Agency for International Development","Agency for International Development","38018886","56","38018886","56","0","0","100.0","100.0","null","2022","3","2022","2","06","30"
"2022-06-30","Agency","American Battle Monuments Commission","null","0","0","0","0","0","0","0.0","0.0","Non-CFO","2022","3","2022","2","06","30"
"2022-06-30","Bureau","American Battle Monuments Commission","American Battle Monuments Commission","0","0","0","0","0","0","0.0","0.0","null","2022","3","2022","2","06","30"
"2022-06-30","Agency","Armed Forces Retirement Home","null","103852","107","77060","102","26792","5","74.20174864229865","95.32710280373831","Non-CFO","2022","3","2022","2","06","30"
"2022-06-30","Bureau","Armed Forces Retirement Home","Armed Forces Retirement Home","103852","107","77060","102","26792","5","74.20174864229865","95.32710280373831","null","2022","3","2022","2","06","30"
"2022-06-30","Agency","Commodity Futures Trading Commission","null","665216746","362","665216746","362","0","0","100.0","100.0","Non-CFO","2022","3","2022","2","06","30"
"2022-06-30","Bureau","Commodity Futures Trading Commission","Commodity Futures Trading Commission","665216746","362","665216746","362","0","0","100.0","100.0","null","2022","3","2022","2","06","30"
"2022-06-30","Agency","Consumer Product Safety Commission","null","2500","1","2500","1","0","0","100.0","100.0","Non-CFO","2022","3","2022","2","06","30"
"2022-06-30","Bureau","Consumer Product Safety Commission","Consumer Product Safety Commission","2500","1","2500","1","0","0","100.0","100.0","null","2022","3","2022","2","06","30"
"2022-06-30","Agency","Corp. for National and Community Service","null","98618","8","0","0","98618","8","0.0","0.0","Non-CFO","2022","3","2022","2","06","30"
"2022-06-30","Bureau","Corp. for National and Community Service","Corp. for National and Community Service","98618","8","0","0","98618","8","0.0","0.0","null","2022","3","2022","2","06","30"
"2022-06-30","Agency","Department of Agriculture","null","1860023831","61838","1845900762","56816","14123069","5022","99.24070494341962","91.87878003816424","CFO","2022","3","2022","2","06","30"
"2022-06-30","Bureau","Department of Agriculture","Agricultural Marketing Service","6457549","2430","5330711","597","1126838","1833","82.55006659647492","24.567901234567902","null","2022","3","2022","2","06","30"
"2022-06-30","Bureau","Department of Agriculture","Commodity Credit Corporation","139310515","10087","139310515","10087","0","0","100.0","100.0","null","2022","3","2022","2","06","30"
"2022-06-30","Bureau","Department of Agriculture","Farm Service Agency","804888406","13223","804888406","13223","0","0","100.0","100.0","null","2022","3","2022","2","06","30"
"2022-06-30","Bureau","Department of Agriculture","Federal Crop Insurance Corporation","15272","418","10557","408","4715","10","69.12650602409639","97.60765550239235","null","2022","3","2022","2","06","30"
"2022-06-30","Bureau","Department of Agriculture","Food Safety and Inspection Service","1127612","1050","1081534","1017","46078","33","95.91366533878674","96.85714285714286","null","2022","3","2022","2","06","30"
"2022-06-30","Bureau","Department of Agriculture","Food and Nutrition Service","2693027","134","57353","18","2635674","116","2.129685294651706","13.432835820895523","null","2022","3","2022","2","06","30"
"2022-06-30","Bureau","Department of Agriculture","Forest Service","73243710","1240","66788139","383","6455571","857","91.18617694270266","30.887096774193548","null","2022","3","2022","2","06","30"
"2022-06-30","Bureau","Department of Agriculture","Rural Development","811632290","29195","811566076","29091","66214","104","99.99184187213646","99.6437746189416","null","2022","3","2022","2","06","30"
"2022-06-30","Bureau","Department of Agriculture","U.S. Department of Agriculture","20655450","4061","16867471","1992","3787979","2069","81.66111607348182","49.051957645900025","null","2022","3","2022","2","06","30"
"2022-06-30","Agency","Department of Commerce","null","61105615","18287","61105615","18287","0","0","100.0","100.0","CFO","2022","3","2022","2","06","30"
"2022-06-30","Bureau","Department of Commerce","Bureau of Industry and Security","37692341","28","37692341","28","0","0","100.0","100.0","null","2022","3","2022","2","06","30"
"2022-06-30","Bureau","Department of Commerce","Bureau of the Census","3992122","16598","3992122","16598","0","0","100.0","100.0","null","2022","3","2022","2","06","30"
"2022-06-30","Bureau","Department of Commerce","Economic Development Administration","5137182","12","5137182","12","0","0","100.0","100.0","null","2022","3","2022","2","06","30"
"2022-06-30","Bureau","Department of Commerce","Economic and Statistical Analysis","0","0","0","0","0","0","0.0","0.0","null","2022","3","2022","2","06","30"
"2022-06-30","Bureau","Department of Commerce","General Administration","4660","1","4660","1","0","0","100.0","100.0","null","2022","3","2022","2","06","30"
"2022-06-30","Bureau","Department of Commerce","International Trade Administration","0","0","0","0","0","0","0.0","0.0","null","2022","3","2022","2","06","30"
"2022-06-30","Bureau","Department of Commerce","Minority Business Development Agency","0","0","0","0","0","0","0.0","0.0","null","2022","3","2022","2","06","30"
"2022-06-30","Bureau","Department of Commerce","NOAA","12822018","981","12822018","981","0","0","100.0","100.0","null","2022","3","2022","2","06","30"
"2022-06-30","Bureau","Department of Commerce","Nat'l Institute of Standards& Technology","673322","5","673322","5","0","0","100.0","100.0","null","2022","3","2022","2","06","30"
"2022-06-30","Bureau","Department of Commerce","Nat'l Telecomm & Information Admin.","296092","1","296092","1","0","0","100.0","100.0","null","2022","3","2022","2","06","30"
"2022-06-30","Bureau","Department of Commerce","National Technical Information Service","0","0","0","0","0","0","0.0","0.0","null","2022","3","2022","2","06","30"
"2022-06-30","Bureau","Department of Commerce","Office of the Inspector General","0","0","0","0","0","0","0.0","0.0","null","2022","3","2022","2","06","30"
"2022-06-30","Bureau","Department of Commerce","Patent and Trademark Office","487878","661","487878","661","0","0","100.0","100.0","null","2022","3","2022","2","06","30"
"2022-06-30","Agency","Department of Defense","null","2950044555","1579801","1067031754","296774","1883012801","1283027","36.17002164226635","18.785530582649333","CFO","2022","3","2022","2","06","30"
"2022-06-30","Bureau","Department of Defense","Consolidated Report","2950044555","1579801","1067031754","296774","1883012801","1283027","36.17002164226635","18.785530582649333","null","2022","3","2022","2","06","30"
"2022-06-30","Agency","Department of Education","null","125898953959","21519506","125803859582","21519281","95094377","225","99.92446769888893","99.99895443696524","CFO","2022","3","2022","2","06","30"
"2022-06-30","Bureau","Department of Education","Departmental Management","1358681195","2101","1263586818","1876","95094377","225","93.00097937986108","89.29081389814374","null","2022","3","2022","2","06","30"
"2022-06-30","Bureau","Department of Education","Federal Student Aid","124540272764","21517405","124540272764","21517405","0","0","100.0","100.0","null","2022","3","2022","2","06","30"
"2022-06-30","Bureau","Department of Education","Office of Postsecondary Education","0","0","0","0","0","0","0.0","0.0","null","2022","3","2022","2","06","30"
"2022-06-30","Agency","Department of Energy","null","13698431","82","13698431","82","0","0","100.0","100.0","CFO","2022","3","2022","2","06","30"
"2022-06-30","Bureau","Department of Energy","Bonneville Power Administration","1061842","25","1061842","25","0","0","100.0","100.0","null","2022","3","2022","2","06","30"
"2022-06-30","Bureau","Department of Energy","Energy Consolidated Reports","12636589","57","12636589","57","0","0","100.0","100.0","null","2022","3","2022","2","06","30"
"2022-06-30","Agency","Department of Health & Human Services","null","9746542702","1138535","9535991576","1109298","210551126","29237","97.83973525343715","97.43205083726016","CFO","2022","3","2022","2","06","30"
"2022-06-30","Bureau","Department of Health & Human Services","Administration for Children and Families","34567345","1741","34567345","1741","0","0","100.0","100.0","null","2022","3","2022","2","06","30"
"2022-06-30","Bureau","Department of Health & Human Services","Administration for Community Living","0","0","0","0","0","0","0.0","0.0","null","2022","3","2022","2","06","30"
"2022-06-30","Bureau","Department of Health & Human Services","Centers for Disease Control","8526230","103","161517","16","8364713","87","1.894354245663089","15.533980582524272","null","2022","3","2022","2","06","30"
"2022-06-30","Bureau","Department of Health & Human Services","Centers for Medicare & Medicaid Services","9355511742","1110360","9265667464","1100675","89844278","9685","99.03966474012684","99.12776036600742","null","2022","3","2022","2","06","30"
"2022-06-30","Bureau","Department of Health & Human Services","Food and Drug Administration","132458728","20368","38757376","1700","93701352","18668","29.25996390362438","8.346425765907306","null","2022","3","2022","2","06","30"
"2022-06-30","Bureau","Department of Health & Human Services","Health Resources and Services Admin","117758457","664","117758457","664","0","0","100.0","100.0","null","2022","3","2022","2","06","30"
"2022-06-30","Bureau","Department of Health & Human Services","Indian Health Services","65220527","4073","65220527","4073","0","0","100.0","100.0","null","2022","3","2022","2","06","30"
"2022-06-30","Bureau","Department of Health & Human Services","National Institutes of Health","25134782","901","6493999","104","18640783","797","25.836703099314725","11.542730299667037","null","2022","3","2022","2","06","30"
"2022-06-30","Bureau","Department of Health & Human Services","Office of the Inspector General","0","0","0","0","0","0","0.0","0.0","null","2022","3","2022","2","06","30"
"2022-06-30","Bureau","Department of Health & Human Services","Office of the Secretary","269993","6","269993","6","0","0","100.0","100.0","null","2022","3","2022","2","06","30"
"2022-06-30","Bureau","Department of Health & Human Services","Program Support Center","6056509","307","6056509","307","0","0","100.0","100.0","null","2022","3","2022","2","06","30"
"2022-06-30","Bureau","Department of Health & Human Services","Substance Abuse & Mental Health Admin.","1038389","12","1038389","12","0","0","100.0","100.0","null","2022","3","2022","2","06","30"
"2022-06-30","Agency","Department of Homeland Security","null","279484104","59368","274758722","46232","4725382","13136","98.30924838573289","77.8736019404393","CFO","2022","3","2022","2","06","30"
"2022-06-30","Bureau","Department of Homeland Security","Bureau of Customs & Border Protection","9406446","644","9406446","644","0","0","100.0","100.0","null","2022","3","2022","2","06","30"
"2022-06-30","Bureau","Department of Homeland Security","Citizenship and Immigration Services","1055753","1241","1055753","1241","0","0","100.0","100.0","null","2022","3","2022","2","06","30"
"2022-06-30","Bureau","Department of Homeland Security","Domestic Nuclear Detection Office","1258","9","0","0","1258","9","0.0","0.0","null","2022","3","2022","2","06","30"
"2022-06-30","Bureau","Department of Homeland Security","Emergency Preparedness & Resp","240249408","39539","240249408","39539","0","0","100.0","100.0","null","2022","3","2022","2","06","30"
"2022-06-30","Bureau","Department of Homeland Security","Federal Law Enforcement Training Ctr.","16218","2","16218","2","0","0","100.0","100.0","null","2022","3","2022","2","06","30"
"2022-06-30","Bureau","Department of Homeland Security","Immigration and Customs Enforcement","14661172","605","14661172","605","0","0","100.0","100.0","null","2022","3","2022","2","06","30"
"2022-06-30","Bureau","Department of Homeland Security","Info Analysis Infrastructure Prot-NPPD","0","0","0","0","0","0","0.0","0.0","null","2022","3","2022","2","06","30"
"2022-06-30","Bureau","Department of Homeland Security","Management Headquarters","0","0","0","0","0","0","0.0","0.0","null","2022","3","2022","2","06","30"
"2022-06-30","Bureau","Department of Homeland Security","Office of Biometric Identity Management","0","0","0","0","0","0","0.0","0.0","null","2022","3","2022","2","06","30"
"2022-06-30","Bureau","Department of Homeland Security","Office of Health Affairs","0","0","0","0","0","0","0.0","0.0","null","2022","3","2022","2","06","30"
"2022-06-30","Bureau","Department of Homeland Security","Office of the Inspector General DHS","100","1","100","1","0","0","100.0","100.0","null","2022","3","2022","2","06","30"
"2022-06-30","Bureau","Department of Homeland Security","Science and Technology","0","0","0","0","0","0","0.0","0.0","null","2022","3","2022","2","06","30"
"2022-06-30","Bureau","Department of Homeland Security","Transportation Safety Administration","9369625","4200","9369625","4200","0","0","100.0","100.0","null","2022","3","2022","2","06","30"
"2022-06-30","Bureau","Department of Homeland Security","U.S. Coast Guard","4724124","13127","0","0","4724124","13127","0.0","0.0","null","2022","3","2022","2","06","30"
"2022-06-30","Bureau","Department of Homeland Security","U.S. Secret Service","0","0","0","0","0","0","0.0","0.0","null","2022","3","2022","2","06","30"
"2022-06-30","Agency","Department of Housing and Urban Development","null","102269187","3745","99076678","3721","3192509","24","96.87832758463212","99.35914552736983","CFO","2022","3","2022","2","06","30"
"2022-06-30","Bureau","Department of Housing and Urban Development","Community Planning and Development","0","0","0","0","0","0","0.0","0.0","null","2022","3","2022","2","06","30"
"2022-06-30","Bureau","Department of Housing and Urban Development","Government National Mortgage Association","0","0","0","0","0","0","0.0","0.0","null","2022","3","2022","2","06","30"
"2022-06-30","Bureau","Department of Housing and Urban Development","Housing Programs","99071843","3719","99071843","3719","0","0","100.0","100.0","null","2022","3","2022","2","06","30"
"2022-06-30","Bureau","Department of Housing and Urban Development","Management and Administration","826849","11","4835","2","822014","9","0.584750057144654","18.181818181818183","null","2022","3","2022","2","06","30"
"2022-06-30","Bureau","Department of Housing and Urban Development","Policy, Development and Research","0","0","0","0","0","0","0.0","0.0","null","2022","3","2022","2","06","30"
"2022-06-30","Bureau","Department of Housing and Urban Development","Public and Indian Housing Programs","2370495","15","0","0","2370495","15","0.0","0.0","null","2022","3","2022","2","06","30"
"2022-06-30","Agency","Department of Justice","null","92278720","38770","88605360","38295","3673360","475","96.01927725048635","98.77482589631158","CFO","2022","3","2022","2","06","30"
"2022-06-30","Bureau","Department of Justice","Bureau of ATF and Explosives","20422","4","20422","4","0","0","100.0","100.0","null","2022","3","2022","2","06","30"
"2022-06-30","Bureau","Department of Justice","Drug Enforcement Administration","363550","22","363550","22","0","0","100.0","100.0","null","2022","3","2022","2","06","30"
"2022-06-30","Bureau","Department of Justice","Federal Bureau of Investigation","415921","91","415921","91","0","0","100.0","100.0","null","2022","3","2022","2","06","30"
"2022-06-30","Bureau","Department of Justice","Federal Prison Industries","129923","13","0","0","129923","13","0.0","0.0","null","2022","3","2022","2","06","30"
"2022-06-30","Bureau","Department of Justice","Federal Prison System","0","0","0","0","0","0","0.0","0.0","null","2022","3","2022","2","06","30"
"2022-06-30","Bureau","Department of Justice","General Administration","0","0","0","0","0","0","0.0","0.0","null","2022","3","2022","2","06","30"
"2022-06-30","Bureau","Department of Justice","Legal Activities","90411134","38637","86867697","38175","3543437","462","96.08075151452033","98.80425498874136","null","2022","3","2022","2","06","30"
"2022-06-30","Bureau","Department of Justice","Office of Justice Assistance Programs","937770","3","937770","3","0","0","100.0","100.0","null","2022","3","2022","2","06","30"
"2022-06-30","Bureau","Department of Justice","U.S. Marshals Service","0","0","0","0","0","0","0.0","0.0","null","2022","3","2022","2","06","30"
"2022-06-30","Agency","Department of Labor","null","185188696","27029","160968185","13930","24220511","13099","86.9211720136525","51.53723778164194","CFO","2022","3","2022","2","06","30"
"2022-06-30","Bureau","Department of Labor","Bureau of Labor Statistics","6558","1","6558","1","0","0","100.0","100.0","null","2022","3","2022","2","06","30"
"2022-06-30","Bureau","Department of Labor","Departmental Management","0","0","0","0","0","0","0.0","0.0","null","2022","3","2022","2","06","30"
"2022-06-30","Bureau","Department of Labor","Employee Benefit Security Administration","21535331","503","21535331","503","0","0","100.0","100.0","null","2022","3","2022","2","06","30"
"2022-06-30","Bureau","Department of Labor","Employment Standards Administration","83648220","15934","65895613","5336","17752607","10598","78.77706542948553","33.488138571607884","null","2022","3","2022","2","06","30"
"2022-06-30","Bureau","Department of Labor","Employment and Training Administration","925025","10","925025","10","0","0","100.0","100.0","null","2022","3","2022","2","06","30"
"2022-06-30","Bureau","Department of Labor","Mine Safety and Health Administration","12505080","4398","10312882","3137","2192198","1261","82.46954037879006","71.32787630741247","null","2022","3","2022","2","06","30"
"2022-06-30","Bureau","Department of Labor","Occupational Safety and Health Admin","66568482","6183","62292776","4943","4275706","1240","93.57698137085355","79.9450105126961","null","2022","3","2022","2","06","30"
"2022-06-30","Agency","Department of State","null","24604131","22795","24459698","22772","144433","23","99.4129725613963","99.89910067997369","CFO","2022","3","2022","2","06","30"
"2022-06-30","Bureau","Department of State","Civil Monetary Penalties","0","0","0","0","0","0","0.0","0.0","null","2022","3","2022","2","06","30"
"2022-06-30","Bureau","Department of State","Department of State","22647289","10184","22502856","10161","144433","23","99.36225037795914","99.77415553809898","null","2022","3","2022","2","06","30"
"2022-06-30","Bureau","Department of State","International Commissions","0","0","0","0","0","0","0.0","0.0","null","2022","3","2022","2","06","30"
"2022-06-30","Bureau","Department of State","Passport NSF","1956842","12611","1956842","12611","0","0","100.0","100.0","null","2022","3","2022","2","06","30"
"2022-06-30","Agency","Department of Transportation","null","71312830","7824","71206680","7781","106150","43","99.85114880449983","99.45040899795501","CFO","2022","3","2022","2","06","30"
"2022-06-30","Bureau","Department of Transportation","Federal Aviation Administration","2447089","367","2340939","324","106150","43","95.66219291574602","88.28337874659401","null","2022","3","2022","2","06","30"
"2022-06-30","Bureau","Department of Transportation","Federal Highway Administration","5040","6","5040","6","0","0","100.0","100.0","null","2022","3","2022","2","06","30"
"2022-06-30","Bureau","Department of Transportation","Federal Motor Carrier Safety Admin","66296225","7367","66296225","7367","0","0","100.0","100.0","null","2022","3","2022","2","06","30"
"2022-06-30","Bureau","Department of Transportation","Federal Railroad Administration","133249","12","133249","12","0","0","100.0","100.0","null","2022","3","2022","2","06","30"
"2022-06-30","Bureau","Department of Transportation","Federal Transit Administration","783405","1","783405","1","0","0","100.0","100.0","null","2022","3","2022","2","06","30"
"2022-06-30","Bureau","Department of Transportation","Maritime Administration","5859","7","5859","7","0","0","100.0","100.0","null","2022","3","2022","2","06","30"
"2022-06-30","Bureau","Department of Transportation","National Highway Traffic Safety Admin.","19297","3","19297","3","0","0","100.0","100.0","null","2022","3","2022","2","06","30"
"2022-06-30","Bureau","Department of Transportation","Office of the Inspector General","0","0","0","0","0","0","0.0","0.0","null","2022","3","2022","2","06","30"
"2022-06-30","Bureau","Department of Transportation","Office of the Secretary","1091474","15","1091474","15","0","0","100.0","100.0","null","2022","3","2022","2","06","30"
"2022-06-30","Bureau","Department of Transportation","Pipeline Hazardous Material Safety Admin","523391","43","523391","43","0","0","100.0","100.0","null","2022","3","2022","2","06","30"
"2022-06-30","Bureau","Department of Transportation","Research Innovative Technology Admin","73","1","73","1","0","0","100.0","100.0","null","2022","3","2022","2","06","30"
"2022-06-30","Bureau","Department of Transportation","St. Lawrence Seaway Development Corp.","7728","2","7728","2","0","0","100.0","100.0","null","2022","3","2022","2","06","30"
"2022-06-30","Agency","Department of Veterans Affairs","null","355045337","2180174","198021626","2135785","157023711","44389","55.77361687755386","97.96396984827817","CFO","2022","3","2022","2","06","30"
"2022-06-30","Bureau","Department of Veterans Affairs","Administration and Cemeteries","1383353","895","34107","29","1349246","866","2.465531212929744","3.2402234636871508","null","2022","3","2022","2","06","30"
"2022-06-30","Bureau","Department of Veterans Affairs","Housing Credit Assistance","770172","27","2024","1","768148","26","0.26279843982902523","3.7037037037037037","null","2022","3","2022","2","06","30"
"2022-06-30","Bureau","Department of Veterans Affairs","Life Insurance","1150403","213","1150403","213","0","0","100.0","100.0","null","2022","3","2022","2","06","30"
"2022-06-30","Bureau","Department of Veterans Affairs","Medical and Construction","350490288","2177390","196835092","2135542","153655196","41848","56.15992760404249","98.07806594133343","null","2022","3","2022","2","06","30"
"2022-06-30","Bureau","Department of Veterans Affairs","Veterans Benefits","1251121","1649","0","0","1251121","1649","0.0","0.0","null","2022","3","2022","2","06","30"
"2022-06-30","Agency","Department of the Interior","null","55191203","32068","55178582","31922","12621","146","99.97713222522074","99.54471747536485","CFO","2022","3","2022","2","06","30"
"2022-06-30","Bureau","Department of the Interior","Bureau of Indian Affairs","16672365","28177","16659744","28031","12621","146","99.92429988187038","99.48184689640487","null","2022","3","2022","2","06","30"
"2022-06-30","Bureau","Department of the Interior","Bureau of Land Management","9020207","334","9020207","334","0","0","100.0","100.0","null","2022","3","2022","2","06","30"
"2022-06-30","Bureau","Department of the Interior","Bureau of Ocean Energy Mgmt., Reg & Enf","1724","1","1724","1","0","0","100.0","100.0","null","2022","3","2022","2","06","30"
"2022-06-30","Bureau","Department of the Interior","Bureau of Reclamation","7332125","67","7332125","67","0","0","100.0","100.0","null","2022","3","2022","2","06","30"
"2022-06-30","Bureau","Department of the Interior","Bureau of Safety and Environmental Enf.","508","2","508","2","0","0","100.0","100.0","null","2022","3","2022","2","06","30"
"2022-06-30","Bureau","Department of the Interior","Fish and Wildlife Service","746100","63","746100","63","0","0","100.0","100.0","null","2022","3","2022","2","06","30"
"2022-06-30","Bureau","Department of the Interior","Geological Survey","243146","503","243146","503","0","0","100.0","100.0","null","2022","3","2022","2","06","30"
"2022-06-30","Bureau","Department of the Interior","National Park Service","8458241","2010","8458241","2010","0","0","100.0","100.0","null","2022","3","2022","2","06","30"
"2022-06-30","Bureau","Department of the Interior","Office of Natural Resources Revenue","4667708","521","4667708","521","0","0","100.0","100.0","null","2022","3","2022","2","06","30"
"2022-06-30","Bureau","Department of the Interior","Office of Surface Mining","8013807","374","8013807","374","0","0","100.0","100.0","null","2022","3","2022","2","06","30"
"2022-06-30","Bureau","Department of the Interior","Office of the Secretary","35272","16","35272","16","0","0","100.0","100.0","null","2022","3","2022","2","06","30"
"2022-06-30","Agency","Department of the Treasury","null","43892475","4738","43376224","4713","516251","25","98.82382800240816","99.47235120303925","CFO","2022","3","2022","2","06","30"
"2022-06-30","Bureau","Department of the Treasury","Bureau of Engraving and Printing","38345","2","38345","2","0","0","100.0","100.0","null","2022","3","2022","2","06","30"
"2022-06-30","Bureau","Department of the Treasury","Bureau of the Fiscal Service","13416864","3265","13416864","3265","0","0","100.0","100.0","null","2022","3","2022","2","06","30"
"2022-06-30","Bureau","Department of the Treasury","Community Dev Financial Inst Fund","4559319","10","4559319","10","0","0","100.0","100.0","null","2022","3","2022","2","06","30"
"2022-06-30","Bureau","Department of the Treasury","Comptroller of the Currency","1453043","23","1448043","22","5000","1","99.65589456058768","95.65217391304348","null","2022","3","2022","2","06","30"
"2022-06-30","Bureau","Department of the Treasury","D.C. Pension Program","455729","21","455729","21","0","0","100.0","100.0","null","2022","3","2022","2","06","30"
"2022-06-30","Bureau","Department of the Treasury","Departmental Offices","22256809","1343","21746558","1320","510251","23","97.70743865394181","98.2874162323157","null","2022","3","2022","2","06","30"
"2022-06-30","Bureau","Department of the Treasury","Financial Crimes Enforcement Network","1544945","3","1544945","3","0","0","100.0","100.0","null","2022","3","2022","2","06","30"
"2022-06-30","Bureau","Department of the Treasury","Interest on Tax/Deposit of Earnings","0","0","0","0","0","0","0.0","0.0","null","2022","3","2022","2","06","30"
"2022-06-30","Bureau","Department of the Treasury","Internal Revenue Service","137543","46","137543","46","0","0","100.0","100.0","null","2022","3","2022","2","06","30"
"2022-06-30","Bureau","Department of the Treasury","International Monetary Funds","0","0","0","0","0","0","0.0","0.0","null","2022","3","2022","2","06","30"
"2022-06-30","Bureau","Department of the Treasury","Office of Financial Research","268","1","268","1","0","0","100.0","100.0","null","2022","3","2022","2","06","30"
"2022-06-30","Bureau","Department of the Treasury","Office of Sec International Affairs","0","0","0","0","0","0","0.0","0.0","null","2022","3","2022","2","06","30"
"2022-06-30","Bureau","Department of the Treasury","Office of the Secretary","0","0","0","0","0","0","0.0","0.0","null","2022","3","2022","2","06","30"
"2022-06-30","Bureau","Department of the Treasury","Pandemic Receivables","0","0","0","0","0","0","0.0","0.0","null","2022","3","2022","2","06","30"
"2022-06-30","Bureau","Department of the Treasury","Spec Insp Gen-Troubled Asset Rel Prog","3916","1","3916","1","0","0","100.0","100.0","null","2022","3","2022","2","06","30"
"2022-06-30","Bureau","Department of the Treasury","Tobacco Tax and Trade","1000","1","1000","1","0","0","100.0","100.0","null","2022","3","2022","2","06","30"
"2022-06-30","Bureau","Department of the Treasury","Treasury Forfeiture Fund","0","0","0","0","0","0","0.0","0.0","null","2022","3","2022","2","06","30"
"2022-06-30","Bureau","Department of the Treasury","Treasury Franchise Fund","0","0","0","0","0","0","0.0","0.0","null","2022","3","2022","2","06","30"
"2022-06-30","Bureau","Department of the Treasury","Treasury IG for Tax Admin","187","1","187","1","0","0","100.0","100.0","null","2022","3","2022","2","06","30"
"2022-06-30","Bureau","Department of the Treasury","U.S. Mint","24507","21","23507","20","1000","1","95.91953319459746","95.23809523809524","null","2022","3","2022","2","06","30"
"2022-06-30","Bureau","Department of the Treasury","U.S. Treasury IG Office","0","0","0","0","0","0","0.0","0.0","null","2022","3","2022","2","06","30"
"2022-06-30","Agency","Environmental Protection Agency","null","26115255","283","26105457","281","9798","2","99.96248169891506","99.29328621908127","CFO","2022","3","2022","2","06","30"
"2022-06-30","Bureau","Environmental Protection Agency","Environmental Protection Agency","26115255","283","26105457","281","9798","2","99.96248169891506","99.29328621908127","null","2022","3","2022","2","06","30"
"2022-06-30","Agency","Equal Employment Opportunity Commission","null","15191","15","15191","15","0","0","100.0","100.0","Non-CFO","2022","3","2022","2","06","30"
"2022-06-30","Bureau","Equal Employment Opportunity Commission","Equal Employment Opportunity Commission","15191","15","15191","15","0","0","100.0","100.0","null","2022","3","2022","2","06","30"
"2022-06-30","Agency","Export - Import  Bank","null","0","0","0","0","0","0","0.0","0.0","Non-CFO","2022","3","2022","2","06","30"
"2022-06-30","Bureau","Export - Import  Bank","Export-Import Bank","0","0","0","0","0","0","0.0","0.0","null","2022","3","2022","2","06","30"
"2022-06-30","Agency","Farm Credit Administration","null","630","1","630","1","0","0","100.0","100.0","Non-CFO","2022","3","2022","2","06","30"
"2022-06-30","Bureau","Farm Credit Administration","Farm Credit Administration","630","1","630","1","0","0","100.0","100.0","null","2022","3","2022","2","06","30"
"2022-06-30","Bureau","Farm Credit Administration","Farm Credit System Insurance Corporation","0","0","0","0","0","0","0.0","0.0","null","2022","3","2022","2","06","30"
"2022-06-30","Agency","Federal Communications Commission","null","235032516","13186","235032516","13186","0","0","100.0","100.0","Non-CFO","2022","3","2022","2","06","30"
"2022-06-30","Bureau","Federal Communications Commission","Federal Communications Commission","235032516","13186","235032516","13186","0","0","100.0","100.0","null","2022","3","2022","2","06","30"
"2022-06-30","Agency","Federal Deposit Insurance Corporation","null","0","0","0","0","0","0","0.0","0.0","Non-CFO","2022","3","2022","2","06","30"
"2022-06-30","Bureau","Federal Deposit Insurance Corporation","Federal Deposit Insurance Corporation","0","0","0","0","0","0","0.0","0.0","null","2022","3","2022","2","06","30"
"2022-06-30","Agency","Federal Election Commission","null","1655281","256","1655281","256","0","0","100.0","100.0","Non-CFO","2022","3","2022","2","06","30"
"2022-06-30","Bureau","Federal Election Commission","Federal Election Commission","1655281","256","1655281","256","0","0","100.0","100.0","null","2022","3","2022","2","06","30"
"2022-06-30","Agency","Federal Labor Relations Authority","null","0","0","0","0","0","0","0.0","0.0","Non-CFO","2022","3","2022","2","06","30"
"2022-06-30","Bureau","Federal Labor Relations Authority","Federal Labor Relations Authority","0","0","0","0","0","0","0.0","0.0","null","2022","3","2022","2","06","30"
"2022-06-30","Agency","Federal Maritime Commission","null","397704","6","397704","6","0","0","100.0","100.0","Non-CFO","2022","3","2022","2","06","30"
"2022-06-30","Bureau","Federal Maritime Commission","Salaries and Expenses","397704","6","397704","6","0","0","100.0","100.0","null","2022","3","2022","2","06","30"
"2022-06-30","Agency","Federal Mediation/Conciliation Service","null","0","0","0","0","0","0","0.0","0.0","Non-CFO","2022","3","2022","2","06","30"
"2022-06-30","Bureau","Federal Mediation/Conciliation Service","Federal Mediation/Conciliation Service","0","0","0","0","0","0","0.0","0.0","null","2022","3","2022","2","06","30"
"2022-06-30","Agency","Federal Trade Commission","null","482184354","68","482184354","68","0","0","100.0","100.0","Non-CFO","2022","3","2022","2","06","30"
"2022-06-30","Bureau","Federal Trade Commission","Federal Trade Commission","482184354","68","482184354","68","0","0","100.0","100.0","null","2022","3","2022","2","06","30"
"2022-06-30","Agency","Funds Appropriated to the President","null","1236060","7","0","0","1236060","7","0.0","0.0","Non-CFO","2022","3","2022","2","06","30"
"2022-06-30","Bureau","Funds Appropriated to the President","African Development Foundation","0","0","0","0","0","0","0.0","0.0","null","2022","3","2022","2","06","30"
"2022-06-30","Bureau","Funds Appropriated to the President","Defense Security Assistance Agency","0","0","0","0","0","0","0.0","0.0","null","2022","3","2022","2","06","30"
"2022-06-30","Bureau","Funds Appropriated to the President","Executive Branch","0","0","0","0","0","0","0.0","0.0","null","2022","3","2022","2","06","30"
"2022-06-30","Bureau","Funds Appropriated to the President","Inter-American Foundation","0","0","0","0","0","0","0.0","0.0","null","2022","3","2022","2","06","30"
"2022-06-30","Bureau","Funds Appropriated to the President","Peace Corps","0","0","0","0","0","0","0.0","0.0","null","2022","3","2022","2","06","30"
"2022-06-30","Bureau","Funds Appropriated to the President","Trade and Development Agency","1236060","7","0","0","1236060","7","0.0","0.0","null","2022","3","2022","2","06","30"
"2022-06-30","Agency","General Services Administration","null","14114584","1674","13036827","1163","1077757","511","92.36423120936473","69.47431302270012","CFO","2022","3","2022","2","06","30"
"2022-06-30","Bureau","General Services Administration","General Services Administration","14114584","1674","13036827","1163","1077757","511","92.36423120936473","69.47431302270012","null","2022","3","2022","2","06","30"
"2022-06-30","Agency","Legis Branch-Library of Congress","null","0","0","0","0","0","0","0.0","0.0","Non-CFO","2022","3","2022","2","06","30"
"2022-06-30","Bureau","Legis Branch-Library of Congress","Library of Congress","0","0","0","0","0","0","0.0","0.0","null","2022","3","2022","2","06","30"
"2022-06-30","Agency","Legislative Branch - U.S. House/Senate","null","274765","203","0","0","274765","203","0.0","0.0","Non-CFO","2022","3","2022","2","06","30"
"2022-06-30","Bureau","Legislative Branch - U.S. House/Senate","U.S. House of Representatives","274765","203","0","0","274765","203","0.0","0.0","null","2022","3","2022","2","06","30"
"2022-06-30","Agency","Legislative Branch-CBO","null","0","0","0","0","0","0","0.0","0.0","Non-CFO","2022","3","2022","2","06","30"
"2022-06-30","Bureau","Legislative Branch-CBO","Congressional Budget Office","0","0","0","0","0","0","0.0","0.0","null","2022","3","2022","2","06","30"
"2022-06-30","Agency","Legislative Branch-GAO","null","0","0","0","0","0","0","0.0","0.0","Non-CFO","2022","3","2022","2","06","30"
"2022-06-30","Bureau","Legislative Branch-GAO","Government Accountability Office","0","0","0","0","0","0","0.0","0.0","null","2022","3","2022","2","06","30"
"2022-06-30","Agency","Legislative Branch-GPO","null","75651","9","75651","9","0","0","100.0","100.0","Non-CFO","2022","3","2022","2","06","30"
"2022-06-30","Bureau","Legislative Branch-GPO","Government Publishing Office","75651","9","75651","9","0","0","100.0","100.0","null","2022","3","2022","2","06","30"
"2022-06-30","Agency","Legislative Branch-Office of Tech.","null","0","0","0","0","0","0","0.0","0.0","Non-CFO","2022","3","2022","2","06","30"
"2022-06-30","Bureau","Legislative Branch-Office of Tech.","Medicaid & CHIP Payment & Access Comm.","0","0","0","0","0","0","0.0","0.0","null","2022","3","2022","2","06","30"
"2022-06-30","Bureau","Legislative Branch-Office of Tech.","Open World Leadership","0","0","0","0","0","0","0.0","0.0","null","2022","3","2022","2","06","30"
"2022-06-30","Agency","Merit Systems Protection Board","null","144","1","144","1","0","0","100.0","100.0","Non-CFO","2022","3","2022","2","06","30"
"2022-06-30","Bureau","Merit Systems Protection Board","Merit Systems Protection Board","144","1","144","1","0","0","100.0","100.0","null","2022","3","2022","2","06","30"
"2022-06-30","Agency","National Aeronautics and Space Administration","null","1584125","130","1584125","130","0","0","100.0","100.0","CFO","2022","3","2022","2","06","30"
"2022-06-30","Bureau","National Aeronautics and Space Administration","National Aeronautics and Space Admin","1584125","130","1584125","130","0","0","100.0","100.0","null","2022","3","2022","2","06","30"
"2022-06-30","Agency","National Archives & Records Admin","null","120327","115","120327","115","0","0","100.0","100.0","Non-CFO","2022","3","2022","2","06","30"
"2022-06-30","Bureau","National Archives & Records Admin","Nat'l Archives & Records Administration","120327","115","120327","115","0","0","100.0","100.0","null","2022","3","2022","2","06","30"
"2022-06-30","Agency","National Credit Union Administration","null","500","2","500","2","0","0","100.0","100.0","Non-CFO","2022","3","2022","2","06","30"
"2022-06-30","Bureau","National Credit Union Administration","National Credit Union Administration","500","2","500","2","0","0","100.0","100.0","null","2022","3","2022","2","06","30"
"2022-06-30","Agency","National Foundation  Arts & Humanities","null","0","0","0","0","0","0","0.0","0.0","Non-CFO","2022","3","2022","2","06","30"
"2022-06-30","Bureau","National Foundation  Arts & Humanities","National Endowment for the Arts","0","0","0","0","0","0","0.0","0.0","null","2022","3","2022","2","06","30"
"2022-06-30","Bureau","National Foundation  Arts & Humanities","National Endowment for the Humanities","0","0","0","0","0","0","0.0","0.0","null","2022","3","2022","2","06","30"
"2022-06-30","Agency","National Labor Relations Board","null","0","0","0","0","0","0","0.0","0.0","Non-CFO","2022","3","2022","2","06","30"
"2022-06-30","Bureau","National Labor Relations Board","National Labor Relations Board","0","0","0","0","0","0","0.0","0.0","null","2022","3","2022","2","06","30"
"2022-06-30","Agency","National Science Foundation","null","561275","62","561275","62","0","0","100.0","100.0","CFO","2022","3","2022","2","06","30"
"2022-06-30","Bureau","National Science Foundation","National Science Foundation","561275","62","561275","62","0","0","100.0","100.0","null","2022","3","2022","2","06","30"
"2022-06-30","Agency","Neighborhood Reinvestment Corporation","null","0","0","0","0","0","0","0.0","0.0","Non-CFO","2022","3","2022","2","06","30"
"2022-06-30","Bureau","Neighborhood Reinvestment Corporation","Neighborhood Reinvestment Corporation","0","0","0","0","0","0","0.0","0.0","null","2022","3","2022","2","06","30"
"2022-06-30","Agency","Nuclear Regulatory Commission","null","2876643","346","2876643","346","0","0","100.0","100.0","CFO","2022","3","2022","2","06","30"
"2022-06-30","Bureau","Nuclear Regulatory Commission","Nuclear Regulatory Commission","2876643","346","2876643","346","0","0","100.0","100.0","null","2022","3","2022","2","06","30"
"2022-06-30","Agency","Occupational Safety & Health Rev Comm","null","0","0","0","0","0","0","0.0","0.0","Non-CFO","2022","3","2022","2","06","30"
"2022-06-30","Bureau","Occupational Safety & Health Rev Comm","Occupational Safety & Health Rev Comm","0","0","0","0","0","0","0.0","0.0","null","2022","3","2022","2","06","30"
"2022-06-30","Agency","Office of Compliance","null","0","0","0","0","0","0","0.0","0.0","Non-CFO","2022","3","2022","2","06","30"
"2022-06-30","Bureau","Office of Compliance","Office of Compliance","0","0","0","0","0","0","0.0","0.0","null","2022","3","2022","2","06","30"
"2022-06-30","Agency","Office of Government Ethics","null","0","0","0","0","0","0","0.0","0.0","Non-CFO","2022","3","2022","2","06","30"
"2022-06-30","Bureau","Office of Government Ethics","Office of Government Ethics","0","0","0","0","0","0","0.0","0.0","null","2022","3","2022","2","06","30"
"2022-06-30","Agency","Office of Personnel Management","null","12904290","870","11698407","718","1205883","152","90.65517746423863","82.52873563218391","CFO","2022","3","2022","2","06","30"
"2022-06-30","Bureau","Office of Personnel Management","Office of Personnel Management","12904290","870","11698407","718","1205883","152","90.65517746423863","82.52873563218391","null","2022","3","2022","2","06","30"
"2022-06-30","Agency","Office of Special Counsel","null","0","0","0","0","0","0","0.0","0.0","Non-CFO","2022","3","2022","2","06","30"
"2022-06-30","Bureau","Office of Special Counsel","Office of Special Counsel","0","0","0","0","0","0","0.0","0.0","null","2022","3","2022","2","06","30"
"2022-06-30","Agency","Other Agencies","null","3491424","72","250634","8","3240790","64","7.178560953925962","11.11111111111111","Non-CFO","2022","3","2022","2","06","30"
"2022-06-30","Bureau","Other Agencies","Advisory Council on Hist. Preservation","0","0","0","0","0","0","0.0","0.0","null","2022","3","2022","2","06","30"
"2022-06-30","Bureau","Other Agencies","Archit.&Trans. Barriers Compliance Bd","0","0","0","0","0","0","0.0","0.0","null","2022","3","2022","2","06","30"
"2022-06-30","Bureau","Other Agencies","Architect of the Capitol","25144","17","0","0","25144","17","0.0","0.0","null","2022","3","2022","2","06","30"
"2022-06-30","Bureau","Other Agencies","Chemical Safety Board","34241","2","34241","2","0","0","100.0","100.0","null","2022","3","2022","2","06","30"
"2022-06-30","Bureau","Other Agencies","Comm. for Purchase from Blind/Handic.","0","0","0","0","0","0","0.0","0.0","null","2022","3","2022","2","06","30"
"2022-06-30","Bureau","Other Agencies","Commission On Fine Arts","0","0","0","0","0","0","0.0","0.0","null","2022","3","2022","2","06","30"
"2022-06-30","Bureau","Other Agencies","Consumer Financial Protection Bureau","3200494","15","211463","4","2989031","11","6.607198763690855","26.666666666666668","null","2022","3","2022","2","06","30"
"2022-06-30","Bureau","Other Agencies","Council of Insps. Gen. of Intg. & Effy.","3032","6","0","0","3032","6","0.0","0.0","null","2022","3","2022","2","06","30"
"2022-06-30","Bureau","Other Agencies","Defense Nuclear Facilities Safety Board","0","0","0","0","0","0","0.0","0.0","null","2022","3","2022","2","06","30"
"2022-06-30","Bureau","Other Agencies","Delta Regional Authority","0","0","0","0","0","0","0.0","0.0","null","2022","3","2022","2","06","30"
"2022-06-30","Bureau","Other Agencies","Denali Commission","0","0","0","0","0","0","0.0","0.0","null","2022","3","2022","2","06","30"
"2022-06-30","Bureau","Other Agencies","District of Columbia Government","0","0","0","0","0","0","0.0","0.0","null","2022","3","2022","2","06","30"
"2022-06-30","Bureau","Other Agencies","Election Assistance Commission","5576","1","0","0","5576","1","0.0","0.0","null","2022","3","2022","2","06","30"
"2022-06-30","Bureau","Other Agencies","Federal Housing Finance Agency","0","0","0","0","0","0","0.0","0.0","null","2022","3","2022","2","06","30"
"2022-06-30","Bureau","Other Agencies","Federal Housing Finance Agency OIG","0","0","0","0","0","0","0.0","0.0","null","2022","3","2022","2","06","30"
"2022-06-30","Bureau","Other Agencies","Federal Mine Safety & Health Review Comm","0","0","0","0","0","0","0.0","0.0","null","2022","3","2022","2","06","30"
"2022-06-30","Bureau","Other Agencies","Gulf Coast Ecosystem Restoration Council","0","0","0","0","0","0","0.0","0.0","null","2022","3","2022","2","06","30"
"2022-06-30","Bureau","Other Agencies","James Madison Memorial Fellowship","210758","24","0","0","210758","24","0.0","0.0","null","2022","3","2022","2","06","30"
"2022-06-30","Bureau","Other Agencies","John C. Stennis","2934","2","0","0","2934","2","0.0","0.0","null","2022","3","2022","2","06","30"
"2022-06-30","Bureau","Other Agencies","Millennium Challenge Corporation","0","0","0","0","0","0","0.0","0.0","null","2022","3","2022","2","06","30"
"2022-06-30","Bureau","Other Agencies","Morris K. Udall Scholarship","0","0","0","0","0","0","0.0","0.0","null","2022","3","2022","2","06","30"
"2022-06-30","Bureau","Other Agencies","National Capital Planning Commission","0","0","0","0","0","0","0.0","0.0","null","2022","3","2022","2","06","30"
"2022-06-30","Bureau","Other Agencies","National Council on Disability","137","2","0","0","137","2","0.0","0.0","null","2022","3","2022","2","06","30"
"2022-06-30","Bureau","Other Agencies","National Mediation Board","0","0","0","0","0","0","0.0","0.0","null","2022","3","2022","2","06","30"
"2022-06-30","Bureau","Other Agencies","National Transportation Safety Board","0","0","0","0","0","0","0.0","0.0","null","2022","3","2022","2","06","30"
"2022-06-30","Bureau","Other Agencies","Privacy & Civil Liberties Oversight Bd","0","0","0","0","0","0","0.0","0.0","null","2022","3","2022","2","06","30"
"2022-06-30","Bureau","Other Agencies","Surface Transportation Board","0","0","0","0","0","0","0.0","0.0","null","2022","3","2022","2","06","30"
"2022-06-30","Bureau","Other Agencies","U.S.  Agency of Global Media","4930","2","4930","2","0","0","100.0","100.0","null","2022","3","2022","2","06","30"
"2022-06-30","Bureau","Other Agencies","U.S. Holocaust Memorial Council","0","0","0","0","0","0","0.0","0.0","null","2022","3","2022","2","06","30"
"2022-06-30","Bureau","Other Agencies","U.S. Inst. for Env. Conflict Resolution","4178","1","0","0","4178","1","0.0","0.0","null","2022","3","2022","2","06","30"
"2022-06-30","Bureau","Other Agencies","U.S. Institute of Peace","0","0","0","0","0","0","0.0","0.0","null","2022","3","2022","2","06","30"
"2022-06-30","Agency","Other Agencies/Boards/Commissions","null","1024","1","0","0","1024","1","0.0","0.0","Non-CFO","2022","3","2022","2","06","30"
"2022-06-30","Bureau","Other Agencies/Boards/Commissions","Medicare Payment Advisory Commission","0","0","0","0","0","0","0.0","0.0","null","2022","3","2022","2","06","30"
"2022-06-30","Bureau","Other Agencies/Boards/Commissions","Nuclear Waste Technical Review Board","0","0","0","0","0","0","0.0","0.0","null","2022","3","2022","2","06","30"
"2022-06-30","Bureau","Other Agencies/Boards/Commissions","U.S. Comm. on Int. Religious Freedom","1024","1","0","0","1024","1","0.0","0.0","null","2022","3","2022","2","06","30"
"2022-06-30","Bureau","Other Agencies/Boards/Commissions","U.S.-China Security Review Commission","0","0","0","0","0","0","0.0","0.0","null","2022","3","2022","2","06","30"
"2022-06-30","Agency","Pension Benefit Guaranty Corp","null","3115924","1173","3115924","1173","0","0","100.0","100.0","Non-CFO","2022","3","2022","2","06","30"
"2022-06-30","Bureau","Pension Benefit Guaranty Corp","Pension Benefit Guaranty Corporation","3115924","1173","3115924","1173","0","0","100.0","100.0","null","2022","3","2022","2","06","30"
"2022-06-30","Agency","Presidio Trust Corporation","null","1660811","79","1501269","64","159542","15","90.39372932862318","81.0126582278481","Non-CFO","2022","3","2022","2","06","30"
"2022-06-30","Bureau","Presidio Trust Corporation","Presidio Trust Corporation","1660811","79","1501269","64","159542","15","90.39372932862318","81.0126582278481","null","2022","3","2022","2","06","30"
"2022-06-30","Agency","Railroad Retirement Board","null","21103690","3999","21103690","3999","0","0","100.0","100.0","Non-CFO","2022","3","2022","2","06","30"
"2022-06-30","Bureau","Railroad Retirement Board","Railroad Retirement Board","21103690","3999","21103690","3999","0","0","100.0","100.0","null","2022","3","2022","2","06","30"
"2022-06-30","Agency","Securities & Exchange Commission","null","2156970541","1169","2156970541","1169","0","0","100.0","100.0","Non-CFO","2022","3","2022","2","06","30"
"2022-06-30","Bureau","Securities & Exchange Commission","SEC Enforcement","2156723501","1122","2156723501","1122","0","0","100.0","100.0","null","2022","3","2022","2","06","30"
"2022-06-30","Bureau","Securities & Exchange Commission","Securities and Exchange Commission","247040","47","247040","47","0","0","100.0","100.0","null","2022","3","2022","2","06","30"
"2022-06-30","Agency","Selective Service System","null","0","0","0","0","0","0","0.0","0.0","Non-CFO","2022","3","2022","2","06","30"
"2022-06-30","Bureau","Selective Service System","Selective Service System","0","0","0","0","0","0","0.0","0.0","null","2022","3","2022","2","06","30"
"2022-06-30","Agency","Small Business Administration","null","13770704135","122724","13770704135","122724","0","0","100.0","100.0","CFO","2022","3","2022","2","06","30"
"2022-06-30","Bureau","Small Business Administration","Small Business Administration","13770704135","122724","13770704135","122724","0","0","100.0","100.0","null","2022","3","2022","2","06","30"
"2022-06-30","Agency","Smithsonian Institution","null","0","0","0","0","0","0","0.0","0.0","Non-CFO","2022","3","2022","2","06","30"
"2022-06-30","Bureau","Smithsonian Institution","Administrative Conference of the US","0","0","0","0","0","0","0.0","0.0","null","2022","3","2022","2","06","30"
"2022-06-30","Bureau","Smithsonian Institution","JFK Center for the Performing Arts","0","0","0","0","0","0","0.0","0.0","null","2022","3","2022","2","06","30"
"2022-06-30","Bureau","Smithsonian Institution","National Gallery of Art","0","0","0","0","0","0","0.0","0.0","null","2022","3","2022","2","06","30"
"2022-06-30","Bureau","Smithsonian Institution","Smithsonian Institution","0","0","0","0","0","0","0.0","0.0","null","2022","3","2022","2","06","30"
"2022-06-30","Agency","Social Security Administration","null","4366880734","1318821","2607163978","446018","1759716756","872803","59.703118468542996","33.81944934149517","CFO","2022","3","2022","2","06","30"
"2022-06-30","Bureau","Social Security Administration","Social Security Administration","4366880734","1318821","2607163978","446018","1759716756","872803","59.703118468542996","33.81944934149517","null","2022","3","2022","2","06","30"
"2022-06-30","Agency","Tennessee Valley Authority","null","0","0","0","0","0","0","0.0","0.0","Non-CFO","2022","3","2022","2","06","30"
"2022-06-30","Bureau","Tennessee Valley Authority","Tennessee Valley Authority","0","0","0","0","0","0","0.0","0.0","null","2022","3","2022","2","06","30"
"2022-06-30","Agency","The Judiciary","null","1011765","296","999799","169","11966","127","98.81731429729236","57.0945945945946","Non-CFO","2022","3","2022","2","06","30"
"2022-06-30","Bureau","The Judiciary","Administrative Office of the U.S. Courts","1011765","296","999799","169","11966","127","98.81731429729236","57.0945945945946","null","2022","3","2022","2","06","30"
"2022-06-30","Agency","U.S. Court of Appeals / Veterans Claims","null","337","1","0","0","337","1","0.0","0.0","Non-CFO","2022","3","2022","2","06","30"
"2022-06-30","Bureau","U.S. Court of Appeals / Veterans Claims","U.S. Court of Appeals / Veterans Claims","337","1","0","0","337","1","0.0","0.0","null","2022","3","2022","2","06","30"
"2022-06-30","Agency","U.S. Postal Service","null","71219464","64811","59276140","51063","11943324","13748","83.23025289828072","78.78755149588804","Non-CFO","2022","3","2022","2","06","30"
"2022-06-30","Bureau","U.S. Postal Service","U.S. Postal Service","71219464","64811","59276140","51063","11943324","13748","83.23025289828072","78.78755149588804","null","2022","3","2022","2","06","30"
"2022-06-30","Agency","U.S. Tax Court","null","0","0","0","0","0","0","0.0","0.0","Non-CFO","2022","3","2022","2","06","30"
"2022-06-30","Bureau","U.S. Tax Court","U.S. Tax Court","0","0","0","0","0","0","0.0","0.0","null","2022","3","2022","2","06","30"
"2022-06-30","Agency","US International Development Fin. Corp.","null","0","0","0","0","0","0","0.0","0.0","Non-CFO","2022","3","2022","2","06","30"
"2022-06-30","Bureau","US International Development Fin. Corp.","US International Development Fin. Corp.","0","0","0","0","0","0","0.0","0.0","null","2022","3","2022","2","06","30"
"2022-03-31","Agency","Agency for International Development","null","38827209","54","38827209","54","0","0","100.0","100.0","CFO","2022","2","2022","1","03","31"
"2022-03-31","Bureau","Agency for International Development","Agency for International Development","38827209","54","38827209","54","0","0","100.0","100.0","null","2022","2","2022","1","03","31"
"2022-03-31","Agency","American Battle Monuments Commission","null","0","0","0","0","0","0","0.0","0.0","Non-CFO","2022","2","2022","1","03","31"
"2022-03-31","Bureau","American Battle Monuments Commission","American Battle Monuments Commission","0","0","0","0","0","0","0.0","0.0","null","2022","2","2022","1","03","31"
"2022-03-31","Agency","Armed Forces Retirement Home","null","116574","123","77060","102","39514","21","66.10393398184844","82.92682926829268","Non-CFO","2022","2","2022","1","03","31"
"2022-03-31","Bureau","Armed Forces Retirement Home","Armed Forces Retirement Home","116574","123","77060","102","39514","21","66.10393398184844","82.92682926829268","null","2022","2","2022","1","03","31"
"2022-03-31","Agency","Commodity Futures Trading Commission","null","662771313","362","662771313","362","0","0","100.0","100.0","Non-CFO","2022","2","2022","1","03","31"
"2022-03-31","Bureau","Commodity Futures Trading Commission","Commodity Futures Trading Commission","662771313","362","662771313","362","0","0","100.0","100.0","null","2022","2","2022","1","03","31"
"2022-03-31","Agency","Consumer Product Safety Commission","null","2500","1","2500","1","0","0","100.0","100.0","Non-CFO","2022","2","2022","1","03","31"
"2022-03-31","Bureau","Consumer Product Safety Commission","Consumer Product Safety Commission","2500","1","2500","1","0","0","100.0","100.0","null","2022","2","2022","1","03","31"
"2022-03-31","Agency","Corp. for National and Community Service","null","3893732","387","3580608","151","313124","236","91.95825495950929","39.01808785529716","Non-CFO","2022","2","2022","1","03","31"
"2022-03-31","Bureau","Corp. for National and Community Service","Corp. for National and Community Service","3893732","387","3580608","151","313124","236","91.95825495950929","39.01808785529716","null","2022","2","2022","1","03","31"
"2022-03-31","Agency","Department of Agriculture","null","1802339471","60549","1779790122","54592","22549349","5957","98.74888447138713","90.16168722852565","CFO","2022","2","2022","1","03","31"
"2022-03-31","Bureau","Department of Agriculture","Agricultural Marketing Service","5649480","2474","4994780","526","654700","1948","88.41132281201102","21.26111560226354","null","2022","2","2022","1","03","31"
"2022-03-31","Bureau","Department of Agriculture","Commodity Credit Corporation","140519765","10506","140519765","10506","0","0","100.0","100.0","null","2022","2","2022","1","03","31"
"2022-03-31","Bureau","Department of Agriculture","Farm Service Agency","804274477","13423","804274477","13423","0","0","100.0","100.0","null","2022","2","2022","1","03","31"
"2022-03-31","Bureau","Department of Agriculture","Federal Crop Insurance Corporation","15939","413","7255","405","8684","8","45.51728464771943","98.06295399515739","null","2022","2","2022","1","03","31"
"2022-03-31","Bureau","Department of Agriculture","Food Safety and Inspection Service","1018755","1149","981102","1118","37653","31","96.30401813978827","97.30200174064404","null","2022","2","2022","1","03","31"
"2022-03-31","Bureau","Department of Agriculture","Food and Nutrition Service","10604544","366","48971","4","10555573","362","0.4617926051322905","1.092896174863388","null","2022","2","2022","1","03","31"
"2022-03-31","Bureau","Department of Agriculture","Forest Service","71676896","1165","65466891","352","6210005","813","91.33611338303488","30.21459227467811","null","2022","2","2022","1","03","31"
"2022-03-31","Bureau","Department of Agriculture","Rural Development","746762371","26729","746677900","26595","84471","134","99.98868836951614","99.49867185454","null","2022","2","2022","1","03","31"
"2022-03-31","Bureau","Department of Agriculture","U.S. Department of Agriculture","21817244","4324","16818981","1663","4998263","2661","77.09030984848499","38.45975948196115","null","2022","2","2022","1","03","31"
"2022-03-31","Agency","Department of Commerce","null","60792935","19666","60792935","19666","0","0","100.0","100.0","CFO","2022","2","2022","1","03","31"
"2022-03-31","Bureau","Department of Commerce","Bureau of Industry and Security","37054089","28","37054089","28","0","0","100.0","100.0","null","2022","2","2022","1","03","31"
"2022-03-31","Bureau","Department of Commerce","Bureau of the Census","4364808","17782","4364808","17782","0","0","100.0","100.0","null","2022","2","2022","1","03","31"
"2022-03-31","Bureau","Department of Commerce","Economic Development Administration","5120584","11","5120584","11","0","0","100.0","100.0","null","2022","2","2022","1","03","31"
"2022-03-31","Bureau","Department of Commerce","Economic and Statistical Analysis","0","0","0","0","0","0","0.0","0.0","null","2022","2","2022","1","03","31"
"2022-03-31","Bureau","Department of Commerce","General Administration","4660","1","4660","1","0","0","100.0","100.0","null","2022","2","2022","1","03","31"
"2022-03-31","Bureau","Department of Commerce","International Trade Administration","0","0","0","0","0","0","0.0","0.0","null","2022","2","2022","1","03","31"
"2022-03-31","Bureau","Department of Commerce","Minority Business Development Agency","0","0","0","0","0","0","0.0","0.0","null","2022","2","2022","1","03","31"
"2022-03-31","Bureau","Department of Commerce","NOAA","12654849","973","12654849","973","0","0","100.0","100.0","null","2022","2","2022","1","03","31"
"2022-03-31","Bureau","Department of Commerce","Nat'l Institute of Standards& Technology","673322","5","673322","5","0","0","100.0","100.0","null","2022","2","2022","1","03","31"
"2022-03-31","Bureau","Department of Commerce","Nat'l Telecomm & Information Admin.","296094","1","296094","1","0","0","100.0","100.0","null","2022","2","2022","1","03","31"
"2022-03-31","Bureau","Department of Commerce","National Technical Information Service","0","0","0","0","0","0","0.0","0.0","null","2022","2","2022","1","03","31"
"2022-03-31","Bureau","Department of Commerce","Office of the Inspector General","0","0","0","0","0","0","0.0","0.0","null","2022","2","2022","1","03","31"
"2022-03-31","Bureau","Department of Commerce","Patent and Trademark Office","624529","865","624529","865","0","0","100.0","100.0","null","2022","2","2022","1","03","31"
"2022-03-31","Agency","Department of Defense","null","2946184438","1506440","1027243100","273805","1918941338","1232635","34.86689722308553","18.175632617296408","CFO","2022","2","2022","1","03","31"
"2022-03-31","Bureau","Department of Defense","Consolidated Report","2946184438","1506440","1027243100","273805","1918941338","1232635","34.86689722308553","18.175632617296408","null","2022","2","2022","1","03","31"
"2022-03-31","Agency","Department of Education","null","127103691281","21654185","127001820048","21653918","101871233","267","99.91985186899507","99.99876698199448","CFO","2022","2","2022","1","03","31"
"2022-03-31","Bureau","Department of Education","Departmental Management","1388651896","2166","1286780663","1899","101871233","267","92.66401944983915","87.67313019390582","null","2022","2","2022","1","03","31"
"2022-03-31","Bureau","Department of Education","Federal Student Aid","125715039385","21652019","125715039385","21652019","0","0","100.0","100.0","null","2022","2","2022","1","03","31"
"2022-03-31","Bureau","Department of Education","Office of Postsecondary Education","0","0","0","0","0","0","0.0","0.0","null","2022","2","2022","1","03","31"
"2022-03-31","Agency","Department of Energy","null","13733445","103","13733445","103","0","0","100.0","100.0","CFO","2022","2","2022","1","03","31"
"2022-03-31","Bureau","Department of Energy","Bonneville Power Administration","1063505","28","1063505","28","0","0","100.0","100.0","null","2022","2","2022","1","03","31"
"2022-03-31","Bureau","Department of Energy","Energy Consolidated Reports","12669940","75","12669940","75","0","0","100.0","100.0","null","2022","2","2022","1","03","31"
"2022-03-31","Agency","Department of Health & Human Services","null","9494480605","1138783","9293271495","1110642","201209110","28141","97.88077812393404","97.528853170446","CFO","2022","2","2022","1","03","31"
"2022-03-31","Bureau","Department of Health & Human Services","Administration for Children and Families","34085876","1765","34085876","1765","0","0","100.0","100.0","null","2022","2","2022","1","03","31"
"2022-03-31","Bureau","Department of Health & Human Services","Administration for Community Living","0","0","0","0","0","0","0.0","0.0","null","2022","2","2022","1","03","31"
"2022-03-31","Bureau","Department of Health & Human Services","Centers for Disease Control","11993441","100","160609","17","11832832","83","1.339140285094161","17.0","null","2022","2","2022","1","03","31"
"2022-03-31","Bureau","Department of Health & Human Services","Centers for Medicare & Medicaid Services","9115989787","1112032","9033786741","1102300","82203046","9732","99.09825429908635","99.124845328192","null","2022","2","2022","1","03","31"
"2022-03-31","Bureau","Department of Health & Human Services","Food and Drug Administration","125611037","19134","35837783","1571","89773254","17563","28.530759601960774","8.210515313055295","null","2022","2","2022","1","03","31"
"2022-03-31","Bureau","Department of Health & Human Services","Health Resources and Services Admin","112301111","662","112301111","662","0","0","100.0","100.0","null","2022","2","2022","1","03","31"
"2022-03-31","Bureau","Department of Health & Human Services","Indian Health Services","63479122","3875","63479121","3875","1","0","99.9999984246789","100.0","null","2022","2","2022","1","03","31"
"2022-03-31","Bureau","Department of Health & Human Services","National Institutes of Health","23729579","865","6329602","102","17399977","763","26.673890843154023","11.791907514450868","null","2022","2","2022","1","03","31"
"2022-03-31","Bureau","Department of Health & Human Services","Office of the Inspector General","0","0","0","0","0","0","0.0","0.0","null","2022","2","2022","1","03","31"
"2022-03-31","Bureau","Department of Health & Human Services","Office of the Secretary","279897","8","279897","8","0","0","100.0","100.0","null","2022","2","2022","1","03","31"
"2022-03-31","Bureau","Department of Health & Human Services","Program Support Center","5985418","329","5985418","329","0","0","100.0","100.0","null","2022","2","2022","1","03","31"
"2022-03-31","Bureau","Department of Health & Human Services","Substance Abuse & Mental Health Admin.","1025337","13","1025337","13","0","0","100.0","100.0","null","2022","2","2022","1","03","31"
"2022-03-31","Agency","Department of Homeland Security","null","281004522","63207","276372010","49611","4632512","13596","98.35144574648517","78.48972423940387","CFO","2022","2","2022","1","03","31"
"2022-03-31","Bureau","Department of Homeland Security","Bureau of Customs & Border Protection","9483551","666","9483551","666","0","0","100.0","100.0","null","2022","2","2022","1","03","31"
"2022-03-31","Bureau","Department of Homeland Security","Citizenship and Immigration Services","1053467","1252","1053467","1252","0","0","100.0","100.0","null","2022","2","2022","1","03","31"
"2022-03-31","Bureau","Department of Homeland Security","Domestic Nuclear Detection Office","371","3","0","0","371","3","0.0","0.0","null","2022","2","2022","1","03","31"
"2022-03-31","Bureau","Department of Homeland Security","Emergency Preparedness & Resp","241402700","40044","241402700","40044","0","0","100.0","100.0","null","2022","2","2022","1","03","31"
"2022-03-31","Bureau","Department of Homeland Security","Federal Law Enforcement Training Ctr.","16318","2","16318","2","0","0","100.0","100.0","null","2022","2","2022","1","03","31"
"2022-03-31","Bureau","Department of Homeland Security","Immigration and Customs Enforcement","14685613","625","14685613","625","0","0","100.0","100.0","null","2022","2","2022","1","03","31"
"2022-03-31","Bureau","Department of Homeland Security","Info Analysis Infrastructure Prot-NPPD","0","0","0","0","0","0","0.0","0.0","null","2022","2","2022","1","03","31"
"2022-03-31","Bureau","Department of Homeland Security","Management Headquarters","0","0","0","0","0","0","0.0","0.0","null","2022","2","2022","1","03","31"
"2022-03-31","Bureau","Department of Homeland Security","Office of Biometric Identity Management","0","0","0","0","0","0","0.0","0.0","null","2022","2","2022","1","03","31"
"2022-03-31","Bureau","Department of Homeland Security","Office of Health Affairs","0","0","0","0","0","0","0.0","0.0","null","2022","2","2022","1","03","31"
"2022-03-31","Bureau","Department of Homeland Security","Office of the Inspector General DHS","100","1","100","1","0","0","100.0","100.0","null","2022","2","2022","1","03","31"
"2022-03-31","Bureau","Department of Homeland Security","Science and Technology","0","0","0","0","0","0","0.0","0.0","null","2022","2","2022","1","03","31"
"2022-03-31","Bureau","Department of Homeland Security","Transportation Safety Administration","9730261","7021","9730261","7021","0","0","100.0","100.0","null","2022","2","2022","1","03","31"
"2022-03-31","Bureau","Department of Homeland Security","U.S. Coast Guard","4632141","13593","0","0","4632141","13593","0.0","0.0","null","2022","2","2022","1","03","31"
"2022-03-31","Bureau","Department of Homeland Security","U.S. Secret Service","0","0","0","0","0","0","0.0","0.0","null","2022","2","2022","1","03","31"
"2022-03-31","Agency","Department of Housing and Urban Development","null","140478629","4487","138166525","4466","2312104","21","98.35412402836022","99.53198127925117","CFO","2022","2","2022","1","03","31"
"2022-03-31","Bureau","Department of Housing and Urban Development","Community Planning and Development","0","0","0","0","0","0","0.0","0.0","null","2022","2","2022","1","03","31"
"2022-03-31","Bureau","Department of Housing and Urban Development","Government National Mortgage Association","0","0","0","0","0","0","0.0","0.0","null","2022","2","2022","1","03","31"
"2022-03-31","Bureau","Department of Housing and Urban Development","Housing Programs","138161770","4464","138161770","4464","0","0","100.0","100.0","null","2022","2","2022","1","03","31"
"2022-03-31","Bureau","Department of Housing and Urban Development","Management and Administration","852222","13","4755","2","847467","11","0.557953209375022","15.384615384615385","null","2022","2","2022","1","03","31"
"2022-03-31","Bureau","Department of Housing and Urban Development","Policy, Development and Research","0","0","0","0","0","0","0.0","0.0","null","2022","2","2022","1","03","31"
"2022-03-31","Bureau","Department of Housing and Urban Development","Public and Indian Housing Programs","1464637","10","0","0","1464637","10","0.0","0.0","null","2022","2","2022","1","03","31"
"2022-03-31","Agency","Department of Justice","null","93034050","38568","89635826","38196","3398224","372","96.34733304634163","99.03546981953951","CFO","2022","2","2022","1","03","31"
"2022-03-31","Bureau","Department of Justice","Bureau of ATF and Explosives","20422","4","20422","4","0","0","100.0","100.0","null","2022","2","2022","1","03","31"
"2022-03-31","Bureau","Department of Justice","Drug Enforcement Administration","364925","23","364925","23","0","0","100.0","100.0","null","2022","2","2022","1","03","31"
"2022-03-31","Bureau","Department of Justice","Federal Bureau of Investigation","406152","86","406152","86","0","0","100.0","100.0","null","2022","2","2022","1","03","31"
"2022-03-31","Bureau","Department of Justice","Federal Prison Industries","132589","20","0","0","132589","20","0.0","0.0","null","2022","2","2022","1","03","31"
"2022-03-31","Bureau","Department of Justice","Federal Prison System","0","0","0","0","0","0","0.0","0.0","null","2022","2","2022","1","03","31"
"2022-03-31","Bureau","Department of Justice","General Administration","0","0","0","0","0","0","0.0","0.0","null","2022","2","2022","1","03","31"
"2022-03-31","Bureau","Department of Justice","Legal Activities","91172192","38432","87906557","38080","3265635","352","96.41816772377261","99.08409658617819","null","2022","2","2022","1","03","31"
"2022-03-31","Bureau","Department of Justice","Office of Justice Assistance Programs","937770","3","937770","3","0","0","100.0","100.0","null","2022","2","2022","1","03","31"
"2022-03-31","Bureau","Department of Justice","U.S. Marshals Service","0","0","0","0","0","0","0.0","0.0","null","2022","2","2022","1","03","31"
"2022-03-31","Agency","Department of Labor","null","185190467","31952","153649270","14031","31541197","17921","82.96823939646958","43.91274411617426","CFO","2022","2","2022","1","03","31"
"2022-03-31","Bureau","Department of Labor","Bureau of Labor Statistics","10260","1","10260","1","0","0","100.0","100.0","null","2022","2","2022","1","03","31"
"2022-03-31","Bureau","Department of Labor","Departmental Management","0","0","0","0","0","0","0.0","0.0","null","2022","2","2022","1","03","31"
"2022-03-31","Bureau","Department of Labor","Employee Benefit Security Administration","19896566","473","19896566","473","0","0","100.0","100.0","null","2022","2","2022","1","03","31"
"2022-03-31","Bureau","Department of Labor","Employment Standards Administration","86846303","20149","66439863","5292","20406440","14857","76.50281094867101","26.264330736016674","null","2022","2","2022","1","03","31"
"2022-03-31","Bureau","Department of Labor","Employment and Training Administration","925026","10","925026","10","0","0","100.0","100.0","null","2022","2","2022","1","03","31"
"2022-03-31","Bureau","Department of Labor","Mine Safety and Health Administration","18634964","6156","12908697","3847","5726267","2309","69.27138147409353","62.49187784275504","null","2022","2","2022","1","03","31"
"2022-03-31","Bureau","Department of Labor","Occupational Safety and Health Admin","58877348","5163","53468858","4408","5408490","755","90.81397144450189","85.37671896184389","null","2022","2","2022","1","03","31"
"2022-03-31","Agency","Department of State","null","20029667","21365","19993409","21329","36258","36","99.818978518215","99.8315001170138","CFO","2022","2","2022","1","03","31"
"2022-03-31","Bureau","Department of State","Civil Monetary Penalties","0","0","0","0","0","0","0.0","0.0","null","2022","2","2022","1","03","31"
"2022-03-31","Bureau","Department of State","Department of State","18005029","8300","17968771","8264","36258","36","99.79862292918273","99.56626506024097","null","2022","2","2022","1","03","31"
"2022-03-31","Bureau","Department of State","International Commissions","0","0","0","0","0","0","0.0","0.0","null","2022","2","2022","1","03","31"
"2022-03-31","Bureau","Department of State","Passport NSF","2024638","13065","2024638","13065","0","0","100.0","100.0","null","2022","2","2022","1","03","31"
"2022-03-31","Agency","Department of Transportation","null","69929025","7659","69912119","7649","16906","10","99.975824058751","99.86943465204335","CFO","2022","2","2022","1","03","31"
"2022-03-31","Bureau","Department of Transportation","Federal Aviation Administration","2348319","359","2331413","349","16906","10","99.28008077267185","97.21448467966574","null","2022","2","2022","1","03","31"
"2022-03-31","Bureau","Department of Transportation","Federal Highway Administration","5719","6","5719","6","0","0","100.0","100.0","null","2022","2","2022","1","03","31"
"2022-03-31","Bureau","Department of Transportation","Federal Motor Carrier Safety Admin","65052651","7211","65052651","7211","0","0","100.0","100.0","null","2022","2","2022","1","03","31"
"2022-03-31","Bureau","Department of Transportation","Federal Railroad Administration","132114","13","132114","13","0","0","100.0","100.0","null","2022","2","2022","1","03","31"
"2022-03-31","Bureau","Department of Transportation","Federal Transit Administration","783404","1","783404","1","0","0","100.0","100.0","null","2022","2","2022","1","03","31"
"2022-03-31","Bureau","Department of Transportation","Maritime Administration","5622","7","5622","7","0","0","100.0","100.0","null","2022","2","2022","1","03","31"
"2022-03-31","Bureau","Department of Transportation","National Highway Traffic Safety Admin.","38855","7","38855","7","0","0","100.0","100.0","null","2022","2","2022","1","03","31"
"2022-03-31","Bureau","Department of Transportation","Office of the Inspector General","0","0","0","0","0","0","0.0","0.0","null","2022","2","2022","1","03","31"
"2022-03-31","Bureau","Department of Transportation","Office of the Secretary","1081949","15","1081949","15","0","0","100.0","100.0","null","2022","2","2022","1","03","31"
"2022-03-31","Bureau","Department of Transportation","Pipeline Hazardous Material Safety Admin","476876","38","476876","38","0","0","100.0","100.0","null","2022","2","2022","1","03","31"
"2022-03-31","Bureau","Department of Transportation","Research Innovative Technology Admin","131","1","131","1","0","0","100.0","100.0","null","2022","2","2022","1","03","31"
"2022-03-31","Bureau","Department of Transportation","St. Lawrence Seaway Development Corp.","3385","1","3385","1","0","0","100.0","100.0","null","2022","2","2022","1","03","31"
"2022-03-31","Agency","Department of Veterans Affairs","null","245766062","3337260","241107998","3332579","4658064","4681","98.10467565696683","99.85973523189682","CFO","2022","2","2022","1","03","31"
"2022-03-31","Bureau","Department of Veterans Affairs","Administration and Cemeteries","1859493","906","35604","30","1823889","876","1.914715462763237","3.3112582781456954","null","2022","2","2022","1","03","31"
"2022-03-31","Bureau","Department of Veterans Affairs","Housing Credit Assistance","909154","28","0","0","909154","28","0.0","0.0","null","2022","2","2022","1","03","31"
"2022-03-31","Bureau","Department of Veterans Affairs","Life Insurance","1076110","198","1076110","198","0","0","100.0","100.0","null","2022","2","2022","1","03","31"
"2022-03-31","Bureau","Department of Veterans Affairs","Medical and Construction","240658698","3334473","239996284","3332351","662414","2122","99.72474961200031","99.93636175791497","null","2022","2","2022","1","03","31"
"2022-03-31","Bureau","Department of Veterans Affairs","Veterans Benefits","1262607","1655","0","0","1262607","1655","0.0","0.0","null","2022","2","2022","1","03","31"
"2022-03-31","Agency","Department of the Interior","null","48475873","32779","48465038","32761","10835","18","99.97764867483666","99.9450867933738","CFO","2022","2","2022","1","03","31"
"2022-03-31","Bureau","Department of the Interior","Bureau of Indian Affairs","16814345","28777","16803510","28759","10835","18","99.93556097486997","99.93745004691246","null","2022","2","2022","1","03","31"
"2022-03-31","Bureau","Department of the Interior","Bureau of Land Management","9049748","380","9049748","380","0","0","100.0","100.0","null","2022","2","2022","1","03","31"
"2022-03-31","Bureau","Department of the Interior","Bureau of Ocean Energy Mgmt., Reg & Enf","2656","2","2656","2","0","0","100.0","100.0","null","2022","2","2022","1","03","31"
"2022-03-31","Bureau","Department of the Interior","Bureau of Reclamation","77076","58","77076","58","0","0","100.0","100.0","null","2022","2","2022","1","03","31"
"2022-03-31","Bureau","Department of the Interior","Bureau of Safety and Environmental Enf.","0","0","0","0","0","0","0.0","0.0","null","2022","2","2022","1","03","31"
"2022-03-31","Bureau","Department of the Interior","Fish and Wildlife Service","752603","65","752603","65","0","0","100.0","100.0","null","2022","2","2022","1","03","31"
"2022-03-31","Bureau","Department of the Interior","Geological Survey","139195","391","139195","391","0","0","100.0","100.0","null","2022","2","2022","1","03","31"
"2022-03-31","Bureau","Department of the Interior","National Park Service","8308465","2194","8308465","2194","0","0","100.0","100.0","null","2022","2","2022","1","03","31"
"2022-03-31","Bureau","Department of the Interior","Office of Natural Resources Revenue","5558073","522","5558073","522","0","0","100.0","100.0","null","2022","2","2022","1","03","31"
"2022-03-31","Bureau","Department of the Interior","Office of Surface Mining","7742208","370","7742208","370","0","0","100.0","100.0","null","2022","2","2022","1","03","31"
"2022-03-31","Bureau","Department of the Interior","Office of the Secretary","31504","20","31504","20","0","0","100.0","100.0","null","2022","2","2022","1","03","31"
"2022-03-31","Agency","Department of the Treasury","null","44553788","5011","43964192","4983","589596","28","98.67666470918253","99.44122929554979","CFO","2022","2","2022","1","03","31"
"2022-03-31","Bureau","Department of the Treasury","Bureau of Engraving and Printing","38345","2","0","0","38345","2","0.0","0.0","null","2022","2","2022","1","03","31"
"2022-03-31","Bureau","Department of the Treasury","Bureau of the Fiscal Service","13731644","3533","13731644","3533","0","0","100.0","100.0","null","2022","2","2022","1","03","31"
"2022-03-31","Bureau","Department of the Treasury","Community Dev Financial Inst Fund","4736083","10","4736083","10","0","0","100.0","100.0","null","2022","2","2022","1","03","31"
"2022-03-31","Bureau","Department of the Treasury","Comptroller of the Currency","1460025","23","1420025","21","40000","2","97.26032088491635","91.30434782608695","null","2022","2","2022","1","03","31"
"2022-03-31","Bureau","Department of the Treasury","D.C. Pension Program","477970","22","477970","22","0","0","100.0","100.0","null","2022","2","2022","1","03","31"
"2022-03-31","Bureau","Department of the Treasury","Departmental Offices","22319866","1324","21809615","1301","510251","23","97.7139154867686","98.26283987915407","null","2022","2","2022","1","03","31"
"2022-03-31","Bureau","Department of the Treasury","Financial Crimes Enforcement Network","1544945","3","1544945","3","0","0","100.0","100.0","null","2022","2","2022","1","03","31"
"2022-03-31","Bureau","Department of the Treasury","Interest on Tax/Deposit of Earnings","0","0","0","0","0","0","0.0","0.0","null","2022","2","2022","1","03","31"
"2022-03-31","Bureau","Department of the Treasury","Internal Revenue Service","209894","68","209894","68","0","0","100.0","100.0","null","2022","2","2022","1","03","31"
"2022-03-31","Bureau","Department of the Treasury","International Monetary Funds","0","0","0","0","0","0","0.0","0.0","null","2022","2","2022","1","03","31"
"2022-03-31","Bureau","Department of the Treasury","Office of Financial Research","268","1","268","1","0","0","100.0","100.0","null","2022","2","2022","1","03","31"
"2022-03-31","Bureau","Department of the Treasury","Office of Sec International Affairs","0","0","0","0","0","0","0.0","0.0","null","2022","2","2022","1","03","31"
"2022-03-31","Bureau","Department of the Treasury","Office of the Secretary","0","0","0","0","0","0","0.0","0.0","null","2022","2","2022","1","03","31"
"2022-03-31","Bureau","Department of the Treasury","Pandemic Receivables","0","0","0","0","0","0","0.0","0.0","null","2022","2","2022","1","03","31"
"2022-03-31","Bureau","Department of the Treasury","Spec Insp Gen-Troubled Asset Rel Prog","3916","1","3916","1","0","0","100.0","100.0","null","2022","2","2022","1","03","31"
"2022-03-31","Bureau","Department of the Treasury","Tobacco Tax and Trade","1000","1","1000","1","0","0","100.0","100.0","null","2022","2","2022","1","03","31"
"2022-03-31","Bureau","Department of the Treasury","Treasury Forfeiture Fund","0","0","0","0","0","0","0.0","0.0","null","2022","2","2022","1","03","31"
"2022-03-31","Bureau","Department of the Treasury","Treasury Franchise Fund","0","0","0","0","0","0","0.0","0.0","null","2022","2","2022","1","03","31"
"2022-03-31","Bureau","Department of the Treasury","Treasury IG for Tax Admin","185","1","185","1","0","0","100.0","100.0","null","2022","2","2022","1","03","31"
"2022-03-31","Bureau","Department of the Treasury","U.S. Mint","29647","22","28647","21","1000","1","96.62697743447903","95.45454545454545","null","2022","2","2022","1","03","31"
"2022-03-31","Bureau","Department of the Treasury","U.S. Treasury IG Office","0","0","0","0","0","0","0.0","0.0","null","2022","2","2022","1","03","31"
"2022-03-31","Agency","Environmental Protection Agency","null","26017987","290","26001841","288","16146","2","99.93794293155732","99.3103448275862","CFO","2022","2","2022","1","03","31"
"2022-03-31","Bureau","Environmental Protection Agency","Environmental Protection Agency","26017987","290","26001841","288","16146","2","99.93794293155732","99.3103448275862","null","2022","2","2022","1","03","31"
"2022-03-31","Agency","Equal Employment Opportunity Commission","null","15976","18","15976","18","0","0","100.0","100.0","Non-CFO","2022","2","2022","1","03","31"
"2022-03-31","Bureau","Equal Employment Opportunity Commission","Equal Employment Opportunity Commission","15976","18","15976","18","0","0","100.0","100.0","null","2022","2","2022","1","03","31"
"2022-03-31","Agency","Export - Import  Bank","null","0","0","0","0","0","0","0.0","0.0","Non-CFO","2022","2","2022","1","03","31"
"2022-03-31","Bureau","Export - Import  Bank","Export-Import Bank","0","0","0","0","0","0","0.0","0.0","null","2022","2","2022","1","03","31"
"2022-03-31","Agency","Farm Credit Administration","null","630","1","630","1","0","0","100.0","100.0","Non-CFO","2022","2","2022","1","03","31"
"2022-03-31","Bureau","Farm Credit Administration","Farm Credit Administration","630","1","630","1","0","0","100.0","100.0","null","2022","2","2022","1","03","31"
"2022-03-31","Bureau","Farm Credit Administration","Farm Credit System Insurance Corporation","0","0","0","0","0","0","0.0","0.0","null","2022","2","2022","1","03","31"
"2022-03-31","Agency","Federal Communications Commission","null","224360279","13425","224360279","13425","0","0","100.0","100.0","Non-CFO","2022","2","2022","1","03","31"
"2022-03-31","Bureau","Federal Communications Commission","Federal Communications Commission","224360279","13425","224360279","13425","0","0","100.0","100.0","null","2022","2","2022","1","03","31"
"2022-03-31","Agency","Federal Deposit Insurance Corporation","null","0","0","0","0","0","0","0.0","0.0","Non-CFO","2022","2","2022","1","03","31"
"2022-03-31","Bureau","Federal Deposit Insurance Corporation","Federal Deposit Insurance Corporation","0","0","0","0","0","0","0.0","0.0","null","2022","2","2022","1","03","31"
"2022-03-31","Agency","Federal Election Commission","null","1357375","209","1357375","209","0","0","100.0","100.0","Non-CFO","2022","2","2022","1","03","31"
"2022-03-31","Bureau","Federal Election Commission","Federal Election Commission","1357375","209","1357375","209","0","0","100.0","100.0","null","2022","2","2022","1","03","31"
"2022-03-31","Agency","Federal Labor Relations Authority","null","0","0","0","0","0","0","0.0","0.0","Non-CFO","2022","2","2022","1","03","31"
"2022-03-31","Bureau","Federal Labor Relations Authority","Federal Labor Relations Authority","0","0","0","0","0","0","0.0","0.0","null","2022","2","2022","1","03","31"
"2022-03-31","Agency","Federal Maritime Commission","null","397583","6","397583","6","0","0","100.0","100.0","Non-CFO","2022","2","2022","1","03","31"
"2022-03-31","Bureau","Federal Maritime Commission","Salaries and Expenses","397583","6","397583","6","0","0","100.0","100.0","null","2022","2","2022","1","03","31"
"2022-03-31","Agency","Federal Mediation/Conciliation Service","null","0","0","0","0","0","0","0.0","0.0","Non-CFO","2022","2","2022","1","03","31"
"2022-03-31","Bureau","Federal Mediation/Conciliation Service","Federal Mediation/Conciliation Service","0","0","0","0","0","0","0.0","0.0","null","2022","2","2022","1","03","31"
"2022-03-31","Agency","Federal Trade Commission","null","482197221","73","482197221","73","0","0","100.0","100.0","Non-CFO","2022","2","2022","1","03","31"
"2022-03-31","Bureau","Federal Trade Commission","Federal Trade Commission","482197221","73","482197221","73","0","0","100.0","100.0","null","2022","2","2022","1","03","31"
"2022-03-31","Agency","Funds Appropriated to the President","null","1236060","7","0","0","1236060","7","0.0","0.0","Non-CFO","2022","2","2022","1","03","31"
"2022-03-31","Bureau","Funds Appropriated to the President","African Development Foundation","0","0","0","0","0","0","0.0","0.0","null","2022","2","2022","1","03","31"
"2022-03-31","Bureau","Funds Appropriated to the President","Defense Security Assistance Agency","0","0","0","0","0","0","0.0","0.0","null","2022","2","2022","1","03","31"
"2022-03-31","Bureau","Funds Appropriated to the President","Executive Branch","0","0","0","0","0","0","0.0","0.0","null","2022","2","2022","1","03","31"
"2022-03-31","Bureau","Funds Appropriated to the President","Inter-American Foundation","0","0","0","0","0","0","0.0","0.0","null","2022","2","2022","1","03","31"
"2022-03-31","Bureau","Funds Appropriated to the President","Peace Corps","0","0","0","0","0","0","0.0","0.0","null","2022","2","2022","1","03","31"
"2022-03-31","Bureau","Funds Appropriated to the President","Trade and Development Agency","1236060","7","0","0","1236060","7","0.0","0.0","null","2022","2","2022","1","03","31"
"2022-03-31","Agency","General Services Administration","null","15381450","1932","13983082","1450","1398368","482","90.90873747273501","75.05175983436853","CFO","2022","2","2022","1","03","31"
"2022-03-31","Bureau","General Services Administration","General Services Administration","15381450","1932","13983082","1450","1398368","482","90.90873747273501","75.05175983436853","null","2022","2","2022","1","03","31"
"2022-03-31","Agency","Legis Branch-Library of Congress","null","0","0","0","0","0","0","0.0","0.0","Non-CFO","2022","2","2022","1","03","31"
"2022-03-31","Bureau","Legis Branch-Library of Congress","Library of Congress","0","0","0","0","0","0","0.0","0.0","null","2022","2","2022","1","03","31"
"2022-03-31","Agency","Legislative Branch - U.S. House/Senate","null","276073","203","0","0","276073","203","0.0","0.0","Non-CFO","2022","2","2022","1","03","31"
"2022-03-31","Bureau","Legislative Branch - U.S. House/Senate","U.S. House of Representatives","276073","203","0","0","276073","203","0.0","0.0","null","2022","2","2022","1","03","31"
"2022-03-31","Agency","Legislative Branch-CBO","null","0","0","0","0","0","0","0.0","0.0","Non-CFO","2022","2","2022","1","03","31"
"2022-03-31","Bureau","Legislative Branch-CBO","Congressional Budget Office","0","0","0","0","0","0","0.0","0.0","null","2022","2","2022","1","03","31"
"2022-03-31","Agency","Legislative Branch-GAO","null","0","0","0","0","0","0","0.0","0.0","Non-CFO","2022","2","2022","1","03","31"
"2022-03-31","Bureau","Legislative Branch-GAO","Government Accountability Office","0","0","0","0","0","0","0.0","0.0","null","2022","2","2022","1","03","31"
"2022-03-31","Agency","Legislative Branch-GPO","null","75651","9","75651","9","0","0","100.0","100.0","Non-CFO","2022","2","2022","1","03","31"
"2022-03-31","Bureau","Legislative Branch-GPO","Government Publishing Office","75651","9","75651","9","0","0","100.0","100.0","null","2022","2","2022","1","03","31"
"2022-03-31","Agency","Legislative Branch-Office of Tech.","null","0","0","0","0","0","0","0.0","0.0","Non-CFO","2022","2","2022","1","03","31"
"2022-03-31","Bureau","Legislative Branch-Office of Tech.","Medicaid & CHIP Payment & Access Comm.","0","0","0","0","0","0","0.0","0.0","null","2022","2","2022","1","03","31"
"2022-03-31","Bureau","Legislative Branch-Office of Tech.","Open World Leadership","0","0","0","0","0","0","0.0","0.0","null","2022","2","2022","1","03","31"
"2022-03-31","Agency","Merit Systems Protection Board","null","144","1","144","1","0","0","100.0","100.0","Non-CFO","2022","2","2022","1","03","31"
"2022-03-31","Bureau","Merit Systems Protection Board","Merit Systems Protection Board","144","1","144","1","0","0","100.0","100.0","null","2022","2","2022","1","03","31"
"2022-03-31","Agency","National Aeronautics and Space Administration","null","1558415","128","1558415","128","0","0","100.0","100.0","CFO","2022","2","2022","1","03","31"
"2022-03-31","Bureau","National Aeronautics and Space Administration","National Aeronautics and Space Admin","1558415","128","1558415","128","0","0","100.0","100.0","null","2022","2","2022","1","03","31"
"2022-03-31","Agency","National Archives & Records Admin","null","118077","100","118077","100","0","0","100.0","100.0","Non-CFO","2022","2","2022","1","03","31"
"2022-03-31","Bureau","National Archives & Records Admin","Nat'l Archives & Records Administration","118077","100","118077","100","0","0","100.0","100.0","null","2022","2","2022","1","03","31"
"2022-03-31","Agency","National Credit Union Administration","null","4885","10","0","0","4885","10","0.0","0.0","Non-CFO","2022","2","2022","1","03","31"
"2022-03-31","Bureau","National Credit Union Administration","National Credit Union Administration","4885","10","0","0","4885","10","0.0","0.0","null","2022","2","2022","1","03","31"
"2022-03-31","Agency","National Foundation  Arts & Humanities","null","0","0","0","0","0","0","0.0","0.0","Non-CFO","2022","2","2022","1","03","31"
"2022-03-31","Bureau","National Foundation  Arts & Humanities","National Endowment for the Arts","0","0","0","0","0","0","0.0","0.0","null","2022","2","2022","1","03","31"
"2022-03-31","Bureau","National Foundation  Arts & Humanities","National Endowment for the Humanities","0","0","0","0","0","0","0.0","0.0","null","2022","2","2022","1","03","31"
"2022-03-31","Agency","National Labor Relations Board","null","0","0","0","0","0","0","0.0","0.0","Non-CFO","2022","2","2022","1","03","31"
"2022-03-31","Bureau","National Labor Relations Board","National Labor Relations Board","0","0","0","0","0","0","0.0","0.0","null","2022","2","2022","1","03","31"
"2022-03-31","Agency","National Science Foundation","null","561973","58","561973","58","0","0","100.0","100.0","CFO","2022","2","2022","1","03","31"
"2022-03-31","Bureau","National Science Foundation","National Science Foundation","561973","58","561973","58","0","0","100.0","100.0","null","2022","2","2022","1","03","31"
"2022-03-31","Agency","Neighborhood Reinvestment Corporation","null","0","0","0","0","0","0","0.0","0.0","Non-CFO","2022","2","2022","1","03","31"
"2022-03-31","Bureau","Neighborhood Reinvestment Corporation","Neighborhood Reinvestment Corporation","0","0","0","0","0","0","0.0","0.0","null","2022","2","2022","1","03","31"
"2022-03-31","Agency","Nuclear Regulatory Commission","null","2780487","353","2780487","353","0","0","100.0","100.0","CFO","2022","2","2022","1","03","31"
"2022-03-31","Bureau","Nuclear Regulatory Commission","Nuclear Regulatory Commission","2780487","353","2780487","353","0","0","100.0","100.0","null","2022","2","2022","1","03","31"
"2022-03-31","Agency","Occupational Safety & Health Rev Comm","null","0","0","0","0","0","0","0.0","0.0","Non-CFO","2022","2","2022","1","03","31"
"2022-03-31","Bureau","Occupational Safety & Health Rev Comm","Occupational Safety & Health Rev Comm","0","0","0","0","0","0","0.0","0.0","null","2022","2","2022","1","03","31"
"2022-03-31","Agency","Office of Compliance","null","0","0","0","0","0","0","0.0","0.0","Non-CFO","2022","2","2022","1","03","31"
"2022-03-31","Bureau","Office of Compliance","Office of Compliance","0","0","0","0","0","0","0.0","0.0","null","2022","2","2022","1","03","31"
"2022-03-31","Agency","Office of Government Ethics","null","0","0","0","0","0","0","0.0","0.0","Non-CFO","2022","2","2022","1","03","31"
"2022-03-31","Bureau","Office of Government Ethics","Office of Government Ethics","0","0","0","0","0","0","0.0","0.0","null","2022","2","2022","1","03","31"
"2022-03-31","Agency","Office of Personnel Management","null","12101605","750","11297986","658","803619","92","93.3594015008753","87.73333333333333","CFO","2022","2","2022","1","03","31"
"2022-03-31","Bureau","Office of Personnel Management","Office of Personnel Management","12101605","750","11297986","658","803619","92","93.3594015008753","87.73333333333333","null","2022","2","2022","1","03","31"
"2022-03-31","Agency","Office of Special Counsel","null","0","0","0","0","0","0","0.0","0.0","Non-CFO","2022","2","2022","1","03","31"
"2022-03-31","Bureau","Office of Special Counsel","Office of Special Counsel","0","0","0","0","0","0","0.0","0.0","null","2022","2","2022","1","03","31"
"2022-03-31","Agency","Other Agencies","null","933692","73","59711","5","873981","68","6.395149578233507","6.8493150684931505","Non-CFO","2022","2","2022","1","03","31"
"2022-03-31","Bureau","Other Agencies","Advisory Council on Hist. Preservation","0","0","0","0","0","0","0.0","0.0","null","2022","2","2022","1","03","31"
"2022-03-31","Bureau","Other Agencies","Archit.&Trans. Barriers Compliance Bd","0","0","0","0","0","0","0.0","0.0","null","2022","2","2022","1","03","31"
"2022-03-31","Bureau","Other Agencies","Architect of the Capitol","38896","17","0","0","38896","17","0.0","0.0","null","2022","2","2022","1","03","31"
"2022-03-31","Bureau","Other Agencies","Chemical Safety Board","33630","2","33630","2","0","0","100.0","100.0","null","2022","2","2022","1","03","31"
"2022-03-31","Bureau","Other Agencies","Comm. for Purchase from Blind/Handic.","0","0","0","0","0","0","0.0","0.0","null","2022","2","2022","1","03","31"
"2022-03-31","Bureau","Other Agencies","Commission On Fine Arts","0","0","0","0","0","0","0.0","0.0","null","2022","2","2022","1","03","31"
"2022-03-31","Bureau","Other Agencies","Consumer Financial Protection Bureau","645558","16","21151","1","624407","15","3.276390347575276","6.25","null","2022","2","2022","1","03","31"
"2022-03-31","Bureau","Other Agencies","Council of Insps. Gen. of Intg. & Effy.","3032","6","0","0","3032","6","0.0","0.0","null","2022","2","2022","1","03","31"
"2022-03-31","Bureau","Other Agencies","Defense Nuclear Facilities Safety Board","0","0","0","0","0","0","0.0","0.0","null","2022","2","2022","1","03","31"
"2022-03-31","Bureau","Other Agencies","Delta Regional Authority","0","0","0","0","0","0","0.0","0.0","null","2022","2","2022","1","03","31"
"2022-03-31","Bureau","Other Agencies","Denali Commission","0","0","0","0","0","0","0.0","0.0","null","2022","2","2022","1","03","31"
"2022-03-31","Bureau","Other Agencies","District of Columbia Government","0","0","0","0","0","0","0.0","0.0","null","2022","2","2022","1","03","31"
"2022-03-31","Bureau","Other Agencies","Election Assistance Commission","5576","1","0","0","5576","1","0.0","0.0","null","2022","2","2022","1","03","31"
"2022-03-31","Bureau","Other Agencies","Federal Housing Finance Agency","0","0","0","0","0","0","0.0","0.0","null","2022","2","2022","1","03","31"
"2022-03-31","Bureau","Other Agencies","Federal Housing Finance Agency OIG","0","0","0","0","0","0","0.0","0.0","null","2022","2","2022","1","03","31"
"2022-03-31","Bureau","Other Agencies","Federal Mine Safety & Health Review Comm","0","0","0","0","0","0","0.0","0.0","null","2022","2","2022","1","03","31"
"2022-03-31","Bureau","Other Agencies","Gulf Coast Ecosystem Restoration Council","0","0","0","0","0","0","0.0","0.0","null","2022","2","2022","1","03","31"
"2022-03-31","Bureau","Other Agencies","James Madison Memorial Fellowship","193379","24","0","0","193379","24","0.0","0.0","null","2022","2","2022","1","03","31"
"2022-03-31","Bureau","Other Agencies","John C. Stennis","2934","2","0","0","2934","2","0.0","0.0","null","2022","2","2022","1","03","31"
"2022-03-31","Bureau","Other Agencies","Millennium Challenge Corporation","0","0","0","0","0","0","0.0","0.0","null","2022","2","2022","1","03","31"
"2022-03-31","Bureau","Other Agencies","Morris K. Udall Scholarship","0","0","0","0","0","0","0.0","0.0","null","2022","2","2022","1","03","31"
"2022-03-31","Bureau","Other Agencies","National Capital Planning Commission","0","0","0","0","0","0","0.0","0.0","null","2022","2","2022","1","03","31"
"2022-03-31","Bureau","Other Agencies","National Council on Disability","1579","2","0","0","1579","2","0.0","0.0","null","2022","2","2022","1","03","31"
"2022-03-31","Bureau","Other Agencies","National Mediation Board","0","0","0","0","0","0","0.0","0.0","null","2022","2","2022","1","03","31"
"2022-03-31","Bureau","Other Agencies","National Transportation Safety Board","0","0","0","0","0","0","0.0","0.0","null","2022","2","2022","1","03","31"
"2022-03-31","Bureau","Other Agencies","Privacy & Civil Liberties Oversight Bd","0","0","0","0","0","0","0.0","0.0","null","2022","2","2022","1","03","31"
"2022-03-31","Bureau","Other Agencies","Surface Transportation Board","0","0","0","0","0","0","0.0","0.0","null","2022","2","2022","1","03","31"
"2022-03-31","Bureau","Other Agencies","U.S.  Agency of Global Media","4930","2","4930","2","0","0","100.0","100.0","null","2022","2","2022","1","03","31"
"2022-03-31","Bureau","Other Agencies","U.S. Holocaust Memorial Council","0","0","0","0","0","0","0.0","0.0","null","2022","2","2022","1","03","31"
"2022-03-31","Bureau","Other Agencies","U.S. Inst. for Env. Conflict Resolution","4178","1","0","0","4178","1","0.0","0.0","null","2022","2","2022","1","03","31"
"2022-03-31","Bureau","Other Agencies","U.S. Institute of Peace","0","0","0","0","0","0","0.0","0.0","null","2022","2","2022","1","03","31"
"2022-03-31","Agency","Other Agencies/Boards/Commissions","null","1024","1","0","0","1024","1","0.0","0.0","Non-CFO","2022","2","2022","1","03","31"
"2022-03-31","Bureau","Other Agencies/Boards/Commissions","Medicare Payment Advisory Commission","0","0","0","0","0","0","0.0","0.0","null","2022","2","2022","1","03","31"
"2022-03-31","Bureau","Other Agencies/Boards/Commissions","Nuclear Waste Technical Review Board","0","0","0","0","0","0","0.0","0.0","null","2022","2","2022","1","03","31"
"2022-03-31","Bureau","Other Agencies/Boards/Commissions","U.S. Comm. on Int. Religious Freedom","1024","1","0","0","1024","1","0.0","0.0","null","2022","2","2022","1","03","31"
"2022-03-31","Bureau","Other Agencies/Boards/Commissions","U.S.-China Security Review Commission","0","0","0","0","0","0","0.0","0.0","null","2022","2","2022","1","03","31"
"2022-03-31","Agency","Pension Benefit Guaranty Corp","null","3066618","893","3066618","893","0","0","100.0","100.0","Non-CFO","2022","2","2022","1","03","31"
"2022-03-31","Bureau","Pension Benefit Guaranty Corp","Pension Benefit Guaranty Corporation","3066618","893","3066618","893","0","0","100.0","100.0","null","2022","2","2022","1","03","31"
"2022-03-31","Agency","Presidio Trust Corporation","null","1650426","81","1485087","66","165339","15","89.98204100032355","81.48148148148148","Non-CFO","2022","2","2022","1","03","31"
"2022-03-31","Bureau","Presidio Trust Corporation","Presidio Trust Corporation","1650426","81","1485087","66","165339","15","89.98204100032355","81.48148148148148","null","2022","2","2022","1","03","31"
"2022-03-31","Agency","Railroad Retirement Board","null","21404640","4106","21404640","4106","0","0","100.0","100.0","Non-CFO","2022","2","2022","1","03","31"
"2022-03-31","Bureau","Railroad Retirement Board","Railroad Retirement Board","21404640","4106","21404640","4106","0","0","100.0","100.0","null","2022","2","2022","1","03","31"
"2022-03-31","Agency","Securities & Exchange Commission","null","2139047801","1183","2139047801","1183","0","0","100.0","100.0","Non-CFO","2022","2","2022","1","03","31"
"2022-03-31","Bureau","Securities & Exchange Commission","SEC Enforcement","2138806537","1135","2138806537","1135","0","0","100.0","100.0","null","2022","2","2022","1","03","31"
"2022-03-31","Bureau","Securities & Exchange Commission","Securities and Exchange Commission","241264","48","241264","48","0","0","100.0","100.0","null","2022","2","2022","1","03","31"
"2022-03-31","Agency","Selective Service System","null","0","0","0","0","0","0","0.0","0.0","Non-CFO","2022","2","2022","1","03","31"
"2022-03-31","Bureau","Selective Service System","Selective Service System","0","0","0","0","0","0","0.0","0.0","null","2022","2","2022","1","03","31"
"2022-03-31","Agency","Small Business Administration","null","12433141154","127057","12433141154","127057","0","0","100.0","100.0","CFO","2022","2","2022","1","03","31"
"2022-03-31","Bureau","Small Business Administration","Small Business Administration","12433141154","127057","12433141154","127057","0","0","100.0","100.0","null","2022","2","2022","1","03","31"
"2022-03-31","Agency","Smithsonian Institution","null","0","0","0","0","0","0","0.0","0.0","Non-CFO","2022","2","2022","1","03","31"
"2022-03-31","Bureau","Smithsonian Institution","Administrative Conference of the US","0","0","0","0","0","0","0.0","0.0","null","2022","2","2022","1","03","31"
"2022-03-31","Bureau","Smithsonian Institution","JFK Center for the Performing Arts","0","0","0","0","0","0","0.0","0.0","null","2022","2","2022","1","03","31"
"2022-03-31","Bureau","Smithsonian Institution","National Gallery of Art","0","0","0","0","0","0","0.0","0.0","null","2022","2","2022","1","03","31"
"2022-03-31","Bureau","Smithsonian Institution","Smithsonian Institution","0","0","0","0","0","0","0.0","0.0","null","2022","2","2022","1","03","31"
"2022-03-31","Agency","Social Security Administration","null","4399579827","1325949","2643004849","452647","1756574978","873302","60.07402872383431","34.137587493938305","CFO","2022","2","2022","1","03","31"
"2022-03-31","Bureau","Social Security Administration","Social Security Administration","4399579827","1325949","2643004849","452647","1756574978","873302","60.07402872383431","34.137587493938305","null","2022","2","2022","1","03","31"
"2022-03-31","Agency","Tennessee Valley Authority","null","0","0","0","0","0","0","0.0","0.0","Non-CFO","2022","2","2022","1","03","31"
"2022-03-31","Bureau","Tennessee Valley Authority","Tennessee Valley Authority","0","0","0","0","0","0","0.0","0.0","null","2022","2","2022","1","03","31"
"2022-03-31","Agency","The Judiciary","null","1007958","292","995992","165","11966","127","98.81284736070351","56.50684931506849","Non-CFO","2022","2","2022","1","03","31"
"2022-03-31","Bureau","The Judiciary","Administrative Office of the U.S. Courts","1007958","292","995992","165","11966","127","98.81284736070351","56.50684931506849","null","2022","2","2022","1","03","31"
"2022-03-31","Agency","U.S. Court of Appeals / Veterans Claims","null","511","1","0","0","511","1","0.0","0.0","Non-CFO","2022","2","2022","1","03","31"
"2022-03-31","Bureau","U.S. Court of Appeals / Veterans Claims","U.S. Court of Appeals / Veterans Claims","511","1","0","0","511","1","0.0","0.0","null","2022","2","2022","1","03","31"
"2022-03-31","Agency","U.S. Postal Service","null","73458473","61860","55824621","50582","17633852","11278","75.9948018521975","81.7685095376657","Non-CFO","2022","2","2022","1","03","31"
"2022-03-31","Bureau","U.S. Postal Service","U.S. Postal Service","73458473","61860","55824621","50582","17633852","11278","75.9948018521975","81.7685095376657","null","2022","2","2022","1","03","31"
"2022-03-31","Agency","U.S. Tax Court","null","0","0","0","0","0","0","0.0","0.0","Non-CFO","2022","2","2022","1","03","31"
"2022-03-31","Bureau","U.S. Tax Court","U.S. Tax Court","0","0","0","0","0","0","0.0","0.0","null","2022","2","2022","1","03","31"
"2022-03-31","Agency","US International Development Fin. Corp.","null","0","0","0","0","0","0","0.0","0.0","Non-CFO","2022","2","2022","1","03","31"
"2022-03-31","Bureau","US International Development Fin. Corp.","US International Development Fin. Corp.","0","0","0","0","0","0","0.0","0.0","null","2022","2","2022","1","03","31"
"2021-12-31","Agency","Agency for International Development","null","39929663","54","39929663","54","0","0","100.0","100.0","CFO","2022","1","2021","4","12","31"
"2021-12-31","Bureau","Agency for International Development","Agency for International Development","39929663","54","39929663","54","0","0","100.0","100.0","null","2022","1","2021","4","12","31"
"2021-12-31","Agency","American Battle Monuments Commission","null","0","0","0","0","0","0","0.0","0.0","Non-CFO","2022","1","2021","4","12","31"
"2021-12-31","Bureau","American Battle Monuments Commission","American Battle Monuments Commission","0","0","0","0","0","0","0.0","0.0","null","2022","1","2021","4","12","31"
"2021-12-31","Agency","Armed Forces Retirement Home","null","116284","121","78202","103","38082","18","67.25086856317292","85.12396694214875","Non-CFO","2022","1","2021","4","12","31"
"2021-12-31","Bureau","Armed Forces Retirement Home","Armed Forces Retirement Home","116284","121","78202","103","38082","18","67.25086856317292","85.12396694214875","null","2022","1","2021","4","12","31"
"2021-12-31","Agency","Commodity Futures Trading Commission","null","661847583","365","661847583","365","0","0","100.0","100.0","Non-CFO","2022","1","2021","4","12","31"
"2021-12-31","Bureau","Commodity Futures Trading Commission","Commodity Futures Trading Commission","661847583","365","661847583","365","0","0","100.0","100.0","null","2022","1","2021","4","12","31"
"2021-12-31","Agency","Consumer Product Safety Commission","null","2500","1","2500","1","0","0","100.0","100.0","Non-CFO","2022","1","2021","4","12","31"
"2021-12-31","Bureau","Consumer Product Safety Commission","Consumer Product Safety Commission","2500","1","2500","1","0","0","100.0","100.0","null","2022","1","2021","4","12","31"
"2021-12-31","Agency","Corp. for National and Community Service","null","4536611","1221","3581080","151","955531","1070","78.9373389078323","12.366912366912366","Non-CFO","2022","1","2021","4","12","31"
"2021-12-31","Bureau","Corp. for National and Community Service","Corp. for National and Community Service","4536611","1221","3581080","151","955531","1070","78.9373389078323","12.366912366912366","null","2022","1","2021","4","12","31"
"2021-12-31","Agency","Department of Agriculture","null","1780700574","62508","1758290701","56999","22409873","5509","98.74151368696083","91.18672809880336","CFO","2022","1","2021","4","12","31"
"2021-12-31","Bureau","Department of Agriculture","Agricultural Marketing Service","5658332","2616","4916401","518","741931","2098","86.88781428873385","19.801223241590215","null","2022","1","2021","4","12","31"
"2021-12-31","Bureau","Department of Agriculture","Commodity Credit Corporation","138047795","10581","138047795","10581","0","0","100.0","100.0","null","2022","1","2021","4","12","31"
"2021-12-31","Bureau","Department of Agriculture","Farm Service Agency","797099182","13535","797099182","13535","0","0","100.0","100.0","null","2022","1","2021","4","12","31"
"2021-12-31","Bureau","Department of Agriculture","Federal Crop Insurance Corporation","10236","414","1405","405","8831","9","13.726064869089488","97.82608695652173","null","2022","1","2021","4","12","31"
"2021-12-31","Bureau","Department of Agriculture","Food Safety and Inspection Service","1025905","703","929411","621","96494","82","90.5942558034126","88.33570412517781","null","2022","1","2021","4","12","31"
"2021-12-31","Bureau","Department of Agriculture","Food and Nutrition Service","10581621","266","48918","4","10532703","262","0.462292119515526","1.5037593984962405","null","2022","1","2021","4","12","31"
"2021-12-31","Bureau","Department of Agriculture","Forest Service","70606828","1185","64764987","361","5841841","824","91.72623786470056","30.464135021097047","null","2022","1","2021","4","12","31"
"2021-12-31","Bureau","Department of Agriculture","Rural Development","735813096","29045","735725157","28927","87939","118","99.98804873133163","99.59373386124979","null","2022","1","2021","4","12","31"
"2021-12-31","Bureau","Department of Agriculture","U.S. Department of Agriculture","21857579","4163","16757445","2047","5100134","2116","76.66651919684243","49.171270718232044","null","2022","1","2021","4","12","31"
"2021-12-31","Agency","Department of Commerce","null","57799410","6429","57799410","6429","0","0","100.0","100.0","CFO","2022","1","2021","4","12","31"
"2021-12-31","Bureau","Department of Commerce","Bureau of Industry and Security","36366405","27","36366405","27","0","0","100.0","100.0","null","2022","1","2021","4","12","31"
"2021-12-31","Bureau","Department of Commerce","Bureau of the Census","2058507","4290","2058507","4290","0","0","100.0","100.0","null","2022","1","2021","4","12","31"
"2021-12-31","Bureau","Department of Commerce","Economic Development Administration","5120584","11","5120584","11","0","0","100.0","100.0","null","2022","1","2021","4","12","31"
"2021-12-31","Bureau","Department of Commerce","Economic and Statistical Analysis","0","0","0","0","0","0","0.0","0.0","null","2022","1","2021","4","12","31"
"2021-12-31","Bureau","Department of Commerce","General Administration","4660","1","4660","1","0","0","100.0","100.0","null","2022","1","2021","4","12","31"
"2021-12-31","Bureau","Department of Commerce","International Trade Administration","0","0","0","0","0","0","0.0","0.0","null","2022","1","2021","4","12","31"
"2021-12-31","Bureau","Department of Commerce","Minority Business Development Agency","0","0","0","0","0","0","0.0","0.0","null","2022","1","2021","4","12","31"
"2021-12-31","Bureau","Department of Commerce","NOAA","12690388","1272","12690388","1272","0","0","100.0","100.0","null","2022","1","2021","4","12","31"
"2021-12-31","Bureau","Department of Commerce","Nat'l Institute of Standards& Technology","673322","5","673322","5","0","0","100.0","100.0","null","2022","1","2021","4","12","31"
"2021-12-31","Bureau","Department of Commerce","Nat'l Telecomm & Information Admin.","296092","1","296092","1","0","0","100.0","100.0","null","2022","1","2021","4","12","31"
"2021-12-31","Bureau","Department of Commerce","National Technical Information Service","0","0","0","0","0","0","0.0","0.0","null","2022","1","2021","4","12","31"
"2021-12-31","Bureau","Department of Commerce","Office of the Inspector General","0","0","0","0","0","0","0.0","0.0","null","2022","1","2021","4","12","31"
"2021-12-31","Bureau","Department of Commerce","Patent and Trademark Office","589452","822","589452","822","0","0","100.0","100.0","null","2022","1","2021","4","12","31"
"2021-12-31","Agency","Department of Defense","null","2940707585","1477393","1016533001","261567","1924174584","1215826","34.5676328440524","17.704632416696167","CFO","2022","1","2021","4","12","31"
"2021-12-31","Bureau","Department of Defense","Consolidated Report","2940707585","1477393","1016533001","261567","1924174584","1215826","34.5676328440524","17.704632416696167","null","2022","1","2021","4","12","31"
"2021-12-31","Agency","Department of Education","null","130677439492","22310335","130597689767","22310123","79749725","212","99.93897207864646","99.99904976774216","CFO","2022","1","2021","4","12","31"
"2021-12-31","Bureau","Department of Education","Departmental Management","1344545335","2140","1264795610","1928","79749725","212","94.06864737662416","90.09345794392523","null","2022","1","2021","4","12","31"
"2021-12-31","Bureau","Department of Education","Federal Student Aid","129332894157","22308195","129332894157","22308195","0","0","100.0","100.0","null","2022","1","2021","4","12","31"
"2021-12-31","Bureau","Department of Education","Office of Postsecondary Education","0","0","0","0","0","0","0.0","0.0","null","2022","1","2021","4","12","31"
"2021-12-31","Agency","Department of Energy","null","14108003","93","14108003","93","0","0","100.0","100.0","CFO","2022","1","2021","4","12","31"
"2021-12-31","Bureau","Department of Energy","Bonneville Power Administration","1368925","25","1368925","25","0","0","100.0","100.0","null","2022","1","2021","4","12","31"
"2021-12-31","Bureau","Department of Energy","Energy Consolidated Reports","12739078","68","12739078","68","0","0","100.0","100.0","null","2022","1","2021","4","12","31"
"2021-12-31","Agency","Department of Health & Human Services","null","9703220236","1142310","9518742450","1117824","184477786","24486","98.09879832145242","97.85644877485096","CFO","2022","1","2021","4","12","31"
"2021-12-31","Bureau","Department of Health & Human Services","Administration for Children and Families","32668440","1744","32668440","1744","0","0","100.0","100.0","null","2022","1","2021","4","12","31"
"2021-12-31","Bureau","Department of Health & Human Services","Administration for Community Living","0","0","0","0","0","0","0.0","0.0","null","2022","1","2021","4","12","31"
"2021-12-31","Bureau","Department of Health & Human Services","Centers for Disease Control","13218960","110","158347","17","13060613","93","1.1978778965970092","15.454545454545455","null","2022","1","2021","4","12","31"
"2021-12-31","Bureau","Department of Health & Human Services","Centers for Medicare & Medicaid Services","9354694403","1117866","9285808479","1109738","68885924","8128","99.26362186692161","99.2729003297354","null","2022","1","2021","4","12","31"
"2021-12-31","Bureau","Department of Health & Human Services","Food and Drug Administration","120713912","17030","30656724","1162","90057188","15868","25.396181344864377","6.823253082795068","null","2022","1","2021","4","12","31"
"2021-12-31","Bureau","Department of Health & Human Services","Health Resources and Services Admin","109257481","657","109257481","657","0","0","100.0","100.0","null","2022","1","2021","4","12","31"
"2021-12-31","Bureau","Department of Health & Human Services","Indian Health Services","46087108","4053","46087108","4053","0","0","100.0","100.0","null","2022","1","2021","4","12","31"
"2021-12-31","Bureau","Department of Health & Human Services","National Institutes of Health","18852308","502","6378247","105","12474061","397","33.83271162342563","20.916334661354583","null","2022","1","2021","4","12","31"
"2021-12-31","Bureau","Department of Health & Human Services","Office of the Inspector General","0","0","0","0","0","0","0.0","0.0","null","2022","1","2021","4","12","31"
"2021-12-31","Bureau","Department of Health & Human Services","Office of the Secretary","7226","7","7226","7","0","0","100.0","100.0","null","2022","1","2021","4","12","31"
"2021-12-31","Bureau","Department of Health & Human Services","Program Support Center","6707558","327","6707558","327","0","0","100.0","100.0","null","2022","1","2021","4","12","31"
"2021-12-31","Bureau","Department of Health & Human Services","Substance Abuse & Mental Health Admin.","1012840","14","1012840","14","0","0","100.0","100.0","null","2022","1","2021","4","12","31"
"2021-12-31","Agency","Department of Homeland Security","null","282465118","50901","282436519","50877","28599","24","99.98987521000734","99.95284964931926","CFO","2022","1","2021","4","12","31"
"2021-12-31","Bureau","Department of Homeland Security","Bureau of Customs & Border Protection","8919482","664","8919482","664","0","0","100.0","100.0","null","2022","1","2021","4","12","31"
"2021-12-31","Bureau","Department of Homeland Security","Citizenship and Immigration Services","1029212","1234","1029212","1234","0","0","100.0","100.0","null","2022","1","2021","4","12","31"
"2021-12-31","Bureau","Department of Homeland Security","Domestic Nuclear Detection Office","28599","24","0","0","28599","24","0.0","0.0","null","2022","1","2021","4","12","31"
"2021-12-31","Bureau","Department of Homeland Security","Emergency Preparedness & Resp","249930801","42449","249930801","42449","0","0","100.0","100.0","null","2022","1","2021","4","12","31"
"2021-12-31","Bureau","Department of Homeland Security","Federal Law Enforcement Training Ctr.","1632","2","1632","2","0","0","100.0","100.0","null","2022","1","2021","4","12","31"
"2021-12-31","Bureau","Department of Homeland Security","Immigration and Customs Enforcement","14006209","608","14006209","608","0","0","100.0","100.0","null","2022","1","2021","4","12","31"
"2021-12-31","Bureau","Department of Homeland Security","Info Analysis Infrastructure Prot-NPPD","0","0","0","0","0","0","0.0","0.0","null","2022","1","2021","4","12","31"
"2021-12-31","Bureau","Department of Homeland Security","Management Headquarters","0","0","0","0","0","0","0.0","0.0","null","2022","1","2021","4","12","31"
"2021-12-31","Bureau","Department of Homeland Security","Office of Biometric Identity Management","0","0","0","0","0","0","0.0","0.0","null","2022","1","2021","4","12","31"
"2021-12-31","Bureau","Department of Homeland Security","Office of Health Affairs","0","0","0","0","0","0","0.0","0.0","null","2022","1","2021","4","12","31"
"2021-12-31","Bureau","Department of Homeland Security","Office of the Inspector General DHS","100","1","100","1","0","0","100.0","100.0","null","2022","1","2021","4","12","31"
"2021-12-31","Bureau","Department of Homeland Security","Science and Technology","0","0","0","0","0","0","0.0","0.0","null","2022","1","2021","4","12","31"
"2021-12-31","Bureau","Department of Homeland Security","Transportation Safety Administration","8549083","5919","8549083","5919","0","0","100.0","100.0","null","2022","1","2021","4","12","31"
"2021-12-31","Bureau","Department of Homeland Security","U.S. Coast Guard","0","0","0","0","0","0","0.0","0.0","null","2022","1","2021","4","12","31"
"2021-12-31","Bureau","Department of Homeland Security","U.S. Secret Service","0","0","0","0","0","0","0.0","0.0","null","2022","1","2021","4","12","31"
"2021-12-31","Agency","Department of Housing and Urban Development","null","143052443","4729","142041624","4709","1010819","20","99.2933927035416","99.57707760625925","CFO","2022","1","2021","4","12","31"
"2021-12-31","Bureau","Department of Housing and Urban Development","Community Planning and Development","234529","2","234529","2","0","0","100.0","100.0","null","2022","1","2021","4","12","31"
"2021-12-31","Bureau","Department of Housing and Urban Development","Government National Mortgage Association","0","0","0","0","0","0","0.0","0.0","null","2022","1","2021","4","12","31"
"2021-12-31","Bureau","Department of Housing and Urban Development","Housing Programs","141819242","4708","141802340","4705","16902","3","99.98808201217152","99.93627867459644","null","2022","1","2021","4","12","31"
"2021-12-31","Bureau","Department of Housing and Urban Development","Management and Administration","391418","8","4755","2","386663","6","1.2148138307384944","25.0","null","2022","1","2021","4","12","31"
"2021-12-31","Bureau","Department of Housing and Urban Development","Policy, Development and Research","0","0","0","0","0","0","0.0","0.0","null","2022","1","2021","4","12","31"
"2021-12-31","Bureau","Department of Housing and Urban Development","Public and Indian Housing Programs","607254","11","0","0","607254","11","0.0","0.0","null","2022","1","2021","4","12","31"
"2021-12-31","Agency","Department of Justice","null","93425523","38545","90185901","38231","3239622","314","96.5324015365694","99.1853677519782","CFO","2022","1","2021","4","12","31"
"2021-12-31","Bureau","Department of Justice","Bureau of ATF and Explosives","20422","4","20422","4","0","0","100.0","100.0","null","2022","1","2021","4","12","31"
"2021-12-31","Bureau","Department of Justice","Drug Enforcement Administration","313028","21","313028","21","0","0","100.0","100.0","null","2022","1","2021","4","12","31"
"2021-12-31","Bureau","Department of Justice","Federal Bureau of Investigation","338605","76","338605","76","0","0","100.0","100.0","null","2022","1","2021","4","12","31"
"2021-12-31","Bureau","Department of Justice","Federal Prison Industries","22733","8","0","0","22733","8","0.0","0.0","null","2022","1","2021","4","12","31"
"2021-12-31","Bureau","Department of Justice","Federal Prison System","0","0","0","0","0","0","0.0","0.0","null","2022","1","2021","4","12","31"
"2021-12-31","Bureau","Department of Justice","General Administration","0","0","0","0","0","0","0.0","0.0","null","2022","1","2021","4","12","31"
"2021-12-31","Bureau","Department of Justice","Legal Activities","91792965","38433","88576076","38127","3216889","306","96.49549505237138","99.20380922644603","null","2022","1","2021","4","12","31"
"2021-12-31","Bureau","Department of Justice","Office of Justice Assistance Programs","937770","3","937770","3","0","0","100.0","100.0","null","2022","1","2021","4","12","31"
"2021-12-31","Bureau","Department of Justice","U.S. Marshals Service","0","0","0","0","0","0","0.0","0.0","null","2022","1","2021","4","12","31"
"2021-12-31","Agency","Department of Labor","null","197769273","36961","165143954","15170","32625319","21791","83.50334280694858","41.04326181650929","CFO","2022","1","2021","4","12","31"
"2021-12-31","Bureau","Department of Labor","Bureau of Labor Statistics","12209","1","12209","1","0","0","100.0","100.0","null","2022","1","2021","4","12","31"
"2021-12-31","Bureau","Department of Labor","Departmental Management","0","0","0","0","0","0","0.0","0.0","null","2022","1","2021","4","12","31"
"2021-12-31","Bureau","Department of Labor","Employee Benefit Security Administration","20001180","456","20001180","456","0","0","100.0","100.0","null","2022","1","2021","4","12","31"
"2021-12-31","Bureau","Department of Labor","Employment Standards Administration","92724584","23292","67500119","5285","25224465","18007","72.79635678926314","22.69019405804568","null","2022","1","2021","4","12","31"
"2021-12-31","Bureau","Department of Labor","Employment and Training Administration","1122042","10","1122042","10","0","0","100.0","100.0","null","2022","1","2021","4","12","31"
"2021-12-31","Bureau","Department of Labor","Mine Safety and Health Administration","21981808","6921","17062837","4738","4918971","2183","77.6225367813239","68.45831527235948","null","2022","1","2021","4","12","31"
"2021-12-31","Bureau","Department of Labor","Occupational Safety and Health Admin","61927450","6281","59445567","4680","2481883","1601","95.99227321648155","74.51042827575228","null","2022","1","2021","4","12","31"
"2021-12-31","Agency","Department of State","null","29449184","20142","17811817","20067","11637367","75","60.483227650722","99.6276437295204","CFO","2022","1","2021","4","12","31"
"2021-12-31","Bureau","Department of State","Civil Monetary Penalties","0","0","0","0","0","0","0.0","0.0","null","2022","1","2021","4","12","31"
"2021-12-31","Bureau","Department of State","Department of State","27376460","6781","15739093","6706","11637367","75","57.49133744830413","98.89396844123286","null","2022","1","2021","4","12","31"
"2021-12-31","Bureau","Department of State","International Commissions","0","0","0","0","0","0","0.0","0.0","null","2022","1","2021","4","12","31"
"2021-12-31","Bureau","Department of State","Passport NSF","2072724","13361","2072724","13361","0","0","100.0","100.0","null","2022","1","2021","4","12","31"
"2021-12-31","Agency","Department of Transportation","null","67781925","7337","67754172","7319","27753","18","99.9590554561559","99.7546681204852","CFO","2022","1","2021","4","12","31"
"2021-12-31","Bureau","Department of Transportation","Federal Aviation Administration","1842114","237","1814616","223","27498","14","98.50725850843108","94.09282700421942","null","2022","1","2021","4","12","31"
"2021-12-31","Bureau","Department of Transportation","Federal Highway Administration","6048","7","6048","7","0","0","100.0","100.0","null","2022","1","2021","4","12","31"
"2021-12-31","Bureau","Department of Transportation","Federal Motor Carrier Safety Admin","63497752","7020","63497497","7016","255","4","99.99959841097997","99.94301994301995","null","2022","1","2021","4","12","31"
"2021-12-31","Bureau","Department of Transportation","Federal Railroad Administration","130497","13","130497","13","0","0","100.0","100.0","null","2022","1","2021","4","12","31"
"2021-12-31","Bureau","Department of Transportation","Federal Transit Administration","783404","1","783404","1","0","0","100.0","100.0","null","2022","1","2021","4","12","31"
"2021-12-31","Bureau","Department of Transportation","Maritime Administration","5310","6","5310","6","0","0","100.0","100.0","null","2022","1","2021","4","12","31"
"2021-12-31","Bureau","Department of Transportation","National Highway Traffic Safety Admin.","39414","9","39414","9","0","0","100.0","100.0","null","2022","1","2021","4","12","31"
"2021-12-31","Bureau","Department of Transportation","Office of the Inspector General","217","1","217","1","0","0","100.0","100.0","null","2022","1","2021","4","12","31"
"2021-12-31","Bureau","Department of Transportation","Office of the Secretary","1073204","17","1073204","17","0","0","100.0","100.0","null","2022","1","2021","4","12","31"
"2021-12-31","Bureau","Department of Transportation","Pipeline Hazardous Material Safety Admin","400389","24","400389","24","0","0","100.0","100.0","null","2022","1","2021","4","12","31"
"2021-12-31","Bureau","Department of Transportation","Research Innovative Technology Admin","0","0","0","0","0","0","0.0","0.0","null","2022","1","2021","4","12","31"
"2021-12-31","Bureau","Department of Transportation","St. Lawrence Seaway Development Corp.","3576","2","3576","2","0","0","100.0","100.0","null","2022","1","2021","4","12","31"
"2021-12-31","Agency","Department of Veterans Affairs","null","200454100","2255543","196320980","2250938","4133120","4605","97.93812149514527","99.79583630194591","CFO","2022","1","2021","4","12","31"
"2021-12-31","Bureau","Department of Veterans Affairs","Administration and Cemeteries","1269967","781","40287","26","1229680","755","3.1722871539181727","3.329065300896287","null","2022","1","2021","4","12","31"
"2021-12-31","Bureau","Department of Veterans Affairs","Housing Credit Assistance","945487","25","0","0","945487","25","0.0","0.0","null","2022","1","2021","4","12","31"
"2021-12-31","Bureau","Department of Veterans Affairs","Life Insurance","917965","181","917965","181","0","0","100.0","100.0","null","2022","1","2021","4","12","31"
"2021-12-31","Bureau","Department of Veterans Affairs","Medical and Construction","196025143","2252854","195362728","2250731","662415","2123","99.6620765122972","99.90576397760351","null","2022","1","2021","4","12","31"
"2021-12-31","Bureau","Department of Veterans Affairs","Veterans Benefits","1295538","1702","0","0","1295538","1702","0.0","0.0","null","2022","1","2021","4","12","31"
"2021-12-31","Agency","Department of the Interior","null","71331399","35082","71309211","35045","22188","37","99.96889448362003","99.89453280884784","CFO","2022","1","2021","4","12","31"
"2021-12-31","Bureau","Department of the Interior","Bureau of Indian Affairs","39022431","31272","39001175","31236","21256","36","99.94552876523761","99.88488104374521","null","2022","1","2021","4","12","31"
"2021-12-31","Bureau","Department of the Interior","Bureau of Land Management","9048182","302","9048182","302","0","0","100.0","100.0","null","2022","1","2021","4","12","31"
"2021-12-31","Bureau","Department of the Interior","Bureau of Ocean Energy Mgmt., Reg & Enf","932","1","0","0","932","1","0.0","0.0","null","2022","1","2021","4","12","31"
"2021-12-31","Bureau","Department of the Interior","Bureau of Reclamation","78251","60","78251","60","0","0","100.0","100.0","null","2022","1","2021","4","12","31"
"2021-12-31","Bureau","Department of the Interior","Bureau of Safety and Environmental Enf.","0","0","0","0","0","0","0.0","0.0","null","2022","1","2021","4","12","31"
"2021-12-31","Bureau","Department of the Interior","Fish and Wildlife Service","753384","69","753384","69","0","0","100.0","100.0","null","2022","1","2021","4","12","31"
"2021-12-31","Bureau","Department of the Interior","Geological Survey","119371","283","119371","283","0","0","100.0","100.0","null","2022","1","2021","4","12","31"
"2021-12-31","Bureau","Department of the Interior","National Park Service","8243675","2172","8243675","2172","0","0","100.0","100.0","null","2022","1","2021","4","12","31"
"2021-12-31","Bureau","Department of the Interior","Office of Natural Resources Revenue","6469279","534","6469279","534","0","0","100.0","100.0","null","2022","1","2021","4","12","31"
"2021-12-31","Bureau","Department of the Interior","Office of Surface Mining","7568479","367","7568479","367","0","0","100.0","100.0","null","2022","1","2021","4","12","31"
"2021-12-31","Bureau","Department of the Interior","Office of the Secretary","27415","22","27415","22","0","0","100.0","100.0","null","2022","1","2021","4","12","31"
"2021-12-31","Agency","Department of the Treasury","null","44966649","5250","43873573","5135","1093076","115","97.56914063131545","97.80952380952381","CFO","2022","1","2021","4","12","31"
"2021-12-31","Bureau","Department of the Treasury","Bureau of Engraving and Printing","0","0","0","0","0","0","0.0","0.0","null","2022","1","2021","4","12","31"
"2021-12-31","Bureau","Department of the Treasury","Bureau of the Fiscal Service","14005030","3735","14005030","3735","0","0","100.0","100.0","null","2022","1","2021","4","12","31"
"2021-12-31","Bureau","Department of the Treasury","Community Dev Financial Inst Fund","4766457","10","4766457","10","0","0","100.0","100.0","null","2022","1","2021","4","12","31"
"2021-12-31","Bureau","Department of the Treasury","Comptroller of the Currency","1368573","26","1318173","21","50400","5","96.31733199471275","80.76923076923077","null","2022","1","2021","4","12","31"
"2021-12-31","Bureau","Department of the Treasury","D.C. Pension Program","477970","22","477970","22","0","0","100.0","100.0","null","2022","1","2021","4","12","31"
"2021-12-31","Bureau","Department of the Treasury","Departmental Offices","22238568","1340","21715635","1314","522933","26","97.64853114642993","98.05970149253731","null","2022","1","2021","4","12","31"
"2021-12-31","Bureau","Department of the Treasury","Financial Crimes Enforcement Network","1544945","3","1544945","3","0","0","100.0","100.0","null","2022","1","2021","4","12","31"
"2021-12-31","Bureau","Department of the Treasury","Interest on Tax/Deposit of Earnings","0","0","0","0","0","0","0.0","0.0","null","2022","1","2021","4","12","31"
"2021-12-31","Bureau","Department of the Treasury","Internal Revenue Service","209716","80","0","0","209716","80","0.0","0.0","null","2022","1","2021","4","12","31"
"2021-12-31","Bureau","Department of the Treasury","International Monetary Funds","0","0","0","0","0","0","0.0","0.0","null","2022","1","2021","4","12","31"
"2021-12-31","Bureau","Department of the Treasury","Office of Financial Research","268","1","268","1","0","0","100.0","100.0","null","2022","1","2021","4","12","31"
"2021-12-31","Bureau","Department of the Treasury","Office of Sec International Affairs","0","0","0","0","0","0","0.0","0.0","null","2022","1","2021","4","12","31"
"2021-12-31","Bureau","Department of the Treasury","Office of the Secretary","0","0","0","0","0","0","0.0","0.0","null","2022","1","2021","4","12","31"
"2021-12-31","Bureau","Department of the Treasury","Pandemic Receivables","304917","1","0","0","304917","1","0.0","0.0","null","2022","1","2021","4","12","31"
"2021-12-31","Bureau","Department of the Treasury","Spec Insp Gen-Troubled Asset Rel Prog","3916","1","3916","1","0","0","100.0","100.0","null","2022","1","2021","4","12","31"
"2021-12-31","Bureau","Department of the Treasury","Tobacco Tax and Trade","1000","1","1000","1","0","0","100.0","100.0","null","2022","1","2021","4","12","31"
"2021-12-31","Bureau","Department of the Treasury","Treasury Forfeiture Fund","0","0","0","0","0","0","0.0","0.0","null","2022","1","2021","4","12","31"
"2021-12-31","Bureau","Department of the Treasury","Treasury Franchise Fund","0","0","0","0","0","0","0.0","0.0","null","2022","1","2021","4","12","31"
"2021-12-31","Bureau","Department of the Treasury","Treasury IG for Tax Admin","182","1","182","1","0","0","100.0","100.0","null","2022","1","2021","4","12","31"
"2021-12-31","Bureau","Department of the Treasury","U.S. Mint","45107","29","39997","26","5110","3","88.67138138204713","89.65517241379311","null","2022","1","2021","4","12","31"
"2021-12-31","Bureau","Department of the Treasury","U.S. Treasury IG Office","0","0","0","0","0","0","0.0","0.0","null","2022","1","2021","4","12","31"
"2021-12-31","Agency","Environmental Protection Agency","null","25460609","255","25278408","253","182201","2","99.28438082529762","99.2156862745098","CFO","2022","1","2021","4","12","31"
"2021-12-31","Bureau","Environmental Protection Agency","Environmental Protection Agency","25460609","255","25278408","253","182201","2","99.28438082529762","99.2156862745098","null","2022","1","2021","4","12","31"
"2021-12-31","Agency","Equal Employment Opportunity Commission","null","17338","14","17338","14","0","0","100.0","100.0","Non-CFO","2022","1","2021","4","12","31"
"2021-12-31","Bureau","Equal Employment Opportunity Commission","Equal Employment Opportunity Commission","17338","14","17338","14","0","0","100.0","100.0","null","2022","1","2021","4","12","31"
"2021-12-31","Agency","Export - Import  Bank","null","0","0","0","0","0","0","0.0","0.0","Non-CFO","2022","1","2021","4","12","31"
"2021-12-31","Bureau","Export - Import  Bank","Export-Import Bank","0","0","0","0","0","0","0.0","0.0","null","2022","1","2021","4","12","31"
"2021-12-31","Agency","Farm Credit Administration","null","630","1","630","1","0","0","100.0","100.0","Non-CFO","2022","1","2021","4","12","31"
"2021-12-31","Bureau","Farm Credit Administration","Farm Credit Administration","630","1","630","1","0","0","100.0","100.0","null","2022","1","2021","4","12","31"
"2021-12-31","Bureau","Farm Credit Administration","Farm Credit System Insurance Corporation","0","0","0","0","0","0","0.0","0.0","null","2022","1","2021","4","12","31"
"2021-12-31","Agency","Federal Communications Commission","null","222106532","13231","222106532","13231","0","0","100.0","100.0","Non-CFO","2022","1","2021","4","12","31"
"2021-12-31","Bureau","Federal Communications Commission","Federal Communications Commission","222106532","13231","222106532","13231","0","0","100.0","100.0","null","2022","1","2021","4","12","31"
"2021-12-31","Agency","Federal Deposit Insurance Corporation","null","0","0","0","0","0","0","0.0","0.0","Non-CFO","2022","1","2021","4","12","31"
"2021-12-31","Bureau","Federal Deposit Insurance Corporation","Federal Deposit Insurance Corporation","0","0","0","0","0","0","0.0","0.0","null","2022","1","2021","4","12","31"
"2021-12-31","Agency","Federal Election Commission","null","1149832","173","1149832","173","0","0","100.0","100.0","Non-CFO","2022","1","2021","4","12","31"
"2021-12-31","Bureau","Federal Election Commission","Federal Election Commission","1149832","173","1149832","173","0","0","100.0","100.0","null","2022","1","2021","4","12","31"
"2021-12-31","Agency","Federal Labor Relations Authority","null","0","0","0","0","0","0","0.0","0.0","Non-CFO","2022","1","2021","4","12","31"
"2021-12-31","Bureau","Federal Labor Relations Authority","Federal Labor Relations Authority","0","0","0","0","0","0","0.0","0.0","null","2022","1","2021","4","12","31"
"2021-12-31","Agency","Federal Maritime Commission","null","397461","6","397461","6","0","0","100.0","100.0","Non-CFO","2022","1","2021","4","12","31"
"2021-12-31","Bureau","Federal Maritime Commission","Salaries and Expenses","397461","6","397461","6","0","0","100.0","100.0","null","2022","1","2021","4","12","31"
"2021-12-31","Agency","Federal Mediation/Conciliation Service","null","0","0","0","0","0","0","0.0","0.0","Non-CFO","2022","1","2021","4","12","31"
"2021-12-31","Bureau","Federal Mediation/Conciliation Service","Federal Mediation/Conciliation Service","0","0","0","0","0","0","0.0","0.0","null","2022","1","2021","4","12","31"
"2021-12-31","Agency","Federal Trade Commission","null","482181306","54","482181306","54","0","0","100.0","100.0","Non-CFO","2022","1","2021","4","12","31"
"2021-12-31","Bureau","Federal Trade Commission","Federal Trade Commission","482181306","54","482181306","54","0","0","100.0","100.0","null","2022","1","2021","4","12","31"
"2021-12-31","Agency","Funds Appropriated to the President","null","1236060","7","0","0","1236060","7","0.0","0.0","Non-CFO","2022","1","2021","4","12","31"
"2021-12-31","Bureau","Funds Appropriated to the President","African Development Foundation","0","0","0","0","0","0","0.0","0.0","null","2022","1","2021","4","12","31"
"2021-12-31","Bureau","Funds Appropriated to the President","Defense Security Assistance Agency","0","0","0","0","0","0","0.0","0.0","null","2022","1","2021","4","12","31"
"2021-12-31","Bureau","Funds Appropriated to the President","Executive Branch","0","0","0","0","0","0","0.0","0.0","null","2022","1","2021","4","12","31"
"2021-12-31","Bureau","Funds Appropriated to the President","Inter-American Foundation","0","0","0","0","0","0","0.0","0.0","null","2022","1","2021","4","12","31"
"2021-12-31","Bureau","Funds Appropriated to the President","Peace Corps","0","0","0","0","0","0","0.0","0.0","null","2022","1","2021","4","12","31"
"2021-12-31","Bureau","Funds Appropriated to the President","Trade and Development Agency","1236060","7","0","0","1236060","7","0.0","0.0","null","2022","1","2021","4","12","31"
"2021-12-31","Agency","General Services Administration","null","10419507","1323","7457651","533","2961856","790","71.57393339243401","40.28722600151172","CFO","2022","1","2021","4","12","31"
"2021-12-31","Bureau","General Services Administration","General Services Administration","10419507","1323","7457651","533","2961856","790","71.57393339243401","40.28722600151172","null","2022","1","2021","4","12","31"
"2021-12-31","Agency","Legis Branch-Library of Congress","null","0","0","0","0","0","0","0.0","0.0","Non-CFO","2022","1","2021","4","12","31"
"2021-12-31","Bureau","Legis Branch-Library of Congress","Library of Congress","0","0","0","0","0","0","0.0","0.0","null","2022","1","2021","4","12","31"
"2021-12-31","Agency","Legislative Branch - U.S. House/Senate","null","218320","178","0","0","218320","178","0.0","0.0","Non-CFO","2022","1","2021","4","12","31"
"2021-12-31","Bureau","Legislative Branch - U.S. House/Senate","U.S. House of Representatives","218320","178","0","0","218320","178","0.0","0.0","null","2022","1","2021","4","12","31"
"2021-12-31","Agency","Legislative Branch-CBO","null","0","0","0","0","0","0","0.0","0.0","Non-CFO","2022","1","2021","4","12","31"
"2021-12-31","Bureau","Legislative Branch-CBO","Congressional Budget Office","0","0","0","0","0","0","0.0","0.0","null","2022","1","2021","4","12","31"
"2021-12-31","Agency","Legislative Branch-GAO","null","0","0","0","0","0","0","0.0","0.0","Non-CFO","2022","1","2021","4","12","31"
"2021-12-31","Bureau","Legislative Branch-GAO","Government Accountability Office","0","0","0","0","0","0","0.0","0.0","null","2022","1","2021","4","12","31"
"2021-12-31","Agency","Legislative Branch-GPO","null","75651","9","75651","9","0","0","100.0","100.0","Non-CFO","2022","1","2021","4","12","31"
"2021-12-31","Bureau","Legislative Branch-GPO","Government Publishing Office","75651","9","75651","9","0","0","100.0","100.0","null","2022","1","2021","4","12","31"
"2021-12-31","Agency","Legislative Branch-Office of Tech.","null","0","0","0","0","0","0","0.0","0.0","Non-CFO","2022","1","2021","4","12","31"
"2021-12-31","Bureau","Legislative Branch-Office of Tech.","Medicaid & CHIP Payment & Access Comm.","0","0","0","0","0","0","0.0","0.0","null","2022","1","2021","4","12","31"
"2021-12-31","Bureau","Legislative Branch-Office of Tech.","Open World Leadership","0","0","0","0","0","0","0.0","0.0","null","2022","1","2021","4","12","31"
"2021-12-31","Agency","Merit Systems Protection Board","null","144","1","144","1","0","0","100.0","100.0","Non-CFO","2022","1","2021","4","12","31"
"2021-12-31","Bureau","Merit Systems Protection Board","Merit Systems Protection Board","144","1","144","1","0","0","100.0","100.0","null","2022","1","2021","4","12","31"
"2021-12-31","Agency","National Aeronautics and Space Administration","null","1558326","126","1558326","126","0","0","100.0","100.0","CFO","2022","1","2021","4","12","31"
"2021-12-31","Bureau","National Aeronautics and Space Administration","National Aeronautics and Space Admin","1558326","126","1558326","126","0","0","100.0","100.0","null","2022","1","2021","4","12","31"
"2021-12-31","Agency","National Archives & Records Admin","null","119017","105","119017","105","0","0","100.0","100.0","Non-CFO","2022","1","2021","4","12","31"
"2021-12-31","Bureau","National Archives & Records Admin","Nat'l Archives & Records Administration","119017","105","119017","105","0","0","100.0","100.0","null","2022","1","2021","4","12","31"
"2021-12-31","Agency","National Credit Union Administration","null","2996","8","0","0","2996","8","0.0","0.0","Non-CFO","2022","1","2021","4","12","31"
"2021-12-31","Bureau","National Credit Union Administration","National Credit Union Administration","2996","8","0","0","2996","8","0.0","0.0","null","2022","1","2021","4","12","31"
"2021-12-31","Agency","National Foundation  Arts & Humanities","null","0","0","0","0","0","0","0.0","0.0","Non-CFO","2022","1","2021","4","12","31"
"2021-12-31","Bureau","National Foundation  Arts & Humanities","National Endowment for the Arts","0","0","0","0","0","0","0.0","0.0","null","2022","1","2021","4","12","31"
"2021-12-31","Bureau","National Foundation  Arts & Humanities","National Endowment for the Humanities","0","0","0","0","0","0","0.0","0.0","null","2022","1","2021","4","12","31"
"2021-12-31","Agency","National Labor Relations Board","null","0","0","0","0","0","0","0.0","0.0","Non-CFO","2022","1","2021","4","12","31"
"2021-12-31","Bureau","National Labor Relations Board","National Labor Relations Board","0","0","0","0","0","0","0.0","0.0","null","2022","1","2021","4","12","31"
"2021-12-31","Agency","National Science Foundation","null","595663","68","595663","68","0","0","100.0","100.0","CFO","2022","1","2021","4","12","31"
"2021-12-31","Bureau","National Science Foundation","National Science Foundation","595663","68","595663","68","0","0","100.0","100.0","null","2022","1","2021","4","12","31"
"2021-12-31","Agency","Neighborhood Reinvestment Corporation","null","0","0","0","0","0","0","0.0","0.0","Non-CFO","2022","1","2021","4","12","31"
"2021-12-31","Bureau","Neighborhood Reinvestment Corporation","Neighborhood Reinvestment Corporation","0","0","0","0","0","0","0.0","0.0","null","2022","1","2021","4","12","31"
"2021-12-31","Agency","Nuclear Regulatory Commission","null","2936862","375","2936862","375","0","0","100.0","100.0","CFO","2022","1","2021","4","12","31"
"2021-12-31","Bureau","Nuclear Regulatory Commission","Nuclear Regulatory Commission","2936862","375","2936862","375","0","0","100.0","100.0","null","2022","1","2021","4","12","31"
"2021-12-31","Agency","Occupational Safety & Health Rev Comm","null","0","0","0","0","0","0","0.0","0.0","Non-CFO","2022","1","2021","4","12","31"
"2021-12-31","Bureau","Occupational Safety & Health Rev Comm","Occupational Safety & Health Rev Comm","0","0","0","0","0","0","0.0","0.0","null","2022","1","2021","4","12","31"
"2021-12-31","Agency","Office of Compliance","null","0","0","0","0","0","0","0.0","0.0","Non-CFO","2022","1","2021","4","12","31"
"2021-12-31","Bureau","Office of Compliance","Office of Compliance","0","0","0","0","0","0","0.0","0.0","null","2022","1","2021","4","12","31"
"2021-12-31","Agency","Office of Government Ethics","null","0","0","0","0","0","0","0.0","0.0","Non-CFO","2022","1","2021","4","12","31"
"2021-12-31","Bureau","Office of Government Ethics","Office of Government Ethics","0","0","0","0","0","0","0.0","0.0","null","2022","1","2021","4","12","31"
"2021-12-31","Agency","Office of Personnel Management","null","22037982","1232","21891574","1215","146408","17","99.33565605054038","98.62012987012987","CFO","2022","1","2021","4","12","31"
"2021-12-31","Bureau","Office of Personnel Management","Office of Personnel Management","22037982","1232","21891574","1215","146408","17","99.33565605054038","98.62012987012987","null","2022","1","2021","4","12","31"
"2021-12-31","Agency","Office of Special Counsel","null","0","0","0","0","0","0","0.0","0.0","Non-CFO","2022","1","2021","4","12","31"
"2021-12-31","Bureau","Office of Special Counsel","Office of Special Counsel","0","0","0","0","0","0","0.0","0.0","null","2022","1","2021","4","12","31"
"2021-12-31","Agency","Other Agencies","null","681933","81","59100","5","622833","76","8.666540554570611","6.172839506172839","Non-CFO","2022","1","2021","4","12","31"
"2021-12-31","Bureau","Other Agencies","Advisory Council on Hist. Preservation","0","0","0","0","0","0","0.0","0.0","null","2022","1","2021","4","12","31"
"2021-12-31","Bureau","Other Agencies","Archit.&Trans. Barriers Compliance Bd","0","0","0","0","0","0","0.0","0.0","null","2022","1","2021","4","12","31"
"2021-12-31","Bureau","Other Agencies","Architect of the Capitol","27483","20","0","0","27483","20","0.0","0.0","null","2022","1","2021","4","12","31"
"2021-12-31","Bureau","Other Agencies","Chemical Safety Board","33019","2","33019","2","0","0","100.0","100.0","null","2022","1","2021","4","12","31"
"2021-12-31","Bureau","Other Agencies","Comm. for Purchase from Blind/Handic.","0","0","0","0","0","0","0.0","0.0","null","2022","1","2021","4","12","31"
"2021-12-31","Bureau","Other Agencies","Commission On Fine Arts","0","0","0","0","0","0","0.0","0.0","null","2022","1","2021","4","12","31"
"2021-12-31","Bureau","Other Agencies","Consumer Financial Protection Bureau","395693","14","21151","1","374542","13","5.345305577809059","7.142857142857143","null","2022","1","2021","4","12","31"
"2021-12-31","Bureau","Other Agencies","Council of Insps. Gen. of Intg. & Effy.","6750","12","0","0","6750","12","0.0","0.0","null","2022","1","2021","4","12","31"
"2021-12-31","Bureau","Other Agencies","Defense Nuclear Facilities Safety Board","0","0","0","0","0","0","0.0","0.0","null","2022","1","2021","4","12","31"
"2021-12-31","Bureau","Other Agencies","Delta Regional Authority","0","0","0","0","0","0","0.0","0.0","null","2022","1","2021","4","12","31"
"2021-12-31","Bureau","Other Agencies","Denali Commission","0","0","0","0","0","0","0.0","0.0","null","2022","1","2021","4","12","31"
"2021-12-31","Bureau","Other Agencies","District of Columbia Government","0","0","0","0","0","0","0.0","0.0","null","2022","1","2021","4","12","31"
"2021-12-31","Bureau","Other Agencies","Election Assistance Commission","5576","1","0","0","5576","1","0.0","0.0","null","2022","1","2021","4","12","31"
"2021-12-31","Bureau","Other Agencies","Federal Housing Finance Agency","0","0","0","0","0","0","0.0","0.0","null","2022","1","2021","4","12","31"
"2021-12-31","Bureau","Other Agencies","Federal Housing Finance Agency OIG","0","0","0","0","0","0","0.0","0.0","null","2022","1","2021","4","12","31"
"2021-12-31","Bureau","Other Agencies","Federal Mine Safety & Health Review Comm","0","0","0","0","0","0","0.0","0.0","null","2022","1","2021","4","12","31"
"2021-12-31","Bureau","Other Agencies","Gulf Coast Ecosystem Restoration Council","0","0","0","0","0","0","0.0","0.0","null","2022","1","2021","4","12","31"
"2021-12-31","Bureau","Other Agencies","James Madison Memorial Fellowship","198966","24","0","0","198966","24","0.0","0.0","null","2022","1","2021","4","12","31"
"2021-12-31","Bureau","Other Agencies","John C. Stennis","2934","2","0","0","2934","2","0.0","0.0","null","2022","1","2021","4","12","31"
"2021-12-31","Bureau","Other Agencies","Millennium Challenge Corporation","0","0","0","0","0","0","0.0","0.0","null","2022","1","2021","4","12","31"
"2021-12-31","Bureau","Other Agencies","Morris K. Udall Scholarship","0","0","0","0","0","0","0.0","0.0","null","2022","1","2021","4","12","31"
"2021-12-31","Bureau","Other Agencies","National Capital Planning Commission","0","0","0","0","0","0","0.0","0.0","null","2022","1","2021","4","12","31"
"2021-12-31","Bureau","Other Agencies","National Council on Disability","1579","2","0","0","1579","2","0.0","0.0","null","2022","1","2021","4","12","31"
"2021-12-31","Bureau","Other Agencies","National Mediation Board","0","0","0","0","0","0","0.0","0.0","null","2022","1","2021","4","12","31"
"2021-12-31","Bureau","Other Agencies","National Transportation Safety Board","0","0","0","0","0","0","0.0","0.0","null","2022","1","2021","4","12","31"
"2021-12-31","Bureau","Other Agencies","Privacy & Civil Liberties Oversight Bd","0","0","0","0","0","0","0.0","0.0","null","2022","1","2021","4","12","31"
"2021-12-31","Bureau","Other Agencies","Surface Transportation Board","0","0","0","0","0","0","0.0","0.0","null","2022","1","2021","4","12","31"
"2021-12-31","Bureau","Other Agencies","U.S.  Agency of Global Media","4930","2","4930","2","0","0","100.0","100.0","null","2022","1","2021","4","12","31"
"2021-12-31","Bureau","Other Agencies","U.S. Holocaust Memorial Council","0","0","0","0","0","0","0.0","0.0","null","2022","1","2021","4","12","31"
"2021-12-31","Bureau","Other Agencies","U.S. Inst. for Env. Conflict Resolution","5003","2","0","0","5003","2","0.0","0.0","null","2022","1","2021","4","12","31"
"2021-12-31","Bureau","Other Agencies","U.S. Institute of Peace","0","0","0","0","0","0","0.0","0.0","null","2022","1","2021","4","12","31"
"2021-12-31","Agency","Other Agencies/Boards/Commissions","null","1024","1","0","0","1024","1","0.0","0.0","Non-CFO","2022","1","2021","4","12","31"
"2021-12-31","Bureau","Other Agencies/Boards/Commissions","Medicare Payment Advisory Commission","0","0","0","0","0","0","0.0","0.0","null","2022","1","2021","4","12","31"
"2021-12-31","Bureau","Other Agencies/Boards/Commissions","Nuclear Waste Technical Review Board","0","0","0","0","0","0","0.0","0.0","null","2022","1","2021","4","12","31"
"2021-12-31","Bureau","Other Agencies/Boards/Commissions","U.S. Comm. on Int. Religious Freedom","1024","1","0","0","1024","1","0.0","0.0","null","2022","1","2021","4","12","31"
"2021-12-31","Bureau","Other Agencies/Boards/Commissions","U.S.-China Security Review Commission","0","0","0","0","0","0","0.0","0.0","null","2022","1","2021","4","12","31"
"2021-12-31","Agency","Pension Benefit Guaranty Corp","null","2595015","745","2595015","745","0","0","100.0","100.0","Non-CFO","2022","1","2021","4","12","31"
"2021-12-31","Bureau","Pension Benefit Guaranty Corp","Pension Benefit Guaranty Corporation","2595015","745","2595015","745","0","0","100.0","100.0","null","2022","1","2021","4","12","31"
"2021-12-31","Agency","Presidio Trust Corporation","null","1469218","66","1469218","66","0","0","100.0","100.0","Non-CFO","2022","1","2021","4","12","31"
"2021-12-31","Bureau","Presidio Trust Corporation","Presidio Trust Corporation","1469218","66","1469218","66","0","0","100.0","100.0","null","2022","1","2021","4","12","31"
"2021-12-31","Agency","Railroad Retirement Board","null","21563120","4161","21563120","4161","0","0","100.0","100.0","Non-CFO","2022","1","2021","4","12","31"
"2021-12-31","Bureau","Railroad Retirement Board","Railroad Retirement Board","21563120","4161","21563120","4161","0","0","100.0","100.0","null","2022","1","2021","4","12","31"
"2021-12-31","Agency","Securities & Exchange Commission","null","2026158381","1078","2026158381","1078","0","0","100.0","100.0","Non-CFO","2022","1","2021","4","12","31"
"2021-12-31","Bureau","Securities & Exchange Commission","SEC Enforcement","2025879703","1027","2025879703","1027","0","0","100.0","100.0","null","2022","1","2021","4","12","31"
"2021-12-31","Bureau","Securities & Exchange Commission","Securities and Exchange Commission","278678","51","278678","51","0","0","100.0","100.0","null","2022","1","2021","4","12","31"
"2021-12-31","Agency","Selective Service System","null","0","0","0","0","0","0","0.0","0.0","Non-CFO","2022","1","2021","4","12","31"
"2021-12-31","Bureau","Selective Service System","Selective Service System","0","0","0","0","0","0","0.0","0.0","null","2022","1","2021","4","12","31"
"2021-12-31","Agency","Small Business Administration","null","12469486128","117869","12469486128","117869","0","0","100.0","100.0","CFO","2022","1","2021","4","12","31"
"2021-12-31","Bureau","Small Business Administration","Small Business Administration","12469486128","117869","12469486128","117869","0","0","100.0","100.0","null","2022","1","2021","4","12","31"
"2021-12-31","Agency","Smithsonian Institution","null","0","0","0","0","0","0","0.0","0.0","Non-CFO","2022","1","2021","4","12","31"
"2021-12-31","Bureau","Smithsonian Institution","Administrative Conference of the US","0","0","0","0","0","0","0.0","0.0","null","2022","1","2021","4","12","31"
"2021-12-31","Bureau","Smithsonian Institution","JFK Center for the Performing Arts","0","0","0","0","0","0","0.0","0.0","null","2022","1","2021","4","12","31"
"2021-12-31","Bureau","Smithsonian Institution","National Gallery of Art","0","0","0","0","0","0","0.0","0.0","null","2022","1","2021","4","12","31"
"2021-12-31","Bureau","Smithsonian Institution","Smithsonian Institution","0","0","0","0","0","0","0.0","0.0","null","2022","1","2021","4","12","31"
"2021-12-31","Agency","Social Security Administration","null","4425385834","1330656","2685680911","460613","1739704923","870043","60.688062278458496","34.6154828896424","CFO","2022","1","2021","4","12","31"
"2021-12-31","Bureau","Social Security Administration","Social Security Administration","4425385834","1330656","2685680911","460613","1739704923","870043","60.688062278458496","34.6154828896424","null","2022","1","2021","4","12","31"
"2021-12-31","Agency","Tennessee Valley Authority","null","0","0","0","0","0","0","0.0","0.0","Non-CFO","2022","1","2021","4","12","31"
"2021-12-31","Bureau","Tennessee Valley Authority","Tennessee Valley Authority","0","0","0","0","0","0","0.0","0.0","null","2022","1","2021","4","12","31"
"2021-12-31","Agency","The Judiciary","null","1053777","299","1041812","172","11965","127","98.86456052846096","57.525083612040135","Non-CFO","2022","1","2021","4","12","31"
"2021-12-31","Bureau","The Judiciary","Administrative Office of the U.S. Courts","1053777","299","1041812","172","11965","127","98.86456052846096","57.525083612040135","null","2022","1","2021","4","12","31"
"2021-12-31","Agency","U.S. Court of Appeals / Veterans Claims","null","938","3","436","2","502","1","46.481876332622605","66.66666666666667","Non-CFO","2022","1","2021","4","12","31"
"2021-12-31","Bureau","U.S. Court of Appeals / Veterans Claims","U.S. Court of Appeals / Veterans Claims","938","3","436","2","502","1","46.481876332622605","66.66666666666667","null","2022","1","2021","4","12","31"
"2021-12-31","Agency","U.S. Postal Service","null","73666650","62720","53352307","51000","20314343","11720","72.42396253935804","81.31377551020408","Non-CFO","2022","1","2021","4","12","31"
"2021-12-31","Bureau","U.S. Postal Service","U.S. Postal Service","73666650","62720","53352307","51000","20314343","11720","72.42396253935804","81.31377551020408","null","2022","1","2021","4","12","31"
"2021-12-31","Agency","U.S. Tax Court","null","0","0","0","0","0","0","0.0","0.0","Non-CFO","2022","1","2021","4","12","31"
"2021-12-31","Bureau","U.S. Tax Court","U.S. Tax Court","0","0","0","0","0","0","0.0","0.0","null","2022","1","2021","4","12","31"
"2021-12-31","Agency","US International Development Fin. Corp.","null","0","0","0","0","0","0","0.0","0.0","Non-CFO","2022","1","2021","4","12","31"
"2021-12-31","Bureau","US International Development Fin. Corp.","US International Development Fin. Corp.","0","0","0","0","0","0","0.0","0.0","null","2022","1","2021","4","12","31"
"2021-09-30","Agency","Agency for International Development","null","38171581","52","38171581","52","0","0","100.0","100.0","CFO","2021","4","2021","3","09","30"
"2021-09-30","Bureau","Agency for International Development","Agency for International Development","38171581","52","38171581","52","0","0","100.0","100.0","null","2021","4","2021","3","09","30"
"2021-09-30","Agency","American Battle Monuments Commission","null","0","0","0","0","0","0","0.0","0.0","Non-CFO","2021","4","2021","3","09","30"
"2021-09-30","Bureau","American Battle Monuments Commission","American Battle Monuments Commission","0","0","0","0","0","0","0.0","0.0","null","2021","4","2021","3","09","30"
"2021-09-30","Agency","Armed Forces Retirement Home","null","116431","117","78519","103","37912","14","67.43822521493416","88.03418803418803","Non-CFO","2021","4","2021","3","09","30"
"2021-09-30","Bureau","Armed Forces Retirement Home","Armed Forces Retirement Home","116431","117","78519","103","37912","14","67.43822521493416","88.03418803418803","null","2021","4","2021","3","09","30"
"2021-09-30","Agency","Commodity Futures Trading Commission","null","659382071","365","659382071","365","0","0","100.0","100.0","Non-CFO","2021","4","2021","3","09","30"
"2021-09-30","Bureau","Commodity Futures Trading Commission","Commodity Futures Trading Commission","659382071","365","659382071","365","0","0","100.0","100.0","null","2021","4","2021","3","09","30"
"2021-09-30","Agency","Consumer Product Safety Commission","null","2500","1","2500","1","0","0","100.0","100.0","Non-CFO","2021","4","2021","3","09","30"
"2021-09-30","Bureau","Consumer Product Safety Commission","Consumer Product Safety Commission","2500","1","2500","1","0","0","100.0","100.0","null","2021","4","2021","3","09","30"
"2021-09-30","Agency","Corp. for National and Community Service","null","4513122","1224","3583083","152","930039","1072","79.39255796763305","12.418300653594772","Non-CFO","2021","4","2021","3","09","30"
"2021-09-30","Bureau","Corp. for National and Community Service","Corp. for National and Community Service","4513122","1224","3583083","152","930039","1072","79.39255796763305","12.418300653594772","null","2021","4","2021","3","09","30"
"2021-09-30","Agency","Department of Agriculture","null","1761824406","58681","1744562237","53901","17262169","4780","99.02021058732002","91.85426287895571","CFO","2021","4","2021","3","09","30"
"2021-09-30","Bureau","Department of Agriculture","Agricultural Marketing Service","5621267","2643","4874781","515","746486","2128","86.72032479510402","19.485433219825957","null","2021","4","2021","3","09","30"
"2021-09-30","Bureau","Department of Agriculture","Commodity Credit Corporation","135916502","10953","135916502","10953","0","0","100.0","100.0","null","2021","4","2021","3","09","30"
"2021-09-30","Bureau","Department of Agriculture","Farm Service Agency","794476421","13726","794476421","13726","0","0","100.0","100.0","null","2021","4","2021","3","09","30"
"2021-09-30","Bureau","Department of Agriculture","Federal Crop Insurance Corporation","14164","415","7863","409","6301","6","55.5139791019486","98.55421686746988","null","2021","4","2021","3","09","30"
"2021-09-30","Bureau","Department of Agriculture","Food Safety and Inspection Service","886058","907","822620","858","63438","49","92.84042353886541","94.59757442116869","null","2021","4","2021","3","09","30"
"2021-09-30","Bureau","Department of Agriculture","Food and Nutrition Service","6683249","264","30965","2","6652284","262","0.463322554643707","0.7575757575757576","null","2021","4","2021","3","09","30"
"2021-09-30","Bureau","Department of Agriculture","Forest Service","69661178","1176","64165878","347","5495300","829","92.11138806754029","29.506802721088434","null","2021","4","2021","3","09","30"
"2021-09-30","Bureau","Department of Agriculture","Rural Development","727731962","25622","727679918","25557","52044","65","99.99284846582017","99.74631176332839","null","2021","4","2021","3","09","30"
"2021-09-30","Bureau","Department of Agriculture","U.S. Department of Agriculture","20833605","2975","16587289","1534","4246316","1441","79.61794898194528","51.563025210084035","null","2021","4","2021","3","09","30"
"2021-09-30","Agency","Department of Commerce","null","56849485","5298","56849485","5298","0","0","100.0","100.0","CFO","2021","4","2021","3","09","30"
"2021-09-30","Bureau","Department of Commerce","Bureau of Industry and Security","35739949","27","35739949","27","0","0","100.0","100.0","null","2021","4","2021","3","09","30"
"2021-09-30","Bureau","Department of Commerce","Bureau of the Census","1841216","3599","1841216","3599","0","0","100.0","100.0","null","2021","4","2021","3","09","30"
"2021-09-30","Bureau","Department of Commerce","Economic Development Administration","5120584","12","5120584","12","0","0","100.0","100.0","null","2021","4","2021","3","09","30"
"2021-09-30","Bureau","Department of Commerce","Economic and Statistical Analysis","0","0","0","0","0","0","0.0","0.0","null","2021","4","2021","3","09","30"
"2021-09-30","Bureau","Department of Commerce","General Administration","4660","1","4660","1","0","0","100.0","100.0","null","2021","4","2021","3","09","30"
"2021-09-30","Bureau","Department of Commerce","International Trade Administration","0","0","0","0","0","0","0.0","0.0","null","2021","4","2021","3","09","30"
"2021-09-30","Bureau","Department of Commerce","Minority Business Development Agency","0","0","0","0","0","0","0.0","0.0","null","2021","4","2021","3","09","30"
"2021-09-30","Bureau","Department of Commerce","NOAA","12616105","922","12616105","922","0","0","100.0","100.0","null","2021","4","2021","3","09","30"
"2021-09-30","Bureau","Department of Commerce","Nat'l Institute of Standards& Technology","673322","5","673322","5","0","0","100.0","100.0","null","2021","4","2021","3","09","30"
"2021-09-30","Bureau","Department of Commerce","Nat'l Telecomm & Information Admin.","296093","1","296093","1","0","0","100.0","100.0","null","2021","4","2021","3","09","30"
"2021-09-30","Bureau","Department of Commerce","National Technical Information Service","0","0","0","0","0","0","0.0","0.0","null","2021","4","2021","3","09","30"
"2021-09-30","Bureau","Department of Commerce","Office of the Inspector General","0","0","0","0","0","0","0.0","0.0","null","2021","4","2021","3","09","30"
"2021-09-30","Bureau","Department of Commerce","Patent and Trademark Office","557556","731","557556","731","0","0","100.0","100.0","null","2021","4","2021","3","09","30"
"2021-09-30","Agency","Department of Defense","null","2610627409","1720843","1012102170","256164","1598525239","1464679","38.7685414820526","14.885959962646215","CFO","2021","4","2021","3","09","30"
"2021-09-30","Bureau","Department of Defense","Consolidated Report","2610627409","1720843","1012102170","256164","1598525239","1464679","38.7685414820526","14.885959962646215","null","2021","4","2021","3","09","30"
"2021-09-30","Agency","Department of Education","null","131395478778","22447357","131070216160","22447012","325262618","345","99.75245524349468","99.99846307073034","CFO","2021","4","2021","3","09","30"
"2021-09-30","Bureau","Department of Education","Departmental Management","1230903779","2188","905641161","1843","325262618","345","73.57530104715033","84.23217550274224","null","2021","4","2021","3","09","30"
"2021-09-30","Bureau","Department of Education","Federal Student Aid","130164574999","22445169","130164574999","22445169","0","0","100.0","100.0","null","2021","4","2021","3","09","30"
"2021-09-30","Bureau","Department of Education","Office of Postsecondary Education","0","0","0","0","0","0","0.0","0.0","null","2021","4","2021","3","09","30"
"2021-09-30","Agency","Department of Energy","null","14391114","90","14391114","90","0","0","100.0","100.0","CFO","2021","4","2021","3","09","30"
"2021-09-30","Bureau","Department of Energy","Bonneville Power Administration","1553703","25","1553703","25","0","0","100.0","100.0","null","2021","4","2021","3","09","30"
"2021-09-30","Bureau","Department of Energy","Energy Consolidated Reports","12837411","65","12837411","65","0","0","100.0","100.0","null","2021","4","2021","3","09","30"
"2021-09-30","Agency","Department of Health & Human Services","null","9618038929","1165437","9435752231","1143675","182286698","21762","98.10474152427919","98.13271759863467","CFO","2021","4","2021","3","09","30"
"2021-09-30","Bureau","Department of Health & Human Services","Administration for Children and Families","31058043","1796","31058043","1796","0","0","100.0","100.0","null","2021","4","2021","3","09","30"
"2021-09-30","Bureau","Department of Health & Human Services","Administration for Community Living","0","0","0","0","0","0","0.0","0.0","null","2021","4","2021","3","09","30"
"2021-09-30","Bureau","Department of Health & Human Services","Centers for Disease Control","12937945","106","157719","18","12780226","88","1.2190421276330978","16.9811320754717","null","2021","4","2021","3","09","30"
"2021-09-30","Bureau","Department of Health & Human Services","Centers for Medicare & Medicaid Services","9305597713","1143660","9227269617","1136651","78328096","7009","99.15826905035262","99.38714303202","null","2021","4","2021","3","09","30"
"2021-09-30","Bureau","Department of Health & Human Services","Food and Drug Administration","112978581","15253","33031289","969","79947292","14284","29.23677099467199","6.352848619943618","null","2021","4","2021","3","09","30"
"2021-09-30","Bureau","Department of Health & Human Services","Health Resources and Services Admin","106511465","644","106511465","644","0","0","100.0","100.0","null","2021","4","2021","3","09","30"
"2021-09-30","Bureau","Department of Health & Human Services","Indian Health Services","24220000","3138","24220000","3138","0","0","100.0","100.0","null","2021","4","2021","3","09","30"
"2021-09-30","Bureau","Department of Health & Human Services","National Institutes of Health","17095227","480","5864143","99","11231084","381","34.30280861435768","20.625","null","2021","4","2021","3","09","30"
"2021-09-30","Bureau","Department of Health & Human Services","Office of the Inspector General","0","0","0","0","0","0","0.0","0.0","null","2021","4","2021","3","09","30"
"2021-09-30","Bureau","Department of Health & Human Services","Office of the Secretary","8371","8","8371","8","0","0","100.0","100.0","null","2021","4","2021","3","09","30"
"2021-09-30","Bureau","Department of Health & Human Services","Program Support Center","6631877","338","6631877","338","0","0","100.0","100.0","null","2021","4","2021","3","09","30"
"2021-09-30","Bureau","Department of Health & Human Services","Substance Abuse & Mental Health Admin.","999707","14","999707","14","0","0","100.0","100.0","null","2021","4","2021","3","09","30"
"2021-09-30","Agency","Department of Homeland Security","null","322734998","61226","317707339","59862","5027659","1364","98.44217112145984","97.77218828602228","CFO","2021","4","2021","3","09","30"
"2021-09-30","Bureau","Department of Homeland Security","Bureau of Customs & Border Protection","8903750","658","8903750","658","0","0","100.0","100.0","null","2021","4","2021","3","09","30"
"2021-09-30","Bureau","Department of Homeland Security","Citizenship and Immigration Services","1015474","1229","1015474","1229","0","0","100.0","100.0","null","2021","4","2021","3","09","30"
"2021-09-30","Bureau","Department of Homeland Security","Domestic Nuclear Detection Office","31397","27","0","0","31397","27","0.0","0.0","null","2021","4","2021","3","09","30"
"2021-09-30","Bureau","Department of Homeland Security","Emergency Preparedness & Resp","215503062","41018","215503062","41018","0","0","100.0","100.0","null","2021","4","2021","3","09","30"
"2021-09-30","Bureau","Department of Homeland Security","Federal Law Enforcement Training Ctr.","0","0","0","0","0","0","0.0","0.0","null","2021","4","2021","3","09","30"
"2021-09-30","Bureau","Department of Homeland Security","Immigration and Customs Enforcement","14003158","595","14003158","595","0","0","100.0","100.0","null","2021","4","2021","3","09","30"
"2021-09-30","Bureau","Department of Homeland Security","Info Analysis Infrastructure Prot-NPPD","0","0","0","0","0","0","0.0","0.0","null","2021","4","2021","3","09","30"
"2021-09-30","Bureau","Department of Homeland Security","Management Headquarters","0","0","0","0","0","0","0.0","0.0","null","2021","4","2021","3","09","30"
"2021-09-30","Bureau","Department of Homeland Security","Office of Biometric Identity Management","0","0","0","0","0","0","0.0","0.0","null","2021","4","2021","3","09","30"
"2021-09-30","Bureau","Department of Homeland Security","Office of Health Affairs","0","0","0","0","0","0","0.0","0.0","null","2021","4","2021","3","09","30"
"2021-09-30","Bureau","Department of Homeland Security","Office of the Inspector General DHS","100","1","100","1","0","0","100.0","100.0","null","2021","4","2021","3","09","30"
"2021-09-30","Bureau","Department of Homeland Security","Science and Technology","0","0","0","0","0","0","0.0","0.0","null","2021","4","2021","3","09","30"
"2021-09-30","Bureau","Department of Homeland Security","Transportation Safety Administration","8175653","5504","8175653","5504","0","0","100.0","100.0","null","2021","4","2021","3","09","30"
"2021-09-30","Bureau","Department of Homeland Security","U.S. Coast Guard","75102404","12194","70106142","10857","4996262","1337","93.34740070371116","89.03559127439725","null","2021","4","2021","3","09","30"
"2021-09-30","Bureau","Department of Homeland Security","U.S. Secret Service","0","0","0","0","0","0","0.0","0.0","null","2021","4","2021","3","09","30"
"2021-09-30","Agency","Department of Housing and Urban Development","null","140078583","4676","139544958","4664","533625","12","99.61905311392249","99.74337040205303","CFO","2021","4","2021","3","09","30"
"2021-09-30","Bureau","Department of Housing and Urban Development","Community Planning and Development","234529","2","234529","2","0","0","100.0","100.0","null","2021","4","2021","3","09","30"
"2021-09-30","Bureau","Department of Housing and Urban Development","Government National Mortgage Association","0","0","0","0","0","0","0.0","0.0","null","2021","4","2021","3","09","30"
"2021-09-30","Bureau","Department of Housing and Urban Development","Housing Programs","139320241","4660","139305110","4659","15131","1","99.9891394101163","99.97854077253218","null","2021","4","2021","3","09","30"
"2021-09-30","Bureau","Department of Housing and Urban Development","Management and Administration","365333","7","4755","2","360578","5","1.301552282438214","28.571428571428573","null","2021","4","2021","3","09","30"
"2021-09-30","Bureau","Department of Housing and Urban Development","Policy, Development and Research","0","0","0","0","0","0","0.0","0.0","null","2021","4","2021","3","09","30"
"2021-09-30","Bureau","Department of Housing and Urban Development","Public and Indian Housing Programs","158480","7","564","1","157916","6","0.3558808682483594","14.285714285714286","null","2021","4","2021","3","09","30"
"2021-09-30","Agency","Department of Justice","null","93558890","38452","89819899","38051","3738991","401","96.00359623762103","98.95714137106002","CFO","2021","4","2021","3","09","30"
"2021-09-30","Bureau","Department of Justice","Bureau of ATF and Explosives","20422","4","20422","4","0","0","100.0","100.0","null","2021","4","2021","3","09","30"
"2021-09-30","Bureau","Department of Justice","Drug Enforcement Administration","315395","22","315395","22","0","0","100.0","100.0","null","2021","4","2021","3","09","30"
"2021-09-30","Bureau","Department of Justice","Federal Bureau of Investigation","330597","79","330597","79","0","0","100.0","100.0","null","2021","4","2021","3","09","30"
"2021-09-30","Bureau","Department of Justice","Federal Prison Industries","661956","183","661956","183","0","0","100.0","100.0","null","2021","4","2021","3","09","30"
"2021-09-30","Bureau","Department of Justice","Federal Prison System","610656","139","610656","139","0","0","100.0","100.0","null","2021","4","2021","3","09","30"
"2021-09-30","Bureau","Department of Justice","General Administration","0","0","0","0","0","0","0.0","0.0","null","2021","4","2021","3","09","30"
"2021-09-30","Bureau","Department of Justice","Legal Activities","91618763","38022","87879772","37621","3738991","401","95.91896803933055","98.945347430435","null","2021","4","2021","3","09","30"
"2021-09-30","Bureau","Department of Justice","Office of Justice Assistance Programs","1101","3","1101","3","0","0","100.0","100.0","null","2021","4","2021","3","09","30"
"2021-09-30","Bureau","Department of Justice","U.S. Marshals Service","0","0","0","0","0","0","0.0","0.0","null","2021","4","2021","3","09","30"
"2021-09-30","Agency","Department of Labor","null","193854491","35315","161683937","16394","32170554","18921","83.40479303107814","46.42220019821605","CFO","2021","4","2021","3","09","30"
"2021-09-30","Bureau","Department of Labor","Bureau of Labor Statistics","13079","1","13079","1","0","0","100.0","100.0","null","2021","4","2021","3","09","30"
"2021-09-30","Bureau","Department of Labor","Departmental Management","0","0","0","0","0","0","0.0","0.0","null","2021","4","2021","3","09","30"
"2021-09-30","Bureau","Department of Labor","Employee Benefit Security Administration","17641527","406","17641527","406","0","0","100.0","100.0","null","2021","4","2021","3","09","30"
"2021-09-30","Bureau","Department of Labor","Employment Standards Administration","89584228","21695","65620817","5714","23963411","15981","73.25041300796832","26.337865867711454","null","2021","4","2021","3","09","30"
"2021-09-30","Bureau","Department of Labor","Employment and Training Administration","1128283","11","1128283","11","0","0","100.0","100.0","null","2021","4","2021","3","09","30"
"2021-09-30","Bureau","Department of Labor","Mine Safety and Health Administration","23376758","7739","18513379","5611","4863379","2128","79.19566519874142","72.50290735237111","null","2021","4","2021","3","09","30"
"2021-09-30","Bureau","Department of Labor","Occupational Safety and Health Admin","62110616","5463","58766852","4651","3343764","812","94.61643722870177","85.13637195680029","null","2021","4","2021","3","09","30"
"2021-09-30","Agency","Department of State","null","19531798","20704","19092293","20496","439505","208","97.74979753528068","98.99536321483771","CFO","2021","4","2021","3","09","30"
"2021-09-30","Bureau","Department of State","Civil Monetary Penalties","0","0","0","0","0","0","0.0","0.0","null","2021","4","2021","3","09","30"
"2021-09-30","Bureau","Department of State","Department of State","17414208","7053","16974703","6845","439505","208","97.47617003311319","97.05090032610237","null","2021","4","2021","3","09","30"
"2021-09-30","Bureau","Department of State","International Commissions","0","0","0","0","0","0","0.0","0.0","null","2021","4","2021","3","09","30"
"2021-09-30","Bureau","Department of State","Passport NSF","2117590","13651","2117590","13651","0","0","100.0","100.0","null","2021","4","2021","3","09","30"
"2021-09-30","Agency","Department of Transportation","null","67427749","7548","67298366","7407","129383","141","99.80811609178886","98.13195548489666","CFO","2021","4","2021","3","09","30"
"2021-09-30","Bureau","Department of Transportation","Federal Aviation Administration","1944003","370","1814620","229","129383","141","93.3445061555975","61.891891891891895","null","2021","4","2021","3","09","30"
"2021-09-30","Bureau","Department of Transportation","Federal Highway Administration","6878","10","6878","10","0","0","100.0","100.0","null","2021","4","2021","3","09","30"
"2021-09-30","Bureau","Department of Transportation","Federal Motor Carrier Safety Admin","63063426","7096","63063426","7096","0","0","100.0","100.0","null","2021","4","2021","3","09","30"
"2021-09-30","Bureau","Department of Transportation","Federal Railroad Administration","128880","13","128880","13","0","0","100.0","100.0","null","2021","4","2021","3","09","30"
"2021-09-30","Bureau","Department of Transportation","Federal Transit Administration","783499","2","783499","2","0","0","100.0","100.0","null","2021","4","2021","3","09","30"
"2021-09-30","Bureau","Department of Transportation","Maritime Administration","6049","6","6049","6","0","0","100.0","100.0","null","2021","4","2021","3","09","30"
"2021-09-30","Bureau","Department of Transportation","National Highway Traffic Safety Admin.","30381","7","30381","7","0","0","100.0","100.0","null","2021","4","2021","3","09","30"
"2021-09-30","Bureau","Department of Transportation","Office of the Inspector General","214","1","214","1","0","0","100.0","100.0","null","2021","4","2021","3","09","30"
"2021-09-30","Bureau","Department of Transportation","Office of the Secretary","1063578","17","1063578","17","0","0","100.0","100.0","null","2021","4","2021","3","09","30"
"2021-09-30","Bureau","Department of Transportation","Pipeline Hazardous Material Safety Admin","397264","24","397264","24","0","0","100.0","100.0","null","2021","4","2021","3","09","30"
"2021-09-30","Bureau","Department of Transportation","Research Innovative Technology Admin","0","0","0","0","0","0","0.0","0.0","null","2021","4","2021","3","09","30"
"2021-09-30","Bureau","Department of Transportation","St. Lawrence Seaway Development Corp.","3577","2","3577","2","0","0","100.0","100.0","null","2021","4","2021","3","09","30"
"2021-09-30","Agency","Department of Veterans Affairs","null","10256380","12755","5948209","8171","4308171","4584","57.995208835866066","64.06115248921991","CFO","2021","4","2021","3","09","30"
"2021-09-30","Bureau","Department of Veterans Affairs","Administration and Cemeteries","1353259","760","39128","23","1314131","737","2.8913903399127587","3.026315789473684","null","2021","4","2021","3","09","30"
"2021-09-30","Bureau","Department of Veterans Affairs","Housing Credit Assistance","1037583","26","0","0","1037583","26","0.0","0.0","null","2021","4","2021","3","09","30"
"2021-09-30","Bureau","Department of Veterans Affairs","Life Insurance","956220","172","956220","172","0","0","100.0","100.0","null","2021","4","2021","3","09","30"
"2021-09-30","Bureau","Department of Veterans Affairs","Medical and Construction","5615275","10098","4952861","7976","662414","2122","88.20335602441554","78.98593780946722","null","2021","4","2021","3","09","30"
"2021-09-30","Bureau","Department of Veterans Affairs","Veterans Benefits","1294043","1699","0","0","1294043","1699","0.0","0.0","null","2021","4","2021","3","09","30"
"2021-09-30","Agency","Department of the Interior","null","71536817","34099","71536817","34099","0","0","100.0","100.0","CFO","2021","4","2021","3","09","30"
"2021-09-30","Bureau","Department of the Interior","Bureau of Indian Affairs","38409503","30398","38409503","30398","0","0","100.0","100.0","null","2021","4","2021","3","09","30"
"2021-09-30","Bureau","Department of the Interior","Bureau of Land Management","8989382","253","8989382","253","0","0","100.0","100.0","null","2021","4","2021","3","09","30"
"2021-09-30","Bureau","Department of the Interior","Bureau of Ocean Energy Mgmt., Reg & Enf","0","0","0","0","0","0","0.0","0.0","null","2021","4","2021","3","09","30"
"2021-09-30","Bureau","Department of the Interior","Bureau of Reclamation","78917","60","78917","60","0","0","100.0","100.0","null","2021","4","2021","3","09","30"
"2021-09-30","Bureau","Department of the Interior","Bureau of Safety and Environmental Enf.","0","0","0","0","0","0","0.0","0.0","null","2021","4","2021","3","09","30"
"2021-09-30","Bureau","Department of the Interior","Fish and Wildlife Service","747049","68","747049","68","0","0","100.0","100.0","null","2021","4","2021","3","09","30"
"2021-09-30","Bureau","Department of the Interior","Geological Survey","114600","336","114600","336","0","0","100.0","100.0","null","2021","4","2021","3","09","30"
"2021-09-30","Bureau","Department of the Interior","National Park Service","8060790","2045","8060790","2045","0","0","100.0","100.0","null","2021","4","2021","3","09","30"
"2021-09-30","Bureau","Department of the Interior","Office of Natural Resources Revenue","7641800","542","7641800","542","0","0","100.0","100.0","null","2021","4","2021","3","09","30"
"2021-09-30","Bureau","Department of the Interior","Office of Surface Mining","7467596","382","7467596","382","0","0","100.0","100.0","null","2021","4","2021","3","09","30"
"2021-09-30","Bureau","Department of the Interior","Office of the Secretary","27180","15","27180","15","0","0","100.0","100.0","null","2021","4","2021","3","09","30"
"2021-09-30","Agency","Department of the Treasury","null","45000116","5186","43877965","5154","1122151","32","97.50633753921879","99.38295410721173","CFO","2021","4","2021","3","09","30"
"2021-09-30","Bureau","Department of the Treasury","Bureau of Engraving and Printing","0","0","0","0","0","0","0.0","0.0","null","2021","4","2021","3","09","30"
"2021-09-30","Bureau","Department of the Treasury","Bureau of the Fiscal Service","13848587","3674","13848587","3674","0","0","100.0","100.0","null","2021","4","2021","3","09","30"
"2021-09-30","Bureau","Department of the Treasury","Community Dev Financial Inst Fund","4547027","9","4547027","9","0","0","100.0","100.0","null","2021","4","2021","3","09","30"
"2021-09-30","Bureau","Department of the Treasury","Comptroller of the Currency","1367981","24","1076790","20","291191","4","78.71381254564209","83.33333333333333","null","2021","4","2021","3","09","30"
"2021-09-30","Bureau","Department of the Treasury","D.C. Pension Program","478419","22","478419","22","0","0","100.0","100.0","null","2021","4","2021","3","09","30"
"2021-09-30","Bureau","Department of the Treasury","Departmental Offices","22943771","1344","22115921","1317","827850","27","96.39183114231746","97.99107142857143","null","2021","4","2021","3","09","30"
"2021-09-30","Bureau","Department of the Treasury","Financial Crimes Enforcement Network","1544945","3","1544945","3","0","0","100.0","100.0","null","2021","4","2021","3","09","30"
"2021-09-30","Bureau","Department of the Treasury","Interest on Tax/Deposit of Earnings","0","0","0","0","0","0","0.0","0.0","null","2021","4","2021","3","09","30"
"2021-09-30","Bureau","Department of the Treasury","Internal Revenue Service","216429","79","216429","79","0","0","100.0","100.0","null","2021","4","2021","3","09","30"
"2021-09-30","Bureau","Department of the Treasury","International Monetary Funds","0","0","0","0","0","0","0.0","0.0","null","2021","4","2021","3","09","30"
"2021-09-30","Bureau","Department of the Treasury","Office of Financial Research","268","1","268","1","0","0","100.0","100.0","null","2021","4","2021","3","09","30"
"2021-09-30","Bureau","Department of the Treasury","Office of Sec International Affairs","0","0","0","0","0","0","0.0","0.0","null","2021","4","2021","3","09","30"
"2021-09-30","Bureau","Department of the Treasury","Office of the Secretary","0","0","0","0","0","0","0.0","0.0","null","2021","4","2021","3","09","30"
"2021-09-30","Bureau","Department of the Treasury","Pandemic Receivables","0","0","0","0","0","0","0.0","0.0","null","2021","4","2021","3","09","30"
"2021-09-30","Bureau","Department of the Treasury","Spec Insp Gen-Troubled Asset Rel Prog","3916","1","3916","1","0","0","100.0","100.0","null","2021","4","2021","3","09","30"
"2021-09-30","Bureau","Department of the Treasury","Tobacco Tax and Trade","1000","1","1000","1","0","0","100.0","100.0","null","2021","4","2021","3","09","30"
"2021-09-30","Bureau","Department of the Treasury","Treasury Forfeiture Fund","0","0","0","0","0","0","0.0","0.0","null","2021","4","2021","3","09","30"
"2021-09-30","Bureau","Department of the Treasury","Treasury Franchise Fund","0","0","0","0","0","0","0.0","0.0","null","2021","4","2021","3","09","30"
"2021-09-30","Bureau","Department of the Treasury","Treasury IG for Tax Admin","0","0","0","0","0","0","0.0","0.0","null","2021","4","2021","3","09","30"
"2021-09-30","Bureau","Department of the Treasury","U.S. Mint","47773","28","44663","27","3110","1","93.49004667908652","96.42857142857143","null","2021","4","2021","3","09","30"
"2021-09-30","Bureau","Department of the Treasury","U.S. Treasury IG Office","0","0","0","0","0","0","0.0","0.0","null","2021","4","2021","3","09","30"
"2021-09-30","Agency","Environmental Protection Agency","null","24814614","240","24814614","240","0","0","100.0","100.0","CFO","2021","4","2021","3","09","30"
"2021-09-30","Bureau","Environmental Protection Agency","Environmental Protection Agency","24814614","240","24814614","240","0","0","100.0","100.0","null","2021","4","2021","3","09","30"
"2021-09-30","Agency","Equal Employment Opportunity Commission","null","29089","16","29089","16","0","0","100.0","100.0","Non-CFO","2021","4","2021","3","09","30"
"2021-09-30","Bureau","Equal Employment Opportunity Commission","Equal Employment Opportunity Commission","29089","16","29089","16","0","0","100.0","100.0","null","2021","4","2021","3","09","30"
"2021-09-30","Agency","Export - Import  Bank","null","0","0","0","0","0","0","0.0","0.0","Non-CFO","2021","4","2021","3","09","30"
"2021-09-30","Bureau","Export - Import  Bank","Export-Import Bank","0","0","0","0","0","0","0.0","0.0","null","2021","4","2021","3","09","30"
"2021-09-30","Agency","Farm Credit Administration","null","630","1","630","1","0","0","100.0","100.0","Non-CFO","2021","4","2021","3","09","30"
"2021-09-30","Bureau","Farm Credit Administration","Farm Credit Administration","630","1","630","1","0","0","100.0","100.0","null","2021","4","2021","3","09","30"
"2021-09-30","Bureau","Farm Credit Administration","Farm Credit System Insurance Corporation","0","0","0","0","0","0","0.0","0.0","null","2021","4","2021","3","09","30"
"2021-09-30","Agency","Federal Communications Commission","null","211614926","11336","211614926","11336","0","0","100.0","100.0","Non-CFO","2021","4","2021","3","09","30"
"2021-09-30","Bureau","Federal Communications Commission","Federal Communications Commission","211614926","11336","211614926","11336","0","0","100.0","100.0","null","2021","4","2021","3","09","30"
"2021-09-30","Agency","Federal Deposit Insurance Corporation","null","0","0","0","0","0","0","0.0","0.0","Non-CFO","2021","4","2021","3","09","30"
"2021-09-30","Bureau","Federal Deposit Insurance Corporation","Federal Deposit Insurance Corporation","0","0","0","0","0","0","0.0","0.0","null","2021","4","2021","3","09","30"
"2021-09-30","Agency","Federal Election Commission","null","1020864","164","1020864","164","0","0","100.0","100.0","Non-CFO","2021","4","2021","3","09","30"
"2021-09-30","Bureau","Federal Election Commission","Federal Election Commission","1020864","164","1020864","164","0","0","100.0","100.0","null","2021","4","2021","3","09","30"
"2021-09-30","Agency","Federal Labor Relations Authority","null","0","0","0","0","0","0","0.0","0.0","Non-CFO","2021","4","2021","3","09","30"
"2021-09-30","Bureau","Federal Labor Relations Authority","Federal Labor Relations Authority","0","0","0","0","0","0","0.0","0.0","null","2021","4","2021","3","09","30"
"2021-09-30","Agency","Federal Maritime Commission","null","397392","6","397392","6","0","0","100.0","100.0","Non-CFO","2021","4","2021","3","09","30"
"2021-09-30","Bureau","Federal Maritime Commission","Salaries and Expenses","397392","6","397392","6","0","0","100.0","100.0","null","2021","4","2021","3","09","30"
"2021-09-30","Agency","Federal Mediation/Conciliation Service","null","0","0","0","0","0","0","0.0","0.0","Non-CFO","2021","4","2021","3","09","30"
"2021-09-30","Bureau","Federal Mediation/Conciliation Service","Federal Mediation/Conciliation Service","0","0","0","0","0","0","0.0","0.0","null","2021","4","2021","3","09","30"
"2021-09-30","Agency","Federal Trade Commission","null","483084342","55","483084342","55","0","0","100.0","100.0","Non-CFO","2021","4","2021","3","09","30"
"2021-09-30","Bureau","Federal Trade Commission","Federal Trade Commission","483084342","55","483084342","55","0","0","100.0","100.0","null","2021","4","2021","3","09","30"
"2021-09-30","Agency","Funds Appropriated to the President","null","1235225","6","0","0","1235225","6","0.0","0.0","Non-CFO","2021","4","2021","3","09","30"
"2021-09-30","Bureau","Funds Appropriated to the President","African Development Foundation","0","0","0","0","0","0","0.0","0.0","null","2021","4","2021","3","09","30"
"2021-09-30","Bureau","Funds Appropriated to the President","Defense Security Assistance Agency","0","0","0","0","0","0","0.0","0.0","null","2021","4","2021","3","09","30"
"2021-09-30","Bureau","Funds Appropriated to the President","Executive Branch","0","0","0","0","0","0","0.0","0.0","null","2021","4","2021","3","09","30"
"2021-09-30","Bureau","Funds Appropriated to the President","Inter-American Foundation","0","0","0","0","0","0","0.0","0.0","null","2021","4","2021","3","09","30"
"2021-09-30","Bureau","Funds Appropriated to the President","Peace Corps","0","0","0","0","0","0","0.0","0.0","null","2021","4","2021","3","09","30"
"2021-09-30","Bureau","Funds Appropriated to the President","Trade and Development Agency","1235225","6","0","0","1235225","6","0.0","0.0","null","2021","4","2021","3","09","30"
"2021-09-30","Agency","General Services Administration","null","10426078","1504","10115073","1237","311005","267","97.01704706218388","82.24734042553192","CFO","2021","4","2021","3","09","30"
"2021-09-30","Bureau","General Services Administration","General Services Administration","10426078","1504","10115073","1237","311005","267","97.01704706218388","82.24734042553192","null","2021","4","2021","3","09","30"
"2021-09-30","Agency","Legis Branch-Library of Congress","null","0","0","0","0","0","0","0.0","0.0","Non-CFO","2021","4","2021","3","09","30"
"2021-09-30","Bureau","Legis Branch-Library of Congress","Library of Congress","0","0","0","0","0","0","0.0","0.0","null","2021","4","2021","3","09","30"
"2021-09-30","Agency","Legislative Branch - U.S. House/Senate","null","219316","173","0","0","219316","173","0.0","0.0","Non-CFO","2021","4","2021","3","09","30"
"2021-09-30","Bureau","Legislative Branch - U.S. House/Senate","U.S. House of Representatives","219316","173","0","0","219316","173","0.0","0.0","null","2021","4","2021","3","09","30"
"2021-09-30","Agency","Legislative Branch-CBO","null","0","0","0","0","0","0","0.0","0.0","Non-CFO","2021","4","2021","3","09","30"
"2021-09-30","Bureau","Legislative Branch-CBO","Congressional Budget Office","0","0","0","0","0","0","0.0","0.0","null","2021","4","2021","3","09","30"
"2021-09-30","Agency","Legislative Branch-GAO","null","29464","8","29464","8","0","0","100.0","100.0","Non-CFO","2021","4","2021","3","09","30"
"2021-09-30","Bureau","Legislative Branch-GAO","Government Accountability Office","29464","8","29464","8","0","0","100.0","100.0","null","2021","4","2021","3","09","30"
"2021-09-30","Agency","Legislative Branch-GPO","null","75651","9","75651","9","0","0","100.0","100.0","Non-CFO","2021","4","2021","3","09","30"
"2021-09-30","Bureau","Legislative Branch-GPO","Government Publishing Office","75651","9","75651","9","0","0","100.0","100.0","null","2021","4","2021","3","09","30"
"2021-09-30","Agency","Legislative Branch-Office of Tech.","null","0","0","0","0","0","0","0.0","0.0","Non-CFO","2021","4","2021","3","09","30"
"2021-09-30","Bureau","Legislative Branch-Office of Tech.","Medicaid & CHIP Payment & Access Comm.","0","0","0","0","0","0","0.0","0.0","null","2021","4","2021","3","09","30"
"2021-09-30","Bureau","Legislative Branch-Office of Tech.","Open World Leadership","0","0","0","0","0","0","0.0","0.0","null","2021","4","2021","3","09","30"
"2021-09-30","Agency","Merit Systems Protection Board","null","144","1","144","1","0","0","100.0","100.0","Non-CFO","2021","4","2021","3","09","30"
"2021-09-30","Bureau","Merit Systems Protection Board","Merit Systems Protection Board","144","1","144","1","0","0","100.0","100.0","null","2021","4","2021","3","09","30"
"2021-09-30","Agency","National Aeronautics and Space Administration","null","1307058","126","1307058","126","0","0","100.0","100.0","CFO","2021","4","2021","3","09","30"
"2021-09-30","Bureau","National Aeronautics and Space Administration","National Aeronautics and Space Admin","1307058","126","1307058","126","0","0","100.0","100.0","null","2021","4","2021","3","09","30"
"2021-09-30","Agency","National Archives & Records Admin","null","117766","103","117766","103","0","0","100.0","100.0","Non-CFO","2021","4","2021","3","09","30"
"2021-09-30","Bureau","National Archives & Records Admin","Nat'l Archives & Records Administration","117766","103","117766","103","0","0","100.0","100.0","null","2021","4","2021","3","09","30"
"2021-09-30","Agency","National Credit Union Administration","null","2996","8","0","0","2996","8","0.0","0.0","Non-CFO","2021","4","2021","3","09","30"
"2021-09-30","Bureau","National Credit Union Administration","National Credit Union Administration","2996","8","0","0","2996","8","0.0","0.0","null","2021","4","2021","3","09","30"
"2021-09-30","Agency","National Foundation  Arts & Humanities","null","0","0","0","0","0","0","0.0","0.0","Non-CFO","2021","4","2021","3","09","30"
"2021-09-30","Bureau","National Foundation  Arts & Humanities","National Endowment for the Arts","0","0","0","0","0","0","0.0","0.0","null","2021","4","2021","3","09","30"
"2021-09-30","Bureau","National Foundation  Arts & Humanities","National Endowment for the Humanities","0","0","0","0","0","0","0.0","0.0","null","2021","4","2021","3","09","30"
"2021-09-30","Agency","National Labor Relations Board","null","0","0","0","0","0","0","0.0","0.0","Non-CFO","2021","4","2021","3","09","30"
"2021-09-30","Bureau","National Labor Relations Board","National Labor Relations Board","0","0","0","0","0","0","0.0","0.0","null","2021","4","2021","3","09","30"
"2021-09-30","Agency","National Science Foundation","null","527228","66","527228","66","0","0","100.0","100.0","CFO","2021","4","2021","3","09","30"
"2021-09-30","Bureau","National Science Foundation","National Science Foundation","527228","66","527228","66","0","0","100.0","100.0","null","2021","4","2021","3","09","30"
"2021-09-30","Agency","Neighborhood Reinvestment Corporation","null","0","0","0","0","0","0","0.0","0.0","Non-CFO","2021","4","2021","3","09","30"
"2021-09-30","Bureau","Neighborhood Reinvestment Corporation","Neighborhood Reinvestment Corporation","0","0","0","0","0","0","0.0","0.0","null","2021","4","2021","3","09","30"
"2021-09-30","Agency","Nuclear Regulatory Commission","null","2940093","364","2940093","364","0","0","100.0","100.0","CFO","2021","4","2021","3","09","30"
"2021-09-30","Bureau","Nuclear Regulatory Commission","Nuclear Regulatory Commission","2940093","364","2940093","364","0","0","100.0","100.0","null","2021","4","2021","3","09","30"
"2021-09-30","Agency","Occupational Safety & Health Rev Comm","null","0","0","0","0","0","0","0.0","0.0","Non-CFO","2021","4","2021","3","09","30"
"2021-09-30","Bureau","Occupational Safety & Health Rev Comm","Occupational Safety & Health Rev Comm","0","0","0","0","0","0","0.0","0.0","null","2021","4","2021","3","09","30"
"2021-09-30","Agency","Office of Compliance","null","0","0","0","0","0","0","0.0","0.0","Non-CFO","2021","4","2021","3","09","30"
"2021-09-30","Bureau","Office of Compliance","Office of Compliance","0","0","0","0","0","0","0.0","0.0","null","2021","4","2021","3","09","30"
"2021-09-30","Agency","Office of Government Ethics","null","0","0","0","0","0","0","0.0","0.0","Non-CFO","2021","4","2021","3","09","30"
"2021-09-30","Bureau","Office of Government Ethics","Office of Government Ethics","0","0","0","0","0","0","0.0","0.0","null","2021","4","2021","3","09","30"
"2021-09-30","Agency","Office of Personnel Management","null","24100234","1386","21891874","1215","2208360","171","90.83676946871138","87.66233766233766","CFO","2021","4","2021","3","09","30"
"2021-09-30","Bureau","Office of Personnel Management","Office of Personnel Management","24100234","1386","21891874","1215","2208360","171","90.83676946871138","87.66233766233766","null","2021","4","2021","3","09","30"
"2021-09-30","Agency","Office of Special Counsel","null","0","0","0","0","0","0","0.0","0.0","Non-CFO","2021","4","2021","3","09","30"
"2021-09-30","Bureau","Office of Special Counsel","Office of Special Counsel","0","0","0","0","0","0","0.0","0.0","null","2021","4","2021","3","09","30"
"2021-09-30","Agency","Other Agencies","null","711237","92","28264","6","682973","86","3.9739214917109207","6.521739130434782","Non-CFO","2021","4","2021","3","09","30"
"2021-09-30","Bureau","Other Agencies","Advisory Council on Hist. Preservation","0","0","0","0","0","0","0.0","0.0","null","2021","4","2021","3","09","30"
"2021-09-30","Bureau","Other Agencies","Archit.&Trans. Barriers Compliance Bd","0","0","0","0","0","0","0.0","0.0","null","2021","4","2021","3","09","30"
"2021-09-30","Bureau","Other Agencies","Architect of the Capitol","27849","18","0","0","27849","18","0.0","0.0","null","2021","4","2021","3","09","30"
"2021-09-30","Bureau","Other Agencies","Chemical Safety Board","32420","2","0","0","32420","2","0.0","0.0","null","2021","4","2021","3","09","30"
"2021-09-30","Bureau","Other Agencies","Comm. for Purchase from Blind/Handic.","0","0","0","0","0","0","0.0","0.0","null","2021","4","2021","3","09","30"
"2021-09-30","Bureau","Other Agencies","Commission On Fine Arts","0","0","0","0","0","0","0.0","0.0","null","2021","4","2021","3","09","30"
"2021-09-30","Bureau","Other Agencies","Consumer Financial Protection Bureau","402191","25","21151","1","381040","24","5.258944133508706","4.0","null","2021","4","2021","3","09","30"
"2021-09-30","Bureau","Other Agencies","Council of Insps. Gen. of Intg. & Effy.","5350","9","0","0","5350","9","0.0","0.0","null","2021","4","2021","3","09","30"
"2021-09-30","Bureau","Other Agencies","Defense Nuclear Facilities Safety Board","0","0","0","0","0","0","0.0","0.0","null","2021","4","2021","3","09","30"
"2021-09-30","Bureau","Other Agencies","Delta Regional Authority","0","0","0","0","0","0","0.0","0.0","null","2021","4","2021","3","09","30"
"2021-09-30","Bureau","Other Agencies","Denali Commission","0","0","0","0","0","0","0.0","0.0","null","2021","4","2021","3","09","30"
"2021-09-30","Bureau","Other Agencies","District of Columbia Government","0","0","0","0","0","0","0.0","0.0","null","2021","4","2021","3","09","30"
"2021-09-30","Bureau","Other Agencies","Election Assistance Commission","5576","1","0","0","5576","1","0.0","0.0","null","2021","4","2021","3","09","30"
"2021-09-30","Bureau","Other Agencies","Federal Housing Finance Agency","1366","2","1366","2","0","0","100.0","100.0","null","2021","4","2021","3","09","30"
"2021-09-30","Bureau","Other Agencies","Federal Housing Finance Agency OIG","0","0","0","0","0","0","0.0","0.0","null","2021","4","2021","3","09","30"
"2021-09-30","Bureau","Other Agencies","Federal Mine Safety & Health Review Comm","0","0","0","0","0","0","0.0","0.0","null","2021","4","2021","3","09","30"
"2021-09-30","Bureau","Other Agencies","Gulf Coast Ecosystem Restoration Council","0","0","0","0","0","0","0.0","0.0","null","2021","4","2021","3","09","30"
"2021-09-30","Bureau","Other Agencies","James Madison Memorial Fellowship","221222","26","0","0","221222","26","0.0","0.0","null","2021","4","2021","3","09","30"
"2021-09-30","Bureau","Other Agencies","John C. Stennis","2934","2","0","0","2934","2","0.0","0.0","null","2021","4","2021","3","09","30"
"2021-09-30","Bureau","Other Agencies","Millennium Challenge Corporation","817","1","817","1","0","0","100.0","100.0","null","2021","4","2021","3","09","30"
"2021-09-30","Bureau","Other Agencies","Morris K. Udall Scholarship","0","0","0","0","0","0","0.0","0.0","null","2021","4","2021","3","09","30"
"2021-09-30","Bureau","Other Agencies","National Capital Planning Commission","0","0","0","0","0","0","0.0","0.0","null","2021","4","2021","3","09","30"
"2021-09-30","Bureau","Other Agencies","National Council on Disability","1579","2","0","0","1579","2","0.0","0.0","null","2021","4","2021","3","09","30"
"2021-09-30","Bureau","Other Agencies","National Mediation Board","0","0","0","0","0","0","0.0","0.0","null","2021","4","2021","3","09","30"
"2021-09-30","Bureau","Other Agencies","National Transportation Safety Board","0","0","0","0","0","0","0.0","0.0","null","2021","4","2021","3","09","30"
"2021-09-30","Bureau","Other Agencies","Privacy & Civil Liberties Oversight Bd","0","0","0","0","0","0","0.0","0.0","null","2021","4","2021","3","09","30"
"2021-09-30","Bureau","Other Agencies","Surface Transportation Board","0","0","0","0","0","0","0.0","0.0","null","2021","4","2021","3","09","30"
"2021-09-30","Bureau","Other Agencies","U.S.  Agency of Global Media","4930","2","4930","2","0","0","100.0","100.0","null","2021","4","2021","3","09","30"
"2021-09-30","Bureau","Other Agencies","U.S. Holocaust Memorial Council","0","0","0","0","0","0","0.0","0.0","null","2021","4","2021","3","09","30"
"2021-09-30","Bureau","Other Agencies","U.S. Inst. for Env. Conflict Resolution","5003","2","0","0","5003","2","0.0","0.0","null","2021","4","2021","3","09","30"
"2021-09-30","Bureau","Other Agencies","U.S. Institute of Peace","0","0","0","0","0","0","0.0","0.0","null","2021","4","2021","3","09","30"
"2021-09-30","Agency","Other Agencies/Boards/Commissions","null","1024","1","0","0","1024","1","0.0","0.0","Non-CFO","2021","4","2021","3","09","30"
"2021-09-30","Bureau","Other Agencies/Boards/Commissions","Medicare Payment Advisory Commission","0","0","0","0","0","0","0.0","0.0","null","2021","4","2021","3","09","30"
"2021-09-30","Bureau","Other Agencies/Boards/Commissions","U.S. Comm. on Int. Religious Freedom","1024","1","0","0","1024","1","0.0","0.0","null","2021","4","2021","3","09","30"
"2021-09-30","Bureau","Other Agencies/Boards/Commissions","U.S.-China Security Review Commission","0","0","0","0","0","0","0.0","0.0","null","2021","4","2021","3","09","30"
"2021-09-30","Agency","Pension Benefit Guaranty Corp","null","3509718","1077","3509718","1077","0","0","100.0","100.0","Non-CFO","2021","4","2021","3","09","30"
"2021-09-30","Bureau","Pension Benefit Guaranty Corp","Pension Benefit Guaranty Corporation","3509718","1077","3509718","1077","0","0","100.0","100.0","null","2021","4","2021","3","09","30"
"2021-09-30","Agency","Presidio Trust Corporation","null","1457939","67","1457939","67","0","0","100.0","100.0","Non-CFO","2021","4","2021","3","09","30"
"2021-09-30","Bureau","Presidio Trust Corporation","Presidio Trust Corporation","1457939","67","1457939","67","0","0","100.0","100.0","null","2021","4","2021","3","09","30"
"2021-09-30","Agency","Railroad Retirement Board","null","21683492","4196","21683492","4196","0","0","100.0","100.0","Non-CFO","2021","4","2021","3","09","30"
"2021-09-30","Bureau","Railroad Retirement Board","Railroad Retirement Board","21683492","4196","21683492","4196","0","0","100.0","100.0","null","2021","4","2021","3","09","30"
"2021-09-30","Agency","Securities & Exchange Commission","null","2001689850","1087","2001689850","1087","0","0","100.0","100.0","Non-CFO","2021","4","2021","3","09","30"
"2021-09-30","Bureau","Securities & Exchange Commission","SEC Enforcement","2001391662","1035","2001391662","1035","0","0","100.0","100.0","null","2021","4","2021","3","09","30"
"2021-09-30","Bureau","Securities & Exchange Commission","Securities and Exchange Commission","298188","52","298188","52","0","0","100.0","100.0","null","2021","4","2021","3","09","30"
"2021-09-30","Agency","Selective Service System","null","0","0","0","0","0","0","0.0","0.0","Non-CFO","2021","4","2021","3","09","30"
"2021-09-30","Bureau","Selective Service System","Selective Service System","0","0","0","0","0","0","0.0","0.0","null","2021","4","2021","3","09","30"
"2021-09-30","Agency","Small Business Administration","null","12471591443","118174","12471591443","118174","0","0","100.0","100.0","CFO","2021","4","2021","3","09","30"
"2021-09-30","Bureau","Small Business Administration","Small Business Administration","12471591443","118174","12471591443","118174","0","0","100.0","100.0","null","2021","4","2021","3","09","30"
"2021-09-30","Agency","Smithsonian Institution","null","6970","1","0","0","6970","1","0.0","0.0","Non-CFO","2021","4","2021","3","09","30"
"2021-09-30","Bureau","Smithsonian Institution","Administrative Conference of the US","0","0","0","0","0","0","0.0","0.0","null","2021","4","2021","3","09","30"
"2021-09-30","Bureau","Smithsonian Institution","JFK Center for the Performing Arts","0","0","0","0","0","0","0.0","0.0","null","2021","4","2021","3","09","30"
"2021-09-30","Bureau","Smithsonian Institution","National Gallery of Art","0","0","0","0","0","0","0.0","0.0","null","2021","4","2021","3","09","30"
"2021-09-30","Bureau","Smithsonian Institution","Smithsonian Institution","6970","1","0","0","6970","1","0.0","0.0","null","2021","4","2021","3","09","30"
"2021-09-30","Agency","Social Security Administration","null","4346303894","1299667","2703627637","465540","1642676257","834127","62.20521396886934","35.81994464735967","CFO","2021","4","2021","3","09","30"
"2021-09-30","Bureau","Social Security Administration","Social Security Administration","4346303894","1299667","2703627637","465540","1642676257","834127","62.20521396886934","35.81994464735967","null","2021","4","2021","3","09","30"
"2021-09-30","Agency","Tennessee Valley Authority","null","0","0","0","0","0","0","0.0","0.0","Non-CFO","2021","4","2021","3","09","30"
"2021-09-30","Bureau","Tennessee Valley Authority","Tennessee Valley Authority","0","0","0","0","0","0","0.0","0.0","null","2021","4","2021","3","09","30"
"2021-09-30","Agency","The Judiciary","null","1063436","303","1051471","176","11965","127","98.87487352318334","58.085808580858085","Non-CFO","2021","4","2021","3","09","30"
"2021-09-30","Bureau","The Judiciary","Administrative Office of the U.S. Courts","1063436","303","1051471","176","11965","127","98.87487352318334","58.085808580858085","null","2021","4","2021","3","09","30"
"2021-09-30","Agency","U.S. Court of Appeals / Veterans Claims","null","921","3","429","2","492","1","46.579804560260584","66.66666666666667","Non-CFO","2021","4","2021","3","09","30"
"2021-09-30","Bureau","U.S. Court of Appeals / Veterans Claims","U.S. Court of Appeals / Veterans Claims","921","3","429","2","492","1","46.579804560260584","66.66666666666667","null","2021","4","2021","3","09","30"
"2021-09-30","Agency","U.S. Postal Service","null","70030694","60344","57410325","52731","12620369","7613","81.97880346580601","87.38399840912103","Non-CFO","2021","4","2021","3","09","30"
"2021-09-30","Bureau","U.S. Postal Service","U.S. Postal Service","70030694","60344","57410325","52731","12620369","7613","81.97880346580601","87.38399840912103","null","2021","4","2021","3","09","30"
"2021-09-30","Agency","U.S. Tax Court","null","0","0","0","0","0","0","0.0","0.0","Non-CFO","2021","4","2021","3","09","30"
"2021-09-30","Bureau","U.S. Tax Court","U.S. Tax Court","0","0","0","0","0","0","0.0","0.0","null","2021","4","2021","3","09","30"
"2021-09-30","Agency","US International Development Fin. Corp.","null","0","0","0","0","0","0","0.0","0.0","Non-CFO","2021","4","2021","3","09","30"
"2021-09-30","Bureau","US International Development Fin. Corp.","US International Development Fin. Corp.","0","0","0","0","0","0","0.0","0.0","null","2021","4","2021","3","09","30"
"2021-06-30","Agency","Agency for International Development","null","37221816","59","37221816","59","0","0","100.0","100.0","CFO","2021","3","2021","2","06","30"
"2021-06-30","Bureau","Agency for International Development","Agency for International Development","37221816","59","37221816","59","0","0","100.0","100.0","null","2021","3","2021","2","06","30"
"2021-06-30","Agency","American Battle Monuments Commission","null","0","0","0","0","0","0","0.0","0.0","Non-CFO","2021","3","2021","2","06","30"
"2021-06-30","Bureau","American Battle Monuments Commission","American Battle Monuments Commission","0","0","0","0","0","0","0.0","0.0","null","2021","3","2021","2","06","30"
"2021-06-30","Agency","Armed Forces Retirement Home","null","113825","123","80508","104","33317","19","70.72962881616516","84.55284552845528","Non-CFO","2021","3","2021","2","06","30"
"2021-06-30","Bureau","Armed Forces Retirement Home","Armed Forces Retirement Home","113825","123","80508","104","33317","19","70.72962881616516","84.55284552845528","null","2021","3","2021","2","06","30"
"2021-06-30","Agency","Commodity Futures Trading Commission","null","656882406","365","656882406","365","0","0","100.0","100.0","Non-CFO","2021","3","2021","2","06","30"
"2021-06-30","Bureau","Commodity Futures Trading Commission","Commodity Futures Trading Commission","656882406","365","656882406","365","0","0","100.0","100.0","null","2021","3","2021","2","06","30"
"2021-06-30","Agency","Consumer Product Safety Commission","null","2500","1","2500","1","0","0","100.0","100.0","Non-CFO","2021","3","2021","2","06","30"
"2021-06-30","Bureau","Consumer Product Safety Commission","Consumer Product Safety Commission","2500","1","2500","1","0","0","100.0","100.0","null","2021","3","2021","2","06","30"
"2021-06-30","Agency","Corp. for National and Community Service","null","4492561","1168","3583432","152","909129","1016","79.76368044863497","13.013698630136986","Non-CFO","2021","3","2021","2","06","30"
"2021-06-30","Bureau","Corp. for National and Community Service","Corp. for National and Community Service","4492561","1168","3583432","152","909129","1016","79.76368044863497","13.013698630136986","null","2021","3","2021","2","06","30"
"2021-06-30","Agency","Department of Agriculture","null","1579407525","54457","1561171710","50920","18235815","3537","98.84540153751642","93.50496722184475","CFO","2021","3","2021","2","06","30"
"2021-06-30","Bureau","Department of Agriculture","Agricultural Marketing Service","5073706","1660","4576132","515","497574","1145","90.19308568529591","31.02409638554217","null","2021","3","2021","2","06","30"
"2021-06-30","Bureau","Department of Agriculture","Commodity Credit Corporation","138035294","10832","138035294","10832","0","0","100.0","100.0","null","2021","3","2021","2","06","30"
"2021-06-30","Bureau","Department of Agriculture","Farm Service Agency","624134663","13870","624134663","13870","0","0","100.0","100.0","null","2021","3","2021","2","06","30"
"2021-06-30","Bureau","Department of Agriculture","Federal Crop Insurance Corporation","27446","410","23013","409","4433","1","83.84828390293667","99.7560975609756","null","2021","3","2021","2","06","30"
"2021-06-30","Bureau","Department of Agriculture","Food Safety and Inspection Service","893379","669","865399","646","27980","23","96.86807055012487","96.56203288490283","null","2021","3","2021","2","06","30"
"2021-06-30","Bureau","Department of Agriculture","Food and Nutrition Service","6908908","287","49264","6","6859644","281","0.7130504560199673","2.0905923344947737","null","2021","3","2021","2","06","30"
"2021-06-30","Bureau","Department of Agriculture","Forest Service","69808042","1194","63119954","330","6688088","864","90.41931587194496","27.63819095477387","null","2021","3","2021","2","06","30"
"2021-06-30","Bureau","Department of Agriculture","Rural Development","713516698","22762","713510545","22754","6153","8","99.99913765157602","99.964853703541","null","2021","3","2021","2","06","30"
"2021-06-30","Bureau","Department of Agriculture","U.S. Department of Agriculture","21009389","2773","16857446","1558","4151943","1215","80.23767849698056","56.18463757663181","null","2021","3","2021","2","06","30"
"2021-06-30","Agency","Department of Commerce","null","61849348","1900","61849348","1900","0","0","100.0","100.0","CFO","2021","3","2021","2","06","30"
"2021-06-30","Bureau","Department of Commerce","Bureau of Industry and Security","35047203","25","35047203","25","0","0","100.0","100.0","null","2021","3","2021","2","06","30"
"2021-06-30","Bureau","Department of Commerce","Bureau of the Census","316591","427","316591","427","0","0","100.0","100.0","null","2021","3","2021","2","06","30"
"2021-06-30","Bureau","Department of Commerce","Economic Development Administration","5121576","12","5121576","12","0","0","100.0","100.0","null","2021","3","2021","2","06","30"
"2021-06-30","Bureau","Department of Commerce","Economic and Statistical Analysis","0","0","0","0","0","0","0.0","0.0","null","2021","3","2021","2","06","30"
"2021-06-30","Bureau","Department of Commerce","General Administration","4660","1","4660","1","0","0","100.0","100.0","null","2021","3","2021","2","06","30"
"2021-06-30","Bureau","Department of Commerce","International Trade Administration","0","0","0","0","0","0","0.0","0.0","null","2021","3","2021","2","06","30"
"2021-06-30","Bureau","Department of Commerce","Minority Business Development Agency","0","0","0","0","0","0","0.0","0.0","null","2021","3","2021","2","06","30"
"2021-06-30","Bureau","Department of Commerce","NOAA","19930572","872","19930572","872","0","0","100.0","100.0","null","2021","3","2021","2","06","30"
"2021-06-30","Bureau","Department of Commerce","Nat'l Institute of Standards& Technology","686743","5","686743","5","0","0","100.0","100.0","null","2021","3","2021","2","06","30"
"2021-06-30","Bureau","Department of Commerce","Nat'l Telecomm & Information Admin.","296094","1","296094","1","0","0","100.0","100.0","null","2021","3","2021","2","06","30"
"2021-06-30","Bureau","Department of Commerce","National Technical Information Service","0","0","0","0","0","0","0.0","0.0","null","2021","3","2021","2","06","30"
"2021-06-30","Bureau","Department of Commerce","Office of the Inspector General","0","0","0","0","0","0","0.0","0.0","null","2021","3","2021","2","06","30"
"2021-06-30","Bureau","Department of Commerce","Patent and Trademark Office","445909","557","445909","557","0","0","100.0","100.0","null","2021","3","2021","2","06","30"
"2021-06-30","Agency","Department of Defense","null","2387889757","1713526","2275194869","1635369","112694888","78157","95.28056570996883","95.43882030386466","CFO","2021","3","2021","2","06","30"
"2021-06-30","Bureau","Department of Defense","Consolidated Report","2387889757","1713526","2275194869","1635369","112694888","78157","95.28056570996883","95.43882030386466","null","2021","3","2021","2","06","30"
"2021-06-30","Agency","Department of Education","null","133200811871","22911324","133135053331","22910996","65758540","328","99.95063202763082","99.9985683935158","CFO","2021","3","2021","2","06","30"
"2021-06-30","Bureau","Department of Education","Departmental Management","970686301","2147","904927761","1819","65758540","328","93.22556216851359","84.72286911970191","null","2021","3","2021","2","06","30"
"2021-06-30","Bureau","Department of Education","Federal Student Aid","132230125570","22909177","132230125570","22909177","0","0","100.0","100.0","null","2021","3","2021","2","06","30"
"2021-06-30","Bureau","Department of Education","Office of Postsecondary Education","0","0","0","0","0","0","0.0","0.0","null","2021","3","2021","2","06","30"
"2021-06-30","Agency","Department of Energy","null","14516619","99","14516619","99","0","0","100.0","100.0","CFO","2021","3","2021","2","06","30"
"2021-06-30","Bureau","Department of Energy","Bonneville Power Administration","1553865","25","1553865","25","0","0","100.0","100.0","null","2021","3","2021","2","06","30"
"2021-06-30","Bureau","Department of Energy","Energy Consolidated Reports","12962754","74","12962754","74","0","0","100.0","100.0","null","2021","3","2021","2","06","30"
"2021-06-30","Agency","Department of Health & Human Services","null","9625926158","1183456","9448463131","1156495","177463027","26961","98.15640568931113","97.72184179217479","CFO","2021","3","2021","2","06","30"
"2021-06-30","Bureau","Department of Health & Human Services","Administration for Children and Families","29939817","1829","29939817","1829","0","0","100.0","100.0","null","2021","3","2021","2","06","30"
"2021-06-30","Bureau","Department of Health & Human Services","Administration for Community Living","0","0","0","0","0","0","0.0","0.0","null","2021","3","2021","2","06","30"
"2021-06-30","Bureau","Department of Health & Human Services","Centers for Disease Control","14977884","97","155274","18","14822610","79","1.0366884935148384","18.556701030927837","null","2021","3","2021","2","06","30"
"2021-06-30","Bureau","Department of Health & Human Services","Centers for Medicare & Medicaid Services","9313656602","1163280","9242064487","1149132","71592115","14148","99.23132107979345","98.78378378378379","null","2021","3","2021","2","06","30"
"2021-06-30","Bureau","Department of Health & Human Services","Food and Drug Administration","116603011","13583","37848157","1207","78754854","12376","32.45898770144109","8.88610763454318","null","2021","3","2021","2","06","30"
"2021-06-30","Bureau","Department of Health & Human Services","Health Resources and Services Admin","98926442","621","98926442","621","0","0","100.0","100.0","null","2021","3","2021","2","06","30"
"2021-06-30","Bureau","Department of Health & Human Services","Indian Health Services","25762058","3224","25762058","3224","0","0","100.0","100.0","null","2021","3","2021","2","06","30"
"2021-06-30","Bureau","Department of Health & Human Services","National Institutes of Health","18248946","457","5955498","99","12293448","358","32.634750522030146","21.663019693654267","null","2021","3","2021","2","06","30"
"2021-06-30","Bureau","Department of Health & Human Services","Office of the Inspector General","0","0","0","0","0","0","0.0","0.0","null","2021","3","2021","2","06","30"
"2021-06-30","Bureau","Department of Health & Human Services","Office of the Secretary","9105","8","9105","8","0","0","100.0","100.0","null","2021","3","2021","2","06","30"
"2021-06-30","Bureau","Department of Health & Human Services","Program Support Center","6815834","343","6815834","343","0","0","100.0","100.0","null","2021","3","2021","2","06","30"
"2021-06-30","Bureau","Department of Health & Human Services","Substance Abuse & Mental Health Admin.","986459","14","986459","14","0","0","100.0","100.0","null","2021","3","2021","2","06","30"
"2021-06-30","Agency","Department of Homeland Security","null","366156212","62520","366125188","62504","31024","16","99.99152711356977","99.9744081893794","CFO","2021","3","2021","2","06","30"
"2021-06-30","Bureau","Department of Homeland Security","Bureau of Customs & Border Protection","8789350","603","8789350","603","0","0","100.0","100.0","null","2021","3","2021","2","06","30"
"2021-06-30","Bureau","Department of Homeland Security","Citizenship and Immigration Services","1032159","1244","1032159","1244","0","0","100.0","100.0","null","2021","3","2021","2","06","30"
"2021-06-30","Bureau","Department of Homeland Security","Domestic Nuclear Detection Office","31024","16","0","0","31024","16","0.0","0.0","null","2021","3","2021","2","06","30"
"2021-06-30","Bureau","Department of Homeland Security","Emergency Preparedness & Resp","251239364","41146","251239364","41146","0","0","100.0","100.0","null","2021","3","2021","2","06","30"
"2021-06-30","Bureau","Department of Homeland Security","Federal Law Enforcement Training Ctr.","0","0","0","0","0","0","0.0","0.0","null","2021","3","2021","2","06","30"
"2021-06-30","Bureau","Department of Homeland Security","Immigration and Customs Enforcement","13939302","591","13939302","591","0","0","100.0","100.0","null","2021","3","2021","2","06","30"
"2021-06-30","Bureau","Department of Homeland Security","Info Analysis Infrastructure Prot-NPPD","0","0","0","0","0","0","0.0","0.0","null","2021","3","2021","2","06","30"
"2021-06-30","Bureau","Department of Homeland Security","Management Headquarters","0","0","0","0","0","0","0.0","0.0","null","2021","3","2021","2","06","30"
"2021-06-30","Bureau","Department of Homeland Security","Office of Biometric Identity Management","0","0","0","0","0","0","0.0","0.0","null","2021","3","2021","2","06","30"
"2021-06-30","Bureau","Department of Homeland Security","Office of Health Affairs","0","0","0","0","0","0","0.0","0.0","null","2021","3","2021","2","06","30"
"2021-06-30","Bureau","Department of Homeland Security","Office of the Inspector General DHS","100","1","100","1","0","0","100.0","100.0","null","2021","3","2021","2","06","30"
"2021-06-30","Bureau","Department of Homeland Security","Science and Technology","0","0","0","0","0","0","0.0","0.0","null","2021","3","2021","2","06","30"
"2021-06-30","Bureau","Department of Homeland Security","Transportation Safety Administration","8222583","5843","8222583","5843","0","0","100.0","100.0","null","2021","3","2021","2","06","30"
"2021-06-30","Bureau","Department of Homeland Security","U.S. Coast Guard","82902330","13076","82902330","13076","0","0","100.0","100.0","null","2021","3","2021","2","06","30"
"2021-06-30","Bureau","Department of Homeland Security","U.S. Secret Service","0","0","0","0","0","0","0.0","0.0","null","2021","3","2021","2","06","30"
"2021-06-30","Agency","Department of Housing and Urban Development","null","142831627","4813","141792495","4807","1039132","6","99.27247765650671","99.87533762725951","CFO","2021","3","2021","2","06","30"
"2021-06-30","Bureau","Department of Housing and Urban Development","Community Planning and Development","101371","1","101371","1","0","0","100.0","100.0","null","2021","3","2021","2","06","30"
"2021-06-30","Bureau","Department of Housing and Urban Development","Government National Mortgage Association","0","0","0","0","0","0","0.0","0.0","null","2021","3","2021","2","06","30"
"2021-06-30","Bureau","Department of Housing and Urban Development","Housing Programs","139935091","4797","139935091","4797","0","0","100.0","100.0","null","2021","3","2021","2","06","30"
"2021-06-30","Bureau","Department of Housing and Urban Development","Management and Administration","904447","11","8078","7","896369","4","0.8931424395238196","63.63636363636363","null","2021","3","2021","2","06","30"
"2021-06-30","Bureau","Department of Housing and Urban Development","Policy, Development and Research","0","0","0","0","0","0","0.0","0.0","null","2021","3","2021","2","06","30"
"2021-06-30","Bureau","Department of Housing and Urban Development","Public and Indian Housing Programs","1890718","4","1747955","2","142763","2","92.4492705945572","50.0","null","2021","3","2021","2","06","30"
"2021-06-30","Agency","Department of Justice","null","93794403","38308","89365741","37863","4428662","445","95.2783302005771","98.83836274407435","CFO","2021","3","2021","2","06","30"
"2021-06-30","Bureau","Department of Justice","Bureau of ATF and Explosives","20422","4","20422","4","0","0","100.0","100.0","null","2021","3","2021","2","06","30"
"2021-06-30","Bureau","Department of Justice","Drug Enforcement Administration","326271","23","326271","23","0","0","100.0","100.0","null","2021","3","2021","2","06","30"
"2021-06-30","Bureau","Department of Justice","Federal Bureau of Investigation","296086","64","296086","64","0","0","100.0","100.0","null","2021","3","2021","2","06","30"
"2021-06-30","Bureau","Department of Justice","Federal Prison Industries","1043089","183","1043089","183","0","0","100.0","100.0","null","2021","3","2021","2","06","30"
"2021-06-30","Bureau","Department of Justice","Federal Prison System","862854","124","862854","124","0","0","100.0","100.0","null","2021","3","2021","2","06","30"
"2021-06-30","Bureau","Department of Justice","General Administration","0","0","0","0","0","0","0.0","0.0","null","2021","3","2021","2","06","30"
"2021-06-30","Bureau","Department of Justice","Legal Activities","91244580","37907","86815918","37462","4428662","445","95.14638348929876","98.82607433983169","null","2021","3","2021","2","06","30"
"2021-06-30","Bureau","Department of Justice","Office of Justice Assistance Programs","1101","3","1101","3","0","0","100.0","100.0","null","2021","3","2021","2","06","30"
"2021-06-30","Bureau","Department of Justice","U.S. Marshals Service","0","0","0","0","0","0","0.0","0.0","null","2021","3","2021","2","06","30"
"2021-06-30","Agency","Department of Labor","null","198215539","46517","170921518","34454","27294021","12063","86.23013052473146","74.06754519852957","CFO","2021","3","2021","2","06","30"
"2021-06-30","Bureau","Department of Labor","Bureau of Labor Statistics","10260","1","10260","1","0","0","100.0","100.0","null","2021","3","2021","2","06","30"
"2021-06-30","Bureau","Department of Labor","Departmental Management","0","0","0","0","0","0","0.0","0.0","null","2021","3","2021","2","06","30"
"2021-06-30","Bureau","Department of Labor","Employee Benefit Security Administration","17032718","385","17032718","385","0","0","100.0","100.0","null","2021","3","2021","2","06","30"
"2021-06-30","Bureau","Department of Labor","Employment Standards Administration","94906801","33372","77735913","24155","17170888","9217","81.9076316775233","72.38103799592473","null","2021","3","2021","2","06","30"
"2021-06-30","Bureau","Department of Labor","Employment and Training Administration","3369968","11","0","0","3369968","11","0.0","0.0","null","2021","3","2021","2","06","30"
"2021-06-30","Bureau","Department of Labor","Mine Safety and Health Administration","23789860","7718","18542075","5304","5247785","2414","77.94108498326598","68.72246696035242","null","2021","3","2021","2","06","30"
"2021-06-30","Bureau","Department of Labor","Occupational Safety and Health Admin","59105932","5030","57600552","4609","1505380","421","97.45308135907577","91.63021868787277","null","2021","3","2021","2","06","30"
"2021-06-30","Agency","Department of State","null","20460958","22352","20106028","22288","354930","64","98.26533048941306","99.71367215461704","CFO","2021","3","2021","2","06","30"
"2021-06-30","Bureau","Department of State","Civil Monetary Penalties","0","0","0","0","0","0","0.0","0.0","null","2021","3","2021","2","06","30"
"2021-06-30","Bureau","Department of State","Department of State","18263170","8200","17908240","8136","354930","64","98.05658053886593","99.21951219512195","null","2021","3","2021","2","06","30"
"2021-06-30","Bureau","Department of State","International Commissions","0","0","0","0","0","0","0.0","0.0","null","2021","3","2021","2","06","30"
"2021-06-30","Bureau","Department of State","Passport NSF","2197788","14152","2197788","14152","0","0","100.0","100.0","null","2021","3","2021","2","06","30"
"2021-06-30","Agency","Department of Transportation","null","66249525","7362","66177155","7344","72370","18","99.89076148093137","99.75550122249389","CFO","2021","3","2021","2","06","30"
"2021-06-30","Bureau","Department of Transportation","Federal Aviation Administration","1898394","254","1826287","238","72107","16","96.20168416040084","93.7007874015748","null","2021","3","2021","2","06","30"
"2021-06-30","Bureau","Department of Transportation","Federal Highway Administration","4533","5","4533","5","0","0","100.0","100.0","null","2021","3","2021","2","06","30"
"2021-06-30","Bureau","Department of Transportation","Federal Motor Carrier Safety Admin","61952358","7039","61952287","7038","71","1","99.99988539580688","99.98579343656769","null","2021","3","2021","2","06","30"
"2021-06-30","Bureau","Department of Transportation","Federal Railroad Administration","132418","12","132418","12","0","0","100.0","100.0","null","2021","3","2021","2","06","30"
"2021-06-30","Bureau","Department of Transportation","Federal Transit Administration","784879","3","784879","3","0","0","100.0","100.0","null","2021","3","2021","2","06","30"
"2021-06-30","Bureau","Department of Transportation","Maritime Administration","4385","4","4385","4","0","0","100.0","100.0","null","2021","3","2021","2","06","30"
"2021-06-30","Bureau","Department of Transportation","National Highway Traffic Safety Admin.","18516","3","18516","3","0","0","100.0","100.0","null","2021","3","2021","2","06","30"
"2021-06-30","Bureau","Department of Transportation","Office of the Inspector General","214","1","214","1","0","0","100.0","100.0","null","2021","3","2021","2","06","30"
"2021-06-30","Bureau","Department of Transportation","Office of the Secretary","1051969","14","1051969","14","0","0","100.0","100.0","null","2021","3","2021","2","06","30"
"2021-06-30","Bureau","Department of Transportation","Pipeline Hazardous Material Safety Admin","393939","24","393939","24","0","0","100.0","100.0","null","2021","3","2021","2","06","30"
"2021-06-30","Bureau","Department of Transportation","Research Innovative Technology Admin","0","0","0","0","0","0","0.0","0.0","null","2021","3","2021","2","06","30"
"2021-06-30","Bureau","Department of Transportation","St. Lawrence Seaway Development Corp.","7920","3","7728","2","192","1","97.57575757575758","66.66666666666667","null","2021","3","2021","2","06","30"
"2021-06-30","Agency","Department of Veterans Affairs","null","11135561","12214","5508675","7681","5626886","4533","49.4692184794282","62.886851154412966","CFO","2021","3","2021","2","06","30"
"2021-06-30","Bureau","Department of Veterans Affairs","Administration and Cemeteries","1220082","809","40976","26","1179106","783","3.358462791845138","3.2138442521631645","null","2021","3","2021","2","06","30"
"2021-06-30","Bureau","Department of Veterans Affairs","Housing Credit Assistance","945386","24","0","0","945386","24","0.0","0.0","null","2021","3","2021","2","06","30"
"2021-06-30","Bureau","Department of Veterans Affairs","Life Insurance","867243","156","867243","156","0","0","100.0","100.0","null","2021","3","2021","2","06","30"
"2021-06-30","Bureau","Department of Veterans Affairs","Medical and Construction","6807140","9523","4600456","7499","2206684","2024","67.58280276298122","78.74619342644125","null","2021","3","2021","2","06","30"
"2021-06-30","Bureau","Department of Veterans Affairs","Veterans Benefits","1295710","1702","0","0","1295710","1702","0.0","0.0","null","2021","3","2021","2","06","30"
"2021-06-30","Agency","Department of the Interior","null","80029326","30287","80029235","30282","91","5","99.99988629168263","99.98349126688018","CFO","2021","3","2021","2","06","30"
"2021-06-30","Bureau","Department of the Interior","Bureau of Indian Affairs","40162958","26658","40162867","26653","91","5","99.99977342306312","99.9812439042689","null","2021","3","2021","2","06","30"
"2021-06-30","Bureau","Department of the Interior","Bureau of Land Management","15839939","327","15839939","327","0","0","100.0","100.0","null","2021","3","2021","2","06","30"
"2021-06-30","Bureau","Department of the Interior","Bureau of Ocean Energy Mgmt., Reg & Enf","0","0","0","0","0","0","0.0","0.0","null","2021","3","2021","2","06","30"
"2021-06-30","Bureau","Department of the Interior","Bureau of Reclamation","83331","67","83331","67","0","0","100.0","100.0","null","2021","3","2021","2","06","30"
"2021-06-30","Bureau","Department of the Interior","Bureau of Safety and Environmental Enf.","0","0","0","0","0","0","0.0","0.0","null","2021","3","2021","2","06","30"
"2021-06-30","Bureau","Department of the Interior","Fish and Wildlife Service","751787","72","751787","72","0","0","100.0","100.0","null","2021","3","2021","2","06","30"
"2021-06-30","Bureau","Department of the Interior","Geological Survey","123074","417","123074","417","0","0","100.0","100.0","null","2021","3","2021","2","06","30"
"2021-06-30","Bureau","Department of the Interior","National Park Service","7864749","1807","7864749","1807","0","0","100.0","100.0","null","2021","3","2021","2","06","30"
"2021-06-30","Bureau","Department of the Interior","Office of Natural Resources Revenue","8100158","560","8100158","560","0","0","100.0","100.0","null","2021","3","2021","2","06","30"
"2021-06-30","Bureau","Department of the Interior","Office of Surface Mining","6492779","362","6492779","362","0","0","100.0","100.0","null","2021","3","2021","2","06","30"
"2021-06-30","Bureau","Department of the Interior","Office of the Secretary","610551","17","610551","17","0","0","100.0","100.0","null","2021","3","2021","2","06","30"
"2021-06-30","Agency","Department of the Treasury","null","44363167","5152","43531016","5123","832151","29","98.12422994958858","99.43711180124224","CFO","2021","3","2021","2","06","30"
"2021-06-30","Bureau","Department of the Treasury","Bureau of Engraving and Printing","84528","1","84528","1","0","0","100.0","100.0","null","2021","3","2021","2","06","30"
"2021-06-30","Bureau","Department of the Treasury","Bureau of the Fiscal Service","14003648","3631","14003648","3631","0","0","100.0","100.0","null","2021","3","2021","2","06","30"
"2021-06-30","Bureau","Department of the Treasury","Community Dev Financial Inst Fund","4634951","10","4634951","10","0","0","100.0","100.0","null","2021","3","2021","2","06","30"
"2021-06-30","Bureau","Department of the Treasury","Comptroller of the Currency","1086523","21","1085332","20","1191","1","99.89038428086658","95.23809523809524","null","2021","3","2021","2","06","30"
"2021-06-30","Bureau","Department of the Treasury","D.C. Pension Program","388850","21","388850","21","0","0","100.0","100.0","null","2021","3","2021","2","06","30"
"2021-06-30","Bureau","Department of the Treasury","Departmental Offices","22346500","1365","21518650","1338","827850","27","96.29539301456605","98.02197802197803","null","2021","3","2021","2","06","30"
"2021-06-30","Bureau","Department of the Treasury","Financial Crimes Enforcement Network","1544945","3","1544945","3","0","0","100.0","100.0","null","2021","3","2021","2","06","30"
"2021-06-30","Bureau","Department of the Treasury","Interest on Tax/Deposit of Earnings","0","0","0","0","0","0","0.0","0.0","null","2021","3","2021","2","06","30"
"2021-06-30","Bureau","Department of the Treasury","Internal Revenue Service","217736","70","217736","70","0","0","100.0","100.0","null","2021","3","2021","2","06","30"
"2021-06-30","Bureau","Department of the Treasury","International Monetary Funds","0","0","0","0","0","0","0.0","0.0","null","2021","3","2021","2","06","30"
"2021-06-30","Bureau","Department of the Treasury","Office of Financial Research","0","0","0","0","0","0","0.0","0.0","null","2021","3","2021","2","06","30"
"2021-06-30","Bureau","Department of the Treasury","Office of Sec International Affairs","0","0","0","0","0","0","0.0","0.0","null","2021","3","2021","2","06","30"
"2021-06-30","Bureau","Department of the Treasury","Office of the Secretary","0","0","0","0","0","0","0.0","0.0","null","2021","3","2021","2","06","30"
"2021-06-30","Bureau","Department of the Treasury","Pandemic Receivables","0","0","0","0","0","0","0.0","0.0","null","2021","3","2021","2","06","30"
"2021-06-30","Bureau","Department of the Treasury","Spec Insp Gen-Troubled Asset Rel Prog","3916","1","3916","1","0","0","100.0","100.0","null","2021","3","2021","2","06","30"
"2021-06-30","Bureau","Department of the Treasury","Tobacco Tax and Trade","1000","1","1000","1","0","0","100.0","100.0","null","2021","3","2021","2","06","30"
"2021-06-30","Bureau","Department of the Treasury","Treasury Forfeiture Fund","0","0","0","0","0","0","0.0","0.0","null","2021","3","2021","2","06","30"
"2021-06-30","Bureau","Department of the Treasury","Treasury Franchise Fund","0","0","0","0","0","0","0.0","0.0","null","2021","3","2021","2","06","30"
"2021-06-30","Bureau","Department of the Treasury","Treasury IG for Tax Admin","0","0","0","0","0","0","0.0","0.0","null","2021","3","2021","2","06","30"
"2021-06-30","Bureau","Department of the Treasury","U.S. Mint","50570","28","47460","27","3110","1","93.85010876013446","96.42857142857143","null","2021","3","2021","2","06","30"
"2021-06-30","Bureau","Department of the Treasury","U.S. Treasury IG Office","0","0","0","0","0","0","0.0","0.0","null","2021","3","2021","2","06","30"
"2021-06-30","Agency","Environmental Protection Agency","null","24643592","236","24643592","236","0","0","100.0","100.0","CFO","2021","3","2021","2","06","30"
"2021-06-30","Bureau","Environmental Protection Agency","Environmental Protection Agency","24643592","236","24643592","236","0","0","100.0","100.0","null","2021","3","2021","2","06","30"
"2021-06-30","Agency","Equal Employment Opportunity Commission","null","27704","15","27704","15","0","0","100.0","100.0","Non-CFO","2021","3","2021","2","06","30"
"2021-06-30","Bureau","Equal Employment Opportunity Commission","Equal Employment Opportunity Commission","27704","15","27704","15","0","0","100.0","100.0","null","2021","3","2021","2","06","30"
"2021-06-30","Agency","Export - Import  Bank","null","0","0","0","0","0","0","0.0","0.0","Non-CFO","2021","3","2021","2","06","30"
"2021-06-30","Bureau","Export - Import  Bank","Export-Import Bank","0","0","0","0","0","0","0.0","0.0","null","2021","3","2021","2","06","30"
"2021-06-30","Agency","Farm Credit Administration","null","630","1","630","1","0","0","100.0","100.0","Non-CFO","2021","3","2021","2","06","30"
"2021-06-30","Bureau","Farm Credit Administration","Farm Credit Administration","630","1","630","1","0","0","100.0","100.0","null","2021","3","2021","2","06","30"
"2021-06-30","Bureau","Farm Credit Administration","Farm Credit System Insurance Corporation","0","0","0","0","0","0","0.0","0.0","null","2021","3","2021","2","06","30"
"2021-06-30","Agency","Federal Communications Commission","null","211982293","3721","211982293","3721","0","0","100.0","100.0","Non-CFO","2021","3","2021","2","06","30"
"2021-06-30","Bureau","Federal Communications Commission","Federal Communications Commission","211982293","3721","211982293","3721","0","0","100.0","100.0","null","2021","3","2021","2","06","30"
"2021-06-30","Agency","Federal Deposit Insurance Corporation","null","0","0","0","0","0","0","0.0","0.0","Non-CFO","2021","3","2021","2","06","30"
"2021-06-30","Bureau","Federal Deposit Insurance Corporation","Federal Deposit Insurance Corporation","0","0","0","0","0","0","0.0","0.0","null","2021","3","2021","2","06","30"
"2021-06-30","Agency","Federal Election Commission","null","903738","145","903738","145","0","0","100.0","100.0","Non-CFO","2021","3","2021","2","06","30"
"2021-06-30","Bureau","Federal Election Commission","Federal Election Commission","903738","145","903738","145","0","0","100.0","100.0","null","2021","3","2021","2","06","30"
"2021-06-30","Agency","Federal Labor Relations Authority","null","0","0","0","0","0","0","0.0","0.0","Non-CFO","2021","3","2021","2","06","30"
"2021-06-30","Bureau","Federal Labor Relations Authority","Federal Labor Relations Authority","0","0","0","0","0","0","0.0","0.0","null","2021","3","2021","2","06","30"
"2021-06-30","Agency","Federal Maritime Commission","null","397266","6","397266","6","0","0","100.0","100.0","Non-CFO","2021","3","2021","2","06","30"
"2021-06-30","Bureau","Federal Maritime Commission","Salaries and Expenses","397266","6","397266","6","0","0","100.0","100.0","null","2021","3","2021","2","06","30"
"2021-06-30","Agency","Federal Mediation/Conciliation Service","null","0","0","0","0","0","0","0.0","0.0","Non-CFO","2021","3","2021","2","06","30"
"2021-06-30","Bureau","Federal Mediation/Conciliation Service","Federal Mediation/Conciliation Service","0","0","0","0","0","0","0.0","0.0","null","2021","3","2021","2","06","30"
"2021-06-30","Agency","Federal Trade Commission","null","483052147","55","483052147","55","0","0","100.0","100.0","Non-CFO","2021","3","2021","2","06","30"
"2021-06-30","Bureau","Federal Trade Commission","Federal Trade Commission","483052147","55","483052147","55","0","0","100.0","100.0","null","2021","3","2021","2","06","30"
"2021-06-30","Agency","Funds Appropriated to the President","null","1236200","7","0","0","1236200","7","0.0","0.0","Non-CFO","2021","3","2021","2","06","30"
"2021-06-30","Bureau","Funds Appropriated to the President","African Development Foundation","0","0","0","0","0","0","0.0","0.0","null","2021","3","2021","2","06","30"
"2021-06-30","Bureau","Funds Appropriated to the President","Defense Security Assistance Agency","0","0","0","0","0","0","0.0","0.0","null","2021","3","2021","2","06","30"
"2021-06-30","Bureau","Funds Appropriated to the President","Executive Branch","0","0","0","0","0","0","0.0","0.0","null","2021","3","2021","2","06","30"
"2021-06-30","Bureau","Funds Appropriated to the President","Inter-American Foundation","0","0","0","0","0","0","0.0","0.0","null","2021","3","2021","2","06","30"
"2021-06-30","Bureau","Funds Appropriated to the President","Peace Corps","0","0","0","0","0","0","0.0","0.0","null","2021","3","2021","2","06","30"
"2021-06-30","Bureau","Funds Appropriated to the President","Trade and Development Agency","1236200","7","0","0","1236200","7","0.0","0.0","null","2021","3","2021","2","06","30"
"2021-06-30","Agency","General Services Administration","null","7071032","1979","4406589","1136","2664443","843","62.31889489398436","57.40272865083375","CFO","2021","3","2021","2","06","30"
"2021-06-30","Bureau","General Services Administration","General Services Administration","7071032","1979","4406589","1136","2664443","843","62.31889489398436","57.40272865083375","null","2021","3","2021","2","06","30"
"2021-06-30","Agency","Legis Branch-Library of Congress","null","0","0","0","0","0","0","0.0","0.0","Non-CFO","2021","3","2021","2","06","30"
"2021-06-30","Bureau","Legis Branch-Library of Congress","Library of Congress","0","0","0","0","0","0","0.0","0.0","null","2021","3","2021","2","06","30"
"2021-06-30","Agency","Legislative Branch - U.S. House/Senate","null","242304","167","0","0","242304","167","0.0","0.0","Non-CFO","2021","3","2021","2","06","30"
"2021-06-30","Bureau","Legislative Branch - U.S. House/Senate","U.S. House of Representatives","242304","167","0","0","242304","167","0.0","0.0","null","2021","3","2021","2","06","30"
"2021-06-30","Agency","Legislative Branch-CBO","null","0","0","0","0","0","0","0.0","0.0","Non-CFO","2021","3","2021","2","06","30"
"2021-06-30","Bureau","Legislative Branch-CBO","Congressional Budget Office","0","0","0","0","0","0","0.0","0.0","null","2021","3","2021","2","06","30"
"2021-06-30","Agency","Legislative Branch-GAO","null","0","0","0","0","0","0","0.0","0.0","Non-CFO","2021","3","2021","2","06","30"
"2021-06-30","Bureau","Legislative Branch-GAO","Government Accountability Office","0","0","0","0","0","0","0.0","0.0","null","2021","3","2021","2","06","30"
"2021-06-30","Agency","Legislative Branch-GPO","null","142392","58","75651","9","66741","49","53.128687004887915","15.517241379310345","Non-CFO","2021","3","2021","2","06","30"
"2021-06-30","Bureau","Legislative Branch-GPO","Government Publishing Office","142392","58","75651","9","66741","49","53.128687004887915","15.517241379310345","null","2021","3","2021","2","06","30"
"2021-06-30","Agency","Legislative Branch-Office of Tech.","null","0","0","0","0","0","0","0.0","0.0","Non-CFO","2021","3","2021","2","06","30"
"2021-06-30","Bureau","Legislative Branch-Office of Tech.","Medicaid & CHIP Payment & Access Comm.","0","0","0","0","0","0","0.0","0.0","null","2021","3","2021","2","06","30"
"2021-06-30","Bureau","Legislative Branch-Office of Tech.","Open World Leadership","0","0","0","0","0","0","0.0","0.0","null","2021","3","2021","2","06","30"
"2021-06-30","Agency","Merit Systems Protection Board","null","144","1","144","1","0","0","100.0","100.0","Non-CFO","2021","3","2021","2","06","30"
"2021-06-30","Bureau","Merit Systems Protection Board","Merit Systems Protection Board","144","1","144","1","0","0","100.0","100.0","null","2021","3","2021","2","06","30"
"2021-06-30","Agency","National Aeronautics and Space Administration","null","1215551","120","1215551","120","0","0","100.0","100.0","CFO","2021","3","2021","2","06","30"
"2021-06-30","Bureau","National Aeronautics and Space Administration","National Aeronautics and Space Admin","1215551","120","1215551","120","0","0","100.0","100.0","null","2021","3","2021","2","06","30"
"2021-06-30","Agency","National Archives & Records Admin","null","130359","107","130359","107","0","0","100.0","100.0","Non-CFO","2021","3","2021","2","06","30"
"2021-06-30","Bureau","National Archives & Records Admin","Nat'l Archives & Records Administration","130359","107","130359","107","0","0","100.0","100.0","null","2021","3","2021","2","06","30"
"2021-06-30","Agency","National Credit Union Administration","null","1319","5","0","0","1319","5","0.0","0.0","Non-CFO","2021","3","2021","2","06","30"
"2021-06-30","Bureau","National Credit Union Administration","National Credit Union Administration","1319","5","0","0","1319","5","0.0","0.0","null","2021","3","2021","2","06","30"
"2021-06-30","Agency","National Foundation  Arts & Humanities","null","0","0","0","0","0","0","0.0","0.0","Non-CFO","2021","3","2021","2","06","30"
"2021-06-30","Bureau","National Foundation  Arts & Humanities","National Endowment for the Arts","0","0","0","0","0","0","0.0","0.0","null","2021","3","2021","2","06","30"
"2021-06-30","Bureau","National Foundation  Arts & Humanities","National Endowment for the Humanities","0","0","0","0","0","0","0.0","0.0","null","2021","3","2021","2","06","30"
"2021-06-30","Agency","National Labor Relations Board","null","0","0","0","0","0","0","0.0","0.0","Non-CFO","2021","3","2021","2","06","30"
"2021-06-30","Bureau","National Labor Relations Board","National Labor Relations Board","0","0","0","0","0","0","0.0","0.0","null","2021","3","2021","2","06","30"
"2021-06-30","Agency","National Science Foundation","null","533678","78","533678","78","0","0","100.0","100.0","CFO","2021","3","2021","2","06","30"
"2021-06-30","Bureau","National Science Foundation","National Science Foundation","533678","78","533678","78","0","0","100.0","100.0","null","2021","3","2021","2","06","30"
"2021-06-30","Agency","Neighborhood Reinvestment Corporation","null","0","0","0","0","0","0","0.0","0.0","Non-CFO","2021","3","2021","2","06","30"
"2021-06-30","Bureau","Neighborhood Reinvestment Corporation","Neighborhood Reinvestment Corporation","0","0","0","0","0","0","0.0","0.0","null","2021","3","2021","2","06","30"
"2021-06-30","Agency","Nuclear Regulatory Commission","null","2609778","323","2609778","323","0","0","100.0","100.0","CFO","2021","3","2021","2","06","30"
"2021-06-30","Bureau","Nuclear Regulatory Commission","Nuclear Regulatory Commission","2609778","323","2609778","323","0","0","100.0","100.0","null","2021","3","2021","2","06","30"
"2021-06-30","Agency","Occupational Safety & Health Rev Comm","null","0","0","0","0","0","0","0.0","0.0","Non-CFO","2021","3","2021","2","06","30"
"2021-06-30","Bureau","Occupational Safety & Health Rev Comm","Occupational Safety & Health Rev Comm","0","0","0","0","0","0","0.0","0.0","null","2021","3","2021","2","06","30"
"2021-06-30","Agency","Office of Compliance","null","0","0","0","0","0","0","0.0","0.0","Non-CFO","2021","3","2021","2","06","30"
"2021-06-30","Bureau","Office of Compliance","Office of Compliance","0","0","0","0","0","0","0.0","0.0","null","2021","3","2021","2","06","30"
"2021-06-30","Agency","Office of Government Ethics","null","0","0","0","0","0","0","0.0","0.0","Non-CFO","2021","3","2021","2","06","30"
"2021-06-30","Bureau","Office of Government Ethics","Office of Government Ethics","0","0","0","0","0","0","0.0","0.0","null","2021","3","2021","2","06","30"
"2021-06-30","Agency","Office of Personnel Management","null","23232482","1450","21619195","1319","1613287","131","93.05589906407761","90.96551724137932","CFO","2021","3","2021","2","06","30"
"2021-06-30","Bureau","Office of Personnel Management","Office of Personnel Management","23232482","1450","21619195","1319","1613287","131","93.05589906407761","90.96551724137932","null","2021","3","2021","2","06","30"
"2021-06-30","Agency","Office of Special Counsel","null","0","0","0","0","0","0","0.0","0.0","Non-CFO","2021","3","2021","2","06","30"
"2021-06-30","Bureau","Office of Special Counsel","Office of Special Counsel","0","0","0","0","0","0","0.0","0.0","null","2021","3","2021","2","06","30"
"2021-06-30","Agency","Other Agencies","null","699333","95","26898","4","672435","91","3.846236342343347","4.2105263157894735","Non-CFO","2021","3","2021","2","06","30"
"2021-06-30","Bureau","Other Agencies","Advisory Council on Hist. Preservation","0","0","0","0","0","0","0.0","0.0","null","2021","3","2021","2","06","30"
"2021-06-30","Bureau","Other Agencies","Archit.&Trans. Barriers Compliance Bd","0","0","0","0","0","0","0.0","0.0","null","2021","3","2021","2","06","30"
"2021-06-30","Bureau","Other Agencies","Architect of the Capitol","48052","24","0","0","48052","24","0.0","0.0","null","2021","3","2021","2","06","30"
"2021-06-30","Bureau","Other Agencies","Chemical Safety Board","0","0","0","0","0","0","0.0","0.0","null","2021","3","2021","2","06","30"
"2021-06-30","Bureau","Other Agencies","Comm. for Purchase from Blind/Handic.","0","0","0","0","0","0","0.0","0.0","null","2021","3","2021","2","06","30"
"2021-06-30","Bureau","Other Agencies","Commission On Fine Arts","0","0","0","0","0","0","0.0","0.0","null","2021","3","2021","2","06","30"
"2021-06-30","Bureau","Other Agencies","Consumer Financial Protection Bureau","402191","25","21151","1","381040","24","5.258944133508706","4.0","null","2021","3","2021","2","06","30"
"2021-06-30","Bureau","Other Agencies","Council of Insps. Gen. of Intg. & Effy.","4900","8","0","0","4900","8","0.0","0.0","null","2021","3","2021","2","06","30"
"2021-06-30","Bureau","Other Agencies","Defense Nuclear Facilities Safety Board","0","0","0","0","0","0","0.0","0.0","null","2021","3","2021","2","06","30"
"2021-06-30","Bureau","Other Agencies","Delta Regional Authority","0","0","0","0","0","0","0.0","0.0","null","2021","3","2021","2","06","30"
"2021-06-30","Bureau","Other Agencies","Denali Commission","0","0","0","0","0","0","0.0","0.0","null","2021","3","2021","2","06","30"
"2021-06-30","Bureau","Other Agencies","District of Columbia Government","0","0","0","0","0","0","0.0","0.0","null","2021","3","2021","2","06","30"
"2021-06-30","Bureau","Other Agencies","Election Assistance Commission","5576","1","0","0","5576","1","0.0","0.0","null","2021","3","2021","2","06","30"
"2021-06-30","Bureau","Other Agencies","Federal Housing Finance Agency","1239","2","0","0","1239","2","0.0","0.0","null","2021","3","2021","2","06","30"
"2021-06-30","Bureau","Other Agencies","Federal Housing Finance Agency OIG","0","0","0","0","0","0","0.0","0.0","null","2021","3","2021","2","06","30"
"2021-06-30","Bureau","Other Agencies","Federal Mine Safety & Health Review Comm","0","0","0","0","0","0","0.0","0.0","null","2021","3","2021","2","06","30"
"2021-06-30","Bureau","Other Agencies","Gulf Coast Ecosystem Restoration Council","0","0","0","0","0","0","0.0","0.0","null","2021","3","2021","2","06","30"
"2021-06-30","Bureau","Other Agencies","James Madison Memorial Fellowship","222112","26","0","0","222112","26","0.0","0.0","null","2021","3","2021","2","06","30"
"2021-06-30","Bureau","Other Agencies","John C. Stennis","2934","2","0","0","2934","2","0.0","0.0","null","2021","3","2021","2","06","30"
"2021-06-30","Bureau","Other Agencies","Millennium Challenge Corporation","817","1","817","1","0","0","100.0","100.0","null","2021","3","2021","2","06","30"
"2021-06-30","Bureau","Other Agencies","Morris K. Udall Scholarship","0","0","0","0","0","0","0.0","0.0","null","2021","3","2021","2","06","30"
"2021-06-30","Bureau","Other Agencies","National Capital Planning Commission","0","0","0","0","0","0","0.0","0.0","null","2021","3","2021","2","06","30"
"2021-06-30","Bureau","Other Agencies","National Council on Disability","1579","2","0","0","1579","2","0.0","0.0","null","2021","3","2021","2","06","30"
"2021-06-30","Bureau","Other Agencies","National Mediation Board","0","0","0","0","0","0","0.0","0.0","null","2021","3","2021","2","06","30"
"2021-06-30","Bureau","Other Agencies","National Transportation Safety Board","0","0","0","0","0","0","0.0","0.0","null","2021","3","2021","2","06","30"
"2021-06-30","Bureau","Other Agencies","Privacy & Civil Liberties Oversight Bd","0","0","0","0","0","0","0.0","0.0","null","2021","3","2021","2","06","30"
"2021-06-30","Bureau","Other Agencies","Surface Transportation Board","0","0","0","0","0","0","0.0","0.0","null","2021","3","2021","2","06","30"
"2021-06-30","Bureau","Other Agencies","U.S.  Agency of Global Media","4930","2","4930","2","0","0","100.0","100.0","null","2021","3","2021","2","06","30"
"2021-06-30","Bureau","Other Agencies","U.S. Holocaust Memorial Council","0","0","0","0","0","0","0.0","0.0","null","2021","3","2021","2","06","30"
"2021-06-30","Bureau","Other Agencies","U.S. Inst. for Env. Conflict Resolution","5003","2","0","0","5003","2","0.0","0.0","null","2021","3","2021","2","06","30"
"2021-06-30","Bureau","Other Agencies","U.S. Institute of Peace","0","0","0","0","0","0","0.0","0.0","null","2021","3","2021","2","06","30"
"2021-06-30","Agency","Other Agencies/Boards/Commissions","null","1024","1","0","0","1024","1","0.0","0.0","Non-CFO","2021","3","2021","2","06","30"
"2021-06-30","Bureau","Other Agencies/Boards/Commissions","Medicare Payment Advisory Commission","0","0","0","0","0","0","0.0","0.0","null","2021","3","2021","2","06","30"
"2021-06-30","Bureau","Other Agencies/Boards/Commissions","U.S. Comm. on Int. Religious Freedom","1024","1","0","0","1024","1","0.0","0.0","null","2021","3","2021","2","06","30"
"2021-06-30","Bureau","Other Agencies/Boards/Commissions","U.S.-China Security Review Commission","0","0","0","0","0","0","0.0","0.0","null","2021","3","2021","2","06","30"
"2021-06-30","Agency","Pension Benefit Guaranty Corp","null","3366092","1141","3366092","1141","0","0","100.0","100.0","Non-CFO","2021","3","2021","2","06","30"
"2021-06-30","Bureau","Pension Benefit Guaranty Corp","Pension Benefit Guaranty Corporation","3366092","1141","3366092","1141","0","0","100.0","100.0","null","2021","3","2021","2","06","30"
"2021-06-30","Agency","Presidio Trust Corporation","null","1496012","71","0","0","1496012","71","0.0","0.0","Non-CFO","2021","3","2021","2","06","30"
"2021-06-30","Bureau","Presidio Trust Corporation","Presidio Trust Corporation","1496012","71","0","0","1496012","71","0.0","0.0","null","2021","3","2021","2","06","30"
"2021-06-30","Agency","Railroad Retirement Board","null","21725439","4214","21725439","4213","0","1","100.0","99.97626957759849","Non-CFO","2021","3","2021","2","06","30"
"2021-06-30","Bureau","Railroad Retirement Board","Railroad Retirement Board","21725439","4214","21725439","4213","0","1","100.0","99.97626957759849","null","2021","3","2021","2","06","30"
"2021-06-30","Agency","Securities & Exchange Commission","null","2105935184","1107","2105935184","1107","0","0","100.0","100.0","Non-CFO","2021","3","2021","2","06","30"
"2021-06-30","Bureau","Securities & Exchange Commission","SEC Enforcement","2105628446","1056","2105628446","1056","0","0","100.0","100.0","null","2021","3","2021","2","06","30"
"2021-06-30","Bureau","Securities & Exchange Commission","Securities and Exchange Commission","306738","51","306738","51","0","0","100.0","100.0","null","2021","3","2021","2","06","30"
"2021-06-30","Agency","Selective Service System","null","0","0","0","0","0","0","0.0","0.0","Non-CFO","2021","3","2021","2","06","30"
"2021-06-30","Bureau","Selective Service System","Selective Service System","0","0","0","0","0","0","0.0","0.0","null","2021","3","2021","2","06","30"
"2021-06-30","Agency","Small Business Administration","null","12431248241","119029","12431248241","119029","0","0","100.0","100.0","CFO","2021","3","2021","2","06","30"
"2021-06-30","Bureau","Small Business Administration","Small Business Administration","12431248241","119029","12431248241","119029","0","0","100.0","100.0","null","2021","3","2021","2","06","30"
"2021-06-30","Agency","Smithsonian Institution","null","7350","1","0","0","7350","1","0.0","0.0","Non-CFO","2021","3","2021","2","06","30"
"2021-06-30","Bureau","Smithsonian Institution","Administrative Conference of the US","0","0","0","0","0","0","0.0","0.0","null","2021","3","2021","2","06","30"
"2021-06-30","Bureau","Smithsonian Institution","JFK Center for the Performing Arts","0","0","0","0","0","0","0.0","0.0","null","2021","3","2021","2","06","30"
"2021-06-30","Bureau","Smithsonian Institution","National Gallery of Art","0","0","0","0","0","0","0.0","0.0","null","2021","3","2021","2","06","30"
"2021-06-30","Bureau","Smithsonian Institution","Smithsonian Institution","7350","1","0","0","7350","1","0.0","0.0","null","2021","3","2021","2","06","30"
"2021-06-30","Agency","Social Security Administration","null","4359039413","1300690","2725147953","471386","1633891460","829304","62.517167082104564","36.24122581091574","CFO","2021","3","2021","2","06","30"
"2021-06-30","Bureau","Social Security Administration","Social Security Administration","4359039413","1300690","2725147953","471386","1633891460","829304","62.517167082104564","36.24122581091574","null","2021","3","2021","2","06","30"
"2021-06-30","Agency","Tennessee Valley Authority","null","0","0","0","0","0","0","0.0","0.0","Non-CFO","2021","3","2021","2","06","30"
"2021-06-30","Bureau","Tennessee Valley Authority","Tennessee Valley Authority","0","0","0","0","0","0","0.0","0.0","null","2021","3","2021","2","06","30"
"2021-06-30","Agency","The Judiciary","null","1072965","316","1061000","189","11965","127","98.8848657691537","59.81012658227848","Non-CFO","2021","3","2021","2","06","30"
"2021-06-30","Bureau","The Judiciary","Administrative Office of the U.S. Courts","1072965","316","1061000","189","11965","127","98.8848657691537","59.81012658227848","null","2021","3","2021","2","06","30"
"2021-06-30","Agency","U.S. Court of Appeals / Veterans Claims","null","173","1","173","1","0","0","100.0","100.0","Non-CFO","2021","3","2021","2","06","30"
"2021-06-30","Bureau","U.S. Court of Appeals / Veterans Claims","U.S. Court of Appeals / Veterans Claims","173","1","173","1","0","0","100.0","100.0","null","2021","3","2021","2","06","30"
"2021-06-30","Agency","U.S. Postal Service","null","77055820","62045","42394289","50838","34661531","11207","55.017633969763736","81.93730356998952","Non-CFO","2021","3","2021","2","06","30"
"2021-06-30","Bureau","U.S. Postal Service","U.S. Postal Service","77055820","62045","42394289","50838","34661531","11207","55.017633969763736","81.93730356998952","null","2021","3","2021","2","06","30"
"2021-06-30","Agency","U.S. Tax Court","null","0","0","0","0","0","0","0.0","0.0","Non-CFO","2021","3","2021","2","06","30"
"2021-06-30","Bureau","U.S. Tax Court","U.S. Tax Court","0","0","0","0","0","0","0.0","0.0","null","2021","3","2021","2","06","30"
"2021-06-30","Agency","US International Development Fin. Corp.","null","0","0","0","0","0","0","0.0","0.0","Non-CFO","2021","3","2021","2","06","30"
"2021-06-30","Bureau","US International Development Fin. Corp.","US International Development Fin. Corp.","0","0","0","0","0","0","0.0","0.0","null","2021","3","2021","2","06","30"
"2021-03-31","Agency","Agency for International Development","null","33726267","43","33726267","43","0","0","100.0","100.0","CFO","2021","2","2021","1","03","31"
"2021-03-31","Bureau","Agency for International Development","Agency for International Development","33726267","43","33726267","43","0","0","100.0","100.0","null","2021","2","2021","1","03","31"
"2021-03-31","Agency","American Battle Monuments Commission","null","0","0","0","0","0","0","0.0","0.0","Non-CFO","2021","2","2021","1","03","31"
"2021-03-31","Bureau","American Battle Monuments Commission","American Battle Monuments Commission","0","0","0","0","0","0","0.0","0.0","null","2021","2","2021","1","03","31"
"2021-03-31","Agency","Armed Forces Retirement Home","null","113269","122","80508","105","32761","17","71.07681713443219","86.06557377049181","Non-CFO","2021","2","2021","1","03","31"
"2021-03-31","Bureau","Armed Forces Retirement Home","Armed Forces Retirement Home","113269","122","80508","105","32761","17","71.07681713443219","86.06557377049181","null","2021","2","2021","1","03","31"
"2021-03-31","Agency","Commodity Futures Trading Commission","null","654411202","365","654411202","365","0","0","100.0","100.0","Non-CFO","2021","2","2021","1","03","31"
"2021-03-31","Bureau","Commodity Futures Trading Commission","Commodity Futures Trading Commission","654411202","365","654411202","365","0","0","100.0","100.0","null","2021","2","2021","1","03","31"
"2021-03-31","Agency","Consumer Product Safety Commission","null","2500","1","2500","1","0","0","100.0","100.0","Non-CFO","2021","2","2021","1","03","31"
"2021-03-31","Bureau","Consumer Product Safety Commission","Consumer Product Safety Commission","2500","1","2500","1","0","0","100.0","100.0","null","2021","2","2021","1","03","31"
"2021-03-31","Agency","Corp. for National and Community Service","null","4519417","1188","3585715","152","933702","1036","79.34021135911999","12.794612794612794","Non-CFO","2021","2","2021","1","03","31"
"2021-03-31","Bureau","Corp. for National and Community Service","Corp. for National and Community Service","4519417","1188","3585715","152","933702","1036","79.34021135911999","12.794612794612794","null","2021","2","2021","1","03","31"
"2021-03-31","Agency","Department of Agriculture","null","1728326371","53972","1710386220","50508","17940151","3464","98.96199286772324","93.58185725931965","CFO","2021","2","2021","1","03","31"
"2021-03-31","Bureau","Department of Agriculture","Agricultural Marketing Service","5286175","1639","4834363","555","451812","1084","91.45295038472997","33.862111043319096","null","2021","2","2021","1","03","31"
"2021-03-31","Bureau","Department of Agriculture","Commodity Credit Corporation","132506927","10934","132506927","10934","0","0","100.0","100.0","null","2021","2","2021","1","03","31"
"2021-03-31","Bureau","Department of Agriculture","Farm Service Agency","792839891","14332","792839891","14332","0","0","100.0","100.0","null","2021","2","2021","1","03","31"
"2021-03-31","Bureau","Department of Agriculture","Federal Crop Insurance Corporation","17538","428","13153","427","4385","1","74.99714904778196","99.76635514018692","null","2021","2","2021","1","03","31"
"2021-03-31","Bureau","Department of Agriculture","Food Safety and Inspection Service","790616","744","777030","729","13586","15","98.28159308690945","97.98387096774194","null","2021","2","2021","1","03","31"
"2021-03-31","Bureau","Department of Agriculture","Food and Nutrition Service","7126651","268","49094","6","7077557","262","0.6888789699397375","2.2388059701492535","null","2021","2","2021","1","03","31"
"2021-03-31","Bureau","Department of Agriculture","Forest Service","68329215","1050","62121997","296","6207218","754","90.91571884734809","28.19047619047619","null","2021","2","2021","1","03","31"
"2021-03-31","Bureau","Department of Agriculture","Rural Development","699326255","21512","699317446","21507","8809","5","99.99874035903314","99.9767571587951","null","2021","2","2021","1","03","31"
"2021-03-31","Bureau","Department of Agriculture","U.S. Department of Agriculture","22103103","3065","17926319","1722","4176784","1343","81.1031781374769","56.182707993474715","null","2021","2","2021","1","03","31"
"2021-03-31","Agency","Department of Commerce","null","29360503","1935","29360503","1935","0","0","100.0","100.0","CFO","2021","2","2021","1","03","31"
"2021-03-31","Bureau","Department of Commerce","Bureau of Industry and Security","1738130","23","1738130","23","0","0","100.0","100.0","null","2021","2","2021","1","03","31"
"2021-03-31","Bureau","Department of Commerce","Bureau of the Census","320121","432","320121","432","0","0","100.0","100.0","null","2021","2","2021","1","03","31"
"2021-03-31","Bureau","Department of Commerce","Economic Development Administration","5104978","10","5104978","10","0","0","100.0","100.0","null","2021","2","2021","1","03","31"
"2021-03-31","Bureau","Department of Commerce","Economic and Statistical Analysis","0","0","0","0","0","0","0.0","0.0","null","2021","2","2021","1","03","31"
"2021-03-31","Bureau","Department of Commerce","General Administration","4660","1","4660","1","0","0","100.0","100.0","null","2021","2","2021","1","03","31"
"2021-03-31","Bureau","Department of Commerce","International Trade Administration","0","0","0","0","0","0","0.0","0.0","null","2021","2","2021","1","03","31"
"2021-03-31","Bureau","Department of Commerce","Minority Business Development Agency","0","0","0","0","0","0","0.0","0.0","null","2021","2","2021","1","03","31"
"2021-03-31","Bureau","Department of Commerce","NOAA","20831938","842","20831938","842","0","0","100.0","100.0","null","2021","2","2021","1","03","31"
"2021-03-31","Bureau","Department of Commerce","Nat'l Institute of Standards& Technology","686873","6","686873","6","0","0","100.0","100.0","null","2021","2","2021","1","03","31"
"2021-03-31","Bureau","Department of Commerce","Nat'l Telecomm & Information Admin.","296094","1","296094","1","0","0","100.0","100.0","null","2021","2","2021","1","03","31"
"2021-03-31","Bureau","Department of Commerce","National Technical Information Service","0","0","0","0","0","0","0.0","0.0","null","2021","2","2021","1","03","31"
"2021-03-31","Bureau","Department of Commerce","Office of the Inspector General","0","0","0","0","0","0","0.0","0.0","null","2021","2","2021","1","03","31"
"2021-03-31","Bureau","Department of Commerce","Patent and Trademark Office","377709","620","377709","620","0","0","100.0","100.0","null","2021","2","2021","1","03","31"
"2021-03-31","Agency","Department of Defense","null","2417517456","1881616","1049387593","269426","1368129863","1612190","43.407653185524715","14.318862084506085","CFO","2021","2","2021","1","03","31"
"2021-03-31","Bureau","Department of Defense","Consolidated Report","2417517456","1881616","1049387593","269426","1368129863","1612190","43.407653185524715","14.318862084506085","null","2021","2","2021","1","03","31"
"2021-03-31","Agency","Department of Education","null","135536173876","23304958","135402002582","23304336","134171294","622","99.90100702258074","99.99733104003019","CFO","2021","2","2021","1","03","31"
"2021-03-31","Bureau","Department of Education","Departmental Management","921978579","2324","787807285","1702","134171294","622","85.44746081351202","73.23580034423408","null","2021","2","2021","1","03","31"
"2021-03-31","Bureau","Department of Education","Federal Student Aid","134614195297","23302634","134614195297","23302634","0","0","100.0","100.0","null","2021","2","2021","1","03","31"
"2021-03-31","Bureau","Department of Education","Office of Postsecondary Education","0","0","0","0","0","0","0.0","0.0","null","2021","2","2021","1","03","31"
"2021-03-31","Agency","Department of Energy","null","14501454","117","14501454","117","0","0","100.0","100.0","CFO","2021","2","2021","1","03","31"
"2021-03-31","Bureau","Department of Energy","Bonneville Power Administration","1619892","26","1619892","26","0","0","100.0","100.0","null","2021","2","2021","1","03","31"
"2021-03-31","Bureau","Department of Energy","Energy Consolidated Reports","12881562","91","12881562","91","0","0","100.0","100.0","null","2021","2","2021","1","03","31"
"2021-03-31","Agency","Department of Health & Human Services","null","9688270688","1150245","9479834370","1112237","208436318","38008","97.84857045480602","96.69566048972176","CFO","2021","2","2021","1","03","31"
"2021-03-31","Bureau","Department of Health & Human Services","Administration for Children and Families","29457648","1746","29457648","1746","0","0","100.0","100.0","null","2021","2","2021","1","03","31"
"2021-03-31","Bureau","Department of Health & Human Services","Administration for Community Living","0","0","0","0","0","0","0.0","0.0","null","2021","2","2021","1","03","31"
"2021-03-31","Bureau","Department of Health & Human Services","Centers for Disease Control","8813064","110","139350","17","8673714","93","1.5811754005190477","15.454545454545455","null","2021","2","2021","1","03","31"
"2021-03-31","Bureau","Department of Health & Human Services","Centers for Medicare & Medicaid Services","9378441063","1133852","9278434088","1108012","100006975","25840","98.9336503334808","97.72104295798746","null","2021","2","2021","1","03","31"
"2021-03-31","Bureau","Department of Health & Human Services","Food and Drug Administration","94893932","9826","32210198","1145","62683734","8681","33.943369529676566","11.652757989008752","null","2021","2","2021","1","03","31"
"2021-03-31","Bureau","Department of Health & Human Services","Health Resources and Services Admin","95977143","606","95977143","606","0","0","100.0","100.0","null","2021","2","2021","1","03","31"
"2021-03-31","Bureau","Department of Health & Human Services","Indian Health Services","56279142","3242","30088082","211","26191060","3031","53.46222584558947","6.5083281924737815","null","2021","2","2021","1","03","31"
"2021-03-31","Bureau","Department of Health & Human Services","National Institutes of Health","16955979","467","6075144","104","10880835","363","35.828919108710856","22.26980728051392","null","2021","2","2021","1","03","31"
"2021-03-31","Bureau","Department of Health & Human Services","Office of the Inspector General","0","0","0","0","0","0","0.0","0.0","null","2021","2","2021","1","03","31"
"2021-03-31","Bureau","Department of Health & Human Services","Office of the Secretary","8340","7","8340","7","0","0","100.0","100.0","null","2021","2","2021","1","03","31"
"2021-03-31","Bureau","Department of Health & Human Services","Program Support Center","6483980","375","6483980","375","0","0","100.0","100.0","null","2021","2","2021","1","03","31"
"2021-03-31","Bureau","Department of Health & Human Services","Substance Abuse & Mental Health Admin.","960397","14","960397","14","0","0","100.0","100.0","null","2021","2","2021","1","03","31"
"2021-03-31","Agency","Department of Homeland Security","null","290880246","50148","290878629","50141","1617","7","99.9994441011302","99.98604131769962","CFO","2021","2","2021","1","03","31"
"2021-03-31","Bureau","Department of Homeland Security","Bureau of Customs & Border Protection","9016863","575","9016863","575","0","0","100.0","100.0","null","2021","2","2021","1","03","31"
"2021-03-31","Bureau","Department of Homeland Security","Citizenship and Immigration Services","1058329","1257","1058329","1257","0","0","100.0","100.0","null","2021","2","2021","1","03","31"
"2021-03-31","Bureau","Department of Homeland Security","Domestic Nuclear Detection Office","1617","7","0","0","1617","7","0.0","0.0","null","2021","2","2021","1","03","31"
"2021-03-31","Bureau","Department of Homeland Security","Emergency Preparedness & Resp","259146795","42161","259146795","42161","0","0","100.0","100.0","null","2021","2","2021","1","03","31"
"2021-03-31","Bureau","Department of Homeland Security","Federal Law Enforcement Training Ctr.","0","0","0","0","0","0","0.0","0.0","null","2021","2","2021","1","03","31"
"2021-03-31","Bureau","Department of Homeland Security","Immigration and Customs Enforcement","13572458","561","13572458","561","0","0","100.0","100.0","null","2021","2","2021","1","03","31"
"2021-03-31","Bureau","Department of Homeland Security","Info Analysis Infrastructure Prot-NPPD","0","0","0","0","0","0","0.0","0.0","null","2021","2","2021","1","03","31"
"2021-03-31","Bureau","Department of Homeland Security","Management Headquarters","0","0","0","0","0","0","0.0","0.0","null","2021","2","2021","1","03","31"
"2021-03-31","Bureau","Department of Homeland Security","Office of Biometric Identity Management","0","0","0","0","0","0","0.0","0.0","null","2021","2","2021","1","03","31"
"2021-03-31","Bureau","Department of Homeland Security","Office of Health Affairs","0","0","0","0","0","0","0.0","0.0","null","2021","2","2021","1","03","31"
"2021-03-31","Bureau","Department of Homeland Security","Office of the Inspector General DHS","100","1","100","1","0","0","100.0","100.0","null","2021","2","2021","1","03","31"
"2021-03-31","Bureau","Department of Homeland Security","Science and Technology","0","0","0","0","0","0","0.0","0.0","null","2021","2","2021","1","03","31"
"2021-03-31","Bureau","Department of Homeland Security","Transportation Safety Administration","8084084","5586","8084084","5586","0","0","100.0","100.0","null","2021","2","2021","1","03","31"
"2021-03-31","Bureau","Department of Homeland Security","U.S. Coast Guard","0","0","0","0","0","0","0.0","0.0","null","2021","2","2021","1","03","31"
"2021-03-31","Bureau","Department of Homeland Security","U.S. Secret Service","0","0","0","0","0","0","0.0","0.0","null","2021","2","2021","1","03","31"
"2021-03-31","Agency","Department of Housing and Urban Development","null","143742302","4942","141417891","4906","2324411","36","98.38293183867334","99.27154997976528","CFO","2021","2","2021","1","03","31"
"2021-03-31","Bureau","Department of Housing and Urban Development","Community Planning and Development","0","0","0","0","0","0","0.0","0.0","null","2021","2","2021","1","03","31"
"2021-03-31","Bureau","Department of Housing and Urban Development","Government National Mortgage Association","0","0","0","0","0","0","0.0","0.0","null","2021","2","2021","1","03","31"
"2021-03-31","Bureau","Department of Housing and Urban Development","Housing Programs","139696194","4922","139661858","4897","34336","25","99.97542094811831","99.49207639171068","null","2021","2","2021","1","03","31"
"2021-03-31","Bureau","Department of Housing and Urban Development","Management and Administration","630959","11","8078","7","622881","4","1.2802733616605833","63.63636363636363","null","2021","2","2021","1","03","31"
"2021-03-31","Bureau","Department of Housing and Urban Development","Policy, Development and Research","0","0","0","0","0","0","0.0","0.0","null","2021","2","2021","1","03","31"
"2021-03-31","Bureau","Department of Housing and Urban Development","Public and Indian Housing Programs","3415149","9","1747955","2","1667194","7","51.18239350611057","22.22222222222222","null","2021","2","2021","1","03","31"
"2021-03-31","Agency","Department of Justice","null","92382864","38134","88833322","37755","3549542","379","96.15779177402423","99.00613625635916","CFO","2021","2","2021","1","03","31"
"2021-03-31","Bureau","Department of Justice","Bureau of ATF and Explosives","20422","4","20422","4","0","0","100.0","100.0","null","2021","2","2021","1","03","31"
"2021-03-31","Bureau","Department of Justice","Drug Enforcement Administration","315669","21","315669","21","0","0","100.0","100.0","null","2021","2","2021","1","03","31"
"2021-03-31","Bureau","Department of Justice","Federal Bureau of Investigation","278624","68","278624","68","0","0","100.0","100.0","null","2021","2","2021","1","03","31"
"2021-03-31","Bureau","Department of Justice","Federal Prison Industries","1043089","183","1043089","183","0","0","100.0","100.0","null","2021","2","2021","1","03","31"
"2021-03-31","Bureau","Department of Justice","Federal Prison System","896902","132","896902","132","0","0","100.0","100.0","null","2021","2","2021","1","03","31"
"2021-03-31","Bureau","Department of Justice","General Administration","0","0","0","0","0","0","0.0","0.0","null","2021","2","2021","1","03","31"
"2021-03-31","Bureau","Department of Justice","Legal Activities","89822814","37721","86277539","37345","3545275","376","96.05303503406161","99.00320776225445","null","2021","2","2021","1","03","31"
"2021-03-31","Bureau","Department of Justice","Office of Justice Assistance Programs","1077","2","1077","2","0","0","100.0","100.0","null","2021","2","2021","1","03","31"
"2021-03-31","Bureau","Department of Justice","U.S. Marshals Service","4267","3","0","0","4267","3","0.0","0.0","null","2021","2","2021","1","03","31"
"2021-03-31","Agency","Department of Labor","null","193957638","47178","174130424","41057","19827214","6121","89.7775544162896","87.02573233286701","CFO","2021","2","2021","1","03","31"
"2021-03-31","Bureau","Department of Labor","Bureau of Labor Statistics","10260","1","10260","1","0","0","100.0","100.0","null","2021","2","2021","1","03","31"
"2021-03-31","Bureau","Department of Labor","Departmental Management","0","0","0","0","0","0","0.0","0.0","null","2021","2","2021","1","03","31"
"2021-03-31","Bureau","Department of Labor","Employee Benefit Security Administration","17200332","397","17200332","397","0","0","100.0","100.0","null","2021","2","2021","1","03","31"
"2021-03-31","Bureau","Department of Labor","Employment Standards Administration","91934867","28184","77844292","24209","14090575","3975","84.67330680970039","85.89625319330116","null","2021","2","2021","1","03","31"
"2021-03-31","Bureau","Department of Labor","Employment and Training Administration","3369967","11","0","0","3369967","11","0.0","0.0","null","2021","2","2021","1","03","31"
"2021-03-31","Bureau","Department of Labor","Mine Safety and Health Administration","24289802","12955","22586824","12285","1702978","670","92.98891773592885","94.82825164029332","null","2021","2","2021","1","03","31"
"2021-03-31","Bureau","Department of Labor","Occupational Safety and Health Admin","57152410","5630","56488716","4165","663694","1465","98.83872963537321","73.97868561278864","null","2021","2","2021","1","03","31"
"2021-03-31","Agency","Department of State","null","26807477","26201","14845622","21505","11961855","4696","55.37866170695586","82.07701996107019","CFO","2021","2","2021","1","03","31"
"2021-03-31","Bureau","Department of State","Civil Monetary Penalties","0","0","0","0","0","0","0.0","0.0","null","2021","2","2021","1","03","31"
"2021-03-31","Bureau","Department of State","Department of State","24434715","10923","12472860","6227","11961855","4696","51.045653693935044","57.008147944703836","null","2021","2","2021","1","03","31"
"2021-03-31","Bureau","Department of State","International Commissions","0","0","0","0","0","0","0.0","0.0","null","2021","2","2021","1","03","31"
"2021-03-31","Bureau","Department of State","Passport NSF","2372762","15278","2372762","15278","0","0","100.0","100.0","null","2021","2","2021","1","03","31"
"2021-03-31","Agency","Department of Transportation","null","66308781","7409","66237833","7397","70948","12","99.89300361290007","99.83803482251317","CFO","2021","2","2021","1","03","31"
"2021-03-31","Bureau","Department of Transportation","Federal Aviation Administration","1936942","261","1866203","250","70739","11","96.3479030347837","95.78544061302682","null","2021","2","2021","1","03","31"
"2021-03-31","Bureau","Department of Transportation","Federal Highway Administration","7317","7","7317","7","0","0","100.0","100.0","null","2021","2","2021","1","03","31"
"2021-03-31","Bureau","Department of Transportation","Federal Motor Carrier Safety Admin","61982421","7075","61982212","7074","209","1","99.9996628076209","99.98586572438163","null","2021","2","2021","1","03","31"
"2021-03-31","Bureau","Department of Transportation","Federal Railroad Administration","130772","12","130772","12","0","0","100.0","100.0","null","2021","2","2021","1","03","31"
"2021-03-31","Bureau","Department of Transportation","Federal Transit Administration","784632","2","784632","2","0","0","100.0","100.0","null","2021","2","2021","1","03","31"
"2021-03-31","Bureau","Department of Transportation","Maritime Administration","5613","6","5613","6","0","0","100.0","100.0","null","2021","2","2021","1","03","31"
"2021-03-31","Bureau","Department of Transportation","National Highway Traffic Safety Admin.","18330","3","18330","3","0","0","100.0","100.0","null","2021","2","2021","1","03","31"
"2021-03-31","Bureau","Department of Transportation","Office of the Inspector General","213","1","213","1","0","0","100.0","100.0","null","2021","2","2021","1","03","31"
"2021-03-31","Bureau","Department of Transportation","Office of the Secretary","1043371","14","1043371","14","0","0","100.0","100.0","null","2021","2","2021","1","03","31"
"2021-03-31","Bureau","Department of Transportation","Pipeline Hazardous Material Safety Admin","390049","24","390049","24","0","0","100.0","100.0","null","2021","2","2021","1","03","31"
"2021-03-31","Bureau","Department of Transportation","Research Innovative Technology Admin","218","2","218","2","0","0","100.0","100.0","null","2021","2","2021","1","03","31"
"2021-03-31","Bureau","Department of Transportation","St. Lawrence Seaway Development Corp.","8903","2","8903","2","0","0","100.0","100.0","null","2021","2","2021","1","03","31"
"2021-03-31","Agency","Department of Veterans Affairs","null","11031941","12127","6622676","8649","4409265","3478","60.03182939430151","71.32019460707512","CFO","2021","2","2021","1","03","31"
"2021-03-31","Bureau","Department of Veterans Affairs","Administration and Cemeteries","1206283","747","11273","13","1195010","734","0.934523656554888","1.7402945113788488","null","2021","2","2021","1","03","31"
"2021-03-31","Bureau","Department of Veterans Affairs","Housing Credit Assistance","944684","22","0","0","944684","22","0.0","0.0","null","2021","2","2021","1","03","31"
"2021-03-31","Bureau","Department of Veterans Affairs","Life Insurance","782222","139","782222","139","0","0","100.0","100.0","null","2021","2","2021","1","03","31"
"2021-03-31","Bureau","Department of Veterans Affairs","Medical and Construction","6807142","9523","5829181","8497","977961","1026","85.63330983840208","89.22608421715846","null","2021","2","2021","1","03","31"
"2021-03-31","Bureau","Department of Veterans Affairs","Veterans Benefits","1291610","1696","0","0","1291610","1696","0.0","0.0","null","2021","2","2021","1","03","31"
"2021-03-31","Agency","Department of the Interior","null","82408304","31665","82404350","31637","3954","28","99.99520193984334","99.91157429338386","CFO","2021","2","2021","1","03","31"
"2021-03-31","Bureau","Department of the Interior","Bureau of Indian Affairs","43845402","28305","43841448","28277","3954","28","99.99098195062734","99.90107754813637","null","2021","2","2021","1","03","31"
"2021-03-31","Bureau","Department of the Interior","Bureau of Land Management","15972935","340","15972935","340","0","0","100.0","100.0","null","2021","2","2021","1","03","31"
"2021-03-31","Bureau","Department of the Interior","Bureau of Ocean Energy Mgmt., Reg & Enf","0","0","0","0","0","0","0.0","0.0","null","2021","2","2021","1","03","31"
"2021-03-31","Bureau","Department of the Interior","Bureau of Reclamation","91473","72","91473","72","0","0","100.0","100.0","null","2021","2","2021","1","03","31"
"2021-03-31","Bureau","Department of the Interior","Bureau of Safety and Environmental Enf.","86","1","86","1","0","0","100.0","100.0","null","2021","2","2021","1","03","31"
"2021-03-31","Bureau","Department of the Interior","Fish and Wildlife Service","738224","75","738224","75","0","0","100.0","100.0","null","2021","2","2021","1","03","31"
"2021-03-31","Bureau","Department of the Interior","Geological Survey","140258","126","140258","126","0","0","100.0","100.0","null","2021","2","2021","1","03","31"
"2021-03-31","Bureau","Department of the Interior","National Park Service","7768322","1849","7768322","1849","0","0","100.0","100.0","null","2021","2","2021","1","03","31"
"2021-03-31","Bureau","Department of the Interior","Office of Natural Resources Revenue","7837673","532","7837673","532","0","0","100.0","100.0","null","2021","2","2021","1","03","31"
"2021-03-31","Bureau","Department of the Interior","Office of Surface Mining","5511946","348","5511946","348","0","0","100.0","100.0","null","2021","2","2021","1","03","31"
"2021-03-31","Bureau","Department of the Interior","Office of the Secretary","501985","17","501985","17","0","0","100.0","100.0","null","2021","2","2021","1","03","31"
"2021-03-31","Agency","Department of the Treasury","null","46051844","5459","45139089","5428","912755","31","98.01798381841127","99.4321304268181","CFO","2021","2","2021","1","03","31"
"2021-03-31","Bureau","Department of the Treasury","Bureau of Engraving and Printing","84528","1","84528","1","0","0","100.0","100.0","null","2021","2","2021","1","03","31"
"2021-03-31","Bureau","Department of the Treasury","Bureau of the Fiscal Service","13835216","3861","13835216","3861","0","0","100.0","100.0","null","2021","2","2021","1","03","31"
"2021-03-31","Bureau","Department of the Treasury","Community Dev Financial Inst Fund","4533407","8","4533407","8","0","0","100.0","100.0","null","2021","2","2021","1","03","31"
"2021-03-31","Bureau","Department of the Treasury","Comptroller of the Currency","1095821","22","1094630","21","1191","1","99.89131436612367","95.45454545454545","null","2021","2","2021","1","03","31"
"2021-03-31","Bureau","Department of the Treasury","D.C. Pension Program","392805","21","392805","21","0","0","100.0","100.0","null","2021","2","2021","1","03","31"
"2021-03-31","Bureau","Department of the Treasury","Departmental Offices","24242792","1387","23332453","1359","910339","28","96.2449085897367","97.98125450612834","null","2021","2","2021","1","03","31"
"2021-03-31","Bureau","Department of the Treasury","Financial Crimes Enforcement Network","1544945","3","1544945","3","0","0","100.0","100.0","null","2021","2","2021","1","03","31"
"2021-03-31","Bureau","Department of the Treasury","Interest on Tax/Deposit of Earnings","0","0","0","0","0","0","0.0","0.0","null","2021","2","2021","1","03","31"
"2021-03-31","Bureau","Department of the Treasury","Internal Revenue Service","266828","125","266828","125","0","0","100.0","100.0","null","2021","2","2021","1","03","31"
"2021-03-31","Bureau","Department of the Treasury","International Monetary Funds","0","0","0","0","0","0","0.0","0.0","null","2021","2","2021","1","03","31"
"2021-03-31","Bureau","Department of the Treasury","Office of Financial Research","0","0","0","0","0","0","0.0","0.0","null","2021","2","2021","1","03","31"
"2021-03-31","Bureau","Department of the Treasury","Office of Sec International Affairs","0","0","0","0","0","0","0.0","0.0","null","2021","2","2021","1","03","31"
"2021-03-31","Bureau","Department of the Treasury","Office of the Secretary","0","0","0","0","0","0","0.0","0.0","null","2021","2","2021","1","03","31"
"2021-03-31","Bureau","Department of the Treasury","Pandemic Receivables","0","0","0","0","0","0","0.0","0.0","null","2021","2","2021","1","03","31"
"2021-03-31","Bureau","Department of the Treasury","Spec Insp Gen-Troubled Asset Rel Prog","3916","1","3916","1","0","0","100.0","100.0","null","2021","2","2021","1","03","31"
"2021-03-31","Bureau","Department of the Treasury","Tobacco Tax and Trade","1000","1","1000","1","0","0","100.0","100.0","null","2021","2","2021","1","03","31"
"2021-03-31","Bureau","Department of the Treasury","Treasury Forfeiture Fund","0","0","0","0","0","0","0.0","0.0","null","2021","2","2021","1","03","31"
"2021-03-31","Bureau","Department of the Treasury","Treasury Franchise Fund","0","0","0","0","0","0","0.0","0.0","null","2021","2","2021","1","03","31"
"2021-03-31","Bureau","Department of the Treasury","Treasury IG for Tax Admin","0","0","0","0","0","0","0.0","0.0","null","2021","2","2021","1","03","31"
"2021-03-31","Bureau","Department of the Treasury","U.S. Mint","50586","29","49361","27","1225","2","97.57838137033961","93.10344827586206","null","2021","2","2021","1","03","31"
"2021-03-31","Bureau","Department of the Treasury","U.S. Treasury IG Office","0","0","0","0","0","0","0.0","0.0","null","2021","2","2021","1","03","31"
"2021-03-31","Agency","Environmental Protection Agency","null","24323933","232","24323933","232","0","0","100.0","100.0","CFO","2021","2","2021","1","03","31"
"2021-03-31","Bureau","Environmental Protection Agency","Environmental Protection Agency","24323933","232","24323933","232","0","0","100.0","100.0","null","2021","2","2021","1","03","31"
"2021-03-31","Agency","Equal Employment Opportunity Commission","null","37960","17","37960","17","0","0","100.0","100.0","Non-CFO","2021","2","2021","1","03","31"
"2021-03-31","Bureau","Equal Employment Opportunity Commission","Equal Employment Opportunity Commission","37960","17","37960","17","0","0","100.0","100.0","null","2021","2","2021","1","03","31"
"2021-03-31","Agency","Export - Import  Bank","null","0","0","0","0","0","0","0.0","0.0","Non-CFO","2021","2","2021","1","03","31"
"2021-03-31","Bureau","Export - Import  Bank","Export-Import Bank","0","0","0","0","0","0","0.0","0.0","null","2021","2","2021","1","03","31"
"2021-03-31","Agency","Farm Credit Administration","null","630","1","630","1","0","0","100.0","100.0","Non-CFO","2021","2","2021","1","03","31"
"2021-03-31","Bureau","Farm Credit Administration","Farm Credit Administration","630","1","630","1","0","0","100.0","100.0","null","2021","2","2021","1","03","31"
"2021-03-31","Bureau","Farm Credit Administration","Farm Credit System Insurance Corporation","0","0","0","0","0","0","0.0","0.0","null","2021","2","2021","1","03","31"
"2021-03-31","Agency","Federal Communications Commission","null","210610963","16657","210610963","16657","0","0","100.0","100.0","Non-CFO","2021","2","2021","1","03","31"
"2021-03-31","Bureau","Federal Communications Commission","Federal Communications Commission","210610963","16657","210610963","16657","0","0","100.0","100.0","null","2021","2","2021","1","03","31"
"2021-03-31","Agency","Federal Deposit Insurance Corporation","null","0","0","0","0","0","0","0.0","0.0","Non-CFO","2021","2","2021","1","03","31"
"2021-03-31","Bureau","Federal Deposit Insurance Corporation","Federal Deposit Insurance Corporation","0","0","0","0","0","0","0.0","0.0","null","2021","2","2021","1","03","31"
"2021-03-31","Agency","Federal Election Commission","null","875146","143","875146","143","0","0","100.0","100.0","Non-CFO","2021","2","2021","1","03","31"
"2021-03-31","Bureau","Federal Election Commission","Federal Election Commission","875146","143","875146","143","0","0","100.0","100.0","null","2021","2","2021","1","03","31"
"2021-03-31","Agency","Federal Labor Relations Authority","null","0","0","0","0","0","0","0.0","0.0","Non-CFO","2021","2","2021","1","03","31"
"2021-03-31","Bureau","Federal Labor Relations Authority","Federal Labor Relations Authority","0","0","0","0","0","0","0.0","0.0","null","2021","2","2021","1","03","31"
"2021-03-31","Agency","Federal Maritime Commission","null","397140","6","397140","6","0","0","100.0","100.0","Non-CFO","2021","2","2021","1","03","31"
"2021-03-31","Bureau","Federal Maritime Commission","Salaries and Expenses","397140","6","397140","6","0","0","100.0","100.0","null","2021","2","2021","1","03","31"
"2021-03-31","Agency","Federal Mediation/Conciliation Service","null","0","0","0","0","0","0","0.0","0.0","Non-CFO","2021","2","2021","1","03","31"
"2021-03-31","Bureau","Federal Mediation/Conciliation Service","Federal Mediation/Conciliation Service","0","0","0","0","0","0","0.0","0.0","null","2021","2","2021","1","03","31"
"2021-03-31","Agency","Federal Trade Commission","null","483058157","55","483058157","55","0","0","100.0","100.0","Non-CFO","2021","2","2021","1","03","31"
"2021-03-31","Bureau","Federal Trade Commission","Federal Trade Commission","483058157","55","483058157","55","0","0","100.0","100.0","null","2021","2","2021","1","03","31"
"2021-03-31","Agency","Funds Appropriated to the President","null","1236200","6","0","0","1236200","6","0.0","0.0","Non-CFO","2021","2","2021","1","03","31"
"2021-03-31","Bureau","Funds Appropriated to the President","African Development Foundation","0","0","0","0","0","0","0.0","0.0","null","2021","2","2021","1","03","31"
"2021-03-31","Bureau","Funds Appropriated to the President","Defense Security Assistance Agency","0","0","0","0","0","0","0.0","0.0","null","2021","2","2021","1","03","31"
"2021-03-31","Bureau","Funds Appropriated to the President","Executive Branch","0","0","0","0","0","0","0.0","0.0","null","2021","2","2021","1","03","31"
"2021-03-31","Bureau","Funds Appropriated to the President","Inter-American Foundation","0","0","0","0","0","0","0.0","0.0","null","2021","2","2021","1","03","31"
"2021-03-31","Bureau","Funds Appropriated to the President","Peace Corps","0","0","0","0","0","0","0.0","0.0","null","2021","2","2021","1","03","31"
"2021-03-31","Bureau","Funds Appropriated to the President","Trade and Development Agency","1236200","6","0","0","1236200","6","0.0","0.0","null","2021","2","2021","1","03","31"
"2021-03-31","Agency","General Services Administration","null","6534654","2365","4837201","1363","1697453","1002","74.02382742835351","57.63213530655391","CFO","2021","2","2021","1","03","31"
"2021-03-31","Bureau","General Services Administration","General Services Administration","6534654","2365","4837201","1363","1697453","1002","74.02382742835351","57.63213530655391","null","2021","2","2021","1","03","31"
"2021-03-31","Agency","Legis Branch-Library of Congress","null","0","0","0","0","0","0","0.0","0.0","Non-CFO","2021","2","2021","1","03","31"
"2021-03-31","Bureau","Legis Branch-Library of Congress","Library of Congress","0","0","0","0","0","0","0.0","0.0","null","2021","2","2021","1","03","31"
"2021-03-31","Agency","Legislative Branch - U.S. House/Senate","null","227194","176","0","0","227194","176","0.0","0.0","Non-CFO","2021","2","2021","1","03","31"
"2021-03-31","Bureau","Legislative Branch - U.S. House/Senate","U.S. House of Representatives","227194","176","0","0","227194","176","0.0","0.0","null","2021","2","2021","1","03","31"
"2021-03-31","Agency","Legislative Branch-CBO","null","0","0","0","0","0","0","0.0","0.0","Non-CFO","2021","2","2021","1","03","31"
"2021-03-31","Bureau","Legislative Branch-CBO","Congressional Budget Office","0","0","0","0","0","0","0.0","0.0","null","2021","2","2021","1","03","31"
"2021-03-31","Agency","Legislative Branch-GAO","null","0","0","0","0","0","0","0.0","0.0","Non-CFO","2021","2","2021","1","03","31"
"2021-03-31","Bureau","Legislative Branch-GAO","Government Accountability Office","0","0","0","0","0","0","0.0","0.0","null","2021","2","2021","1","03","31"
"2021-03-31","Agency","Legislative Branch-GPO","null","75651","9","75651","9","0","0","100.0","100.0","Non-CFO","2021","2","2021","1","03","31"
"2021-03-31","Bureau","Legislative Branch-GPO","Government Publishing Office","75651","9","75651","9","0","0","100.0","100.0","null","2021","2","2021","1","03","31"
"2021-03-31","Agency","Legislative Branch-Office of Tech.","null","0","0","0","0","0","0","0.0","0.0","Non-CFO","2021","2","2021","1","03","31"
"2021-03-31","Bureau","Legislative Branch-Office of Tech.","Medicaid & CHIP Payment & Access Comm.","0","0","0","0","0","0","0.0","0.0","null","2021","2","2021","1","03","31"
"2021-03-31","Bureau","Legislative Branch-Office of Tech.","Open World Leadership","0","0","0","0","0","0","0.0","0.0","null","2021","2","2021","1","03","31"
"2021-03-31","Agency","Merit Systems Protection Board","null","144","1","144","1","0","0","100.0","100.0","Non-CFO","2021","2","2021","1","03","31"
"2021-03-31","Bureau","Merit Systems Protection Board","Merit Systems Protection Board","144","1","144","1","0","0","100.0","100.0","null","2021","2","2021","1","03","31"
"2021-03-31","Agency","National Aeronautics and Space Administration","null","1250613","136","1250613","136","0","0","100.0","100.0","CFO","2021","2","2021","1","03","31"
"2021-03-31","Bureau","National Aeronautics and Space Administration","National Aeronautics and Space Admin","1250613","136","1250613","136","0","0","100.0","100.0","null","2021","2","2021","1","03","31"
"2021-03-31","Agency","National Archives & Records Admin","null","145306","114","145306","114","0","0","100.0","100.0","Non-CFO","2021","2","2021","1","03","31"
"2021-03-31","Bureau","National Archives & Records Admin","Nat'l Archives & Records Administration","145306","114","145306","114","0","0","100.0","100.0","null","2021","2","2021","1","03","31"
"2021-03-31","Agency","National Credit Union Administration","null","0","0","0","0","0","0","0.0","0.0","Non-CFO","2021","2","2021","1","03","31"
"2021-03-31","Bureau","National Credit Union Administration","National Credit Union Administration","0","0","0","0","0","0","0.0","0.0","null","2021","2","2021","1","03","31"
"2021-03-31","Agency","National Foundation  Arts & Humanities","null","0","0","0","0","0","0","0.0","0.0","Non-CFO","2021","2","2021","1","03","31"
"2021-03-31","Bureau","National Foundation  Arts & Humanities","National Endowment for the Arts","0","0","0","0","0","0","0.0","0.0","null","2021","2","2021","1","03","31"
"2021-03-31","Bureau","National Foundation  Arts & Humanities","National Endowment for the Humanities","0","0","0","0","0","0","0.0","0.0","null","2021","2","2021","1","03","31"
"2021-03-31","Agency","National Labor Relations Board","null","0","0","0","0","0","0","0.0","0.0","Non-CFO","2021","2","2021","1","03","31"
"2021-03-31","Bureau","National Labor Relations Board","National Labor Relations Board","0","0","0","0","0","0","0.0","0.0","null","2021","2","2021","1","03","31"
"2021-03-31","Agency","National Science Foundation","null","541399","78","541399","78","0","0","100.0","100.0","CFO","2021","2","2021","1","03","31"
"2021-03-31","Bureau","National Science Foundation","National Science Foundation","541399","78","541399","78","0","0","100.0","100.0","null","2021","2","2021","1","03","31"
"2021-03-31","Agency","Neighborhood Reinvestment Corporation","null","0","0","0","0","0","0","0.0","0.0","Non-CFO","2021","2","2021","1","03","31"
"2021-03-31","Bureau","Neighborhood Reinvestment Corporation","Neighborhood Reinvestment Corporation","0","0","0","0","0","0","0.0","0.0","null","2021","2","2021","1","03","31"
"2021-03-31","Agency","Nuclear Regulatory Commission","null","2625418","323","2624656","322","762","1","99.97097605028989","99.69040247678019","CFO","2021","2","2021","1","03","31"
"2021-03-31","Bureau","Nuclear Regulatory Commission","Nuclear Regulatory Commission","2625418","323","2624656","322","762","1","99.97097605028989","99.69040247678019","null","2021","2","2021","1","03","31"
"2021-03-31","Agency","Occupational Safety & Health Rev Comm","null","0","0","0","0","0","0","0.0","0.0","Non-CFO","2021","2","2021","1","03","31"
"2021-03-31","Bureau","Occupational Safety & Health Rev Comm","Occupational Safety & Health Rev Comm","0","0","0","0","0","0","0.0","0.0","null","2021","2","2021","1","03","31"
"2021-03-31","Agency","Office of Compliance","null","0","0","0","0","0","0","0.0","0.0","Non-CFO","2021","2","2021","1","03","31"
"2021-03-31","Bureau","Office of Compliance","Office of Compliance","0","0","0","0","0","0","0.0","0.0","null","2021","2","2021","1","03","31"
"2021-03-31","Agency","Office of Government Ethics","null","0","0","0","0","0","0","0.0","0.0","Non-CFO","2021","2","2021","1","03","31"
"2021-03-31","Bureau","Office of Government Ethics","Office of Government Ethics","0","0","0","0","0","0","0.0","0.0","null","2021","2","2021","1","03","31"
"2021-03-31","Agency","Office of Personnel Management","null","22266444","1402","21619195","1319","647249","83","97.0931640454129","94.07988587731812","CFO","2021","2","2021","1","03","31"
"2021-03-31","Bureau","Office of Personnel Management","Office of Personnel Management","22266444","1402","21619195","1319","647249","83","97.0931640454129","94.07988587731812","null","2021","2","2021","1","03","31"
"2021-03-31","Agency","Office of Special Counsel","null","0","0","0","0","0","0","0.0","0.0","Non-CFO","2021","2","2021","1","03","31"
"2021-03-31","Bureau","Office of Special Counsel","Office of Special Counsel","0","0","0","0","0","0","0.0","0.0","null","2021","2","2021","1","03","31"
"2021-03-31","Agency","Other Agencies","null","6025311","121","27747","5","5997564","116","0.46050734974510027","4.132231404958677","Non-CFO","2021","2","2021","1","03","31"
"2021-03-31","Bureau","Other Agencies","Advisory Council on Hist. Preservation","0","0","0","0","0","0","0.0","0.0","null","2021","2","2021","1","03","31"
"2021-03-31","Bureau","Other Agencies","Archit.&Trans. Barriers Compliance Bd","0","0","0","0","0","0","0.0","0.0","null","2021","2","2021","1","03","31"
"2021-03-31","Bureau","Other Agencies","Architect of the Capitol","108246","47","0","0","108246","47","0.0","0.0","null","2021","2","2021","1","03","31"
"2021-03-31","Bureau","Other Agencies","Chemical Safety Board","0","0","0","0","0","0","0.0","0.0","null","2021","2","2021","1","03","31"
"2021-03-31","Bureau","Other Agencies","Comm. for Purchase from Blind/Handic.","0","0","0","0","0","0","0.0","0.0","null","2021","2","2021","1","03","31"
"2021-03-31","Bureau","Other Agencies","Commission On Fine Arts","0","0","0","0","0","0","0.0","0.0","null","2021","2","2021","1","03","31"
"2021-03-31","Bureau","Other Agencies","Consumer Financial Protection Bureau","5667948","28","21151","1","5646797","27","0.37316856117946035","3.5714285714285716","null","2021","2","2021","1","03","31"
"2021-03-31","Bureau","Other Agencies","Council of Insps. Gen. of Intg. & Effy.","4900","8","0","0","4900","8","0.0","0.0","null","2021","2","2021","1","03","31"
"2021-03-31","Bureau","Other Agencies","Defense Nuclear Facilities Safety Board","0","0","0","0","0","0","0.0","0.0","null","2021","2","2021","1","03","31"
"2021-03-31","Bureau","Other Agencies","Delta Regional Authority","0","0","0","0","0","0","0.0","0.0","null","2021","2","2021","1","03","31"
"2021-03-31","Bureau","Other Agencies","Denali Commission","0","0","0","0","0","0","0.0","0.0","null","2021","2","2021","1","03","31"
"2021-03-31","Bureau","Other Agencies","District of Columbia Government","0","0","0","0","0","0","0.0","0.0","null","2021","2","2021","1","03","31"
"2021-03-31","Bureau","Other Agencies","Election Assistance Commission","6425","2","849","1","5576","1","13.214007782101167","50.0","null","2021","2","2021","1","03","31"
"2021-03-31","Bureau","Other Agencies","Federal Housing Finance Agency","1239","2","0","0","1239","2","0.0","0.0","null","2021","2","2021","1","03","31"
"2021-03-31","Bureau","Other Agencies","Federal Housing Finance Agency OIG","0","0","0","0","0","0","0.0","0.0","null","2021","2","2021","1","03","31"
"2021-03-31","Bureau","Other Agencies","Federal Mine Safety & Health Review Comm","0","0","0","0","0","0","0.0","0.0","null","2021","2","2021","1","03","31"
"2021-03-31","Bureau","Other Agencies","Gulf Coast Ecosystem Restoration Council","0","0","0","0","0","0","0.0","0.0","null","2021","2","2021","1","03","31"
"2021-03-31","Bureau","Other Agencies","James Madison Memorial Fellowship","221290","25","0","0","221290","25","0.0","0.0","null","2021","2","2021","1","03","31"
"2021-03-31","Bureau","Other Agencies","John C. Stennis","2934","2","0","0","2934","2","0.0","0.0","null","2021","2","2021","1","03","31"
"2021-03-31","Bureau","Other Agencies","Millennium Challenge Corporation","817","1","817","1","0","0","100.0","100.0","null","2021","2","2021","1","03","31"
"2021-03-31","Bureau","Other Agencies","Morris K. Udall Scholarship","0","0","0","0","0","0","0.0","0.0","null","2021","2","2021","1","03","31"
"2021-03-31","Bureau","Other Agencies","National Capital Planning Commission","0","0","0","0","0","0","0.0","0.0","null","2021","2","2021","1","03","31"
"2021-03-31","Bureau","Other Agencies","National Council on Disability","1579","2","0","0","1579","2","0.0","0.0","null","2021","2","2021","1","03","31"
"2021-03-31","Bureau","Other Agencies","National Mediation Board","0","0","0","0","0","0","0.0","0.0","null","2021","2","2021","1","03","31"
"2021-03-31","Bureau","Other Agencies","National Transportation Safety Board","0","0","0","0","0","0","0.0","0.0","null","2021","2","2021","1","03","31"
"2021-03-31","Bureau","Other Agencies","Privacy & Civil Liberties Oversight Bd","0","0","0","0","0","0","0.0","0.0","null","2021","2","2021","1","03","31"
"2021-03-31","Bureau","Other Agencies","Surface Transportation Board","0","0","0","0","0","0","0.0","0.0","null","2021","2","2021","1","03","31"
"2021-03-31","Bureau","Other Agencies","U.S.  Agency of Global Media","4930","2","4930","2","0","0","100.0","100.0","null","2021","2","2021","1","03","31"
"2021-03-31","Bureau","Other Agencies","U.S. Holocaust Memorial Council","0","0","0","0","0","0","0.0","0.0","null","2021","2","2021","1","03","31"
"2021-03-31","Bureau","Other Agencies","U.S. Inst. for Env. Conflict Resolution","5003","2","0","0","5003","2","0.0","0.0","null","2021","2","2021","1","03","31"
"2021-03-31","Bureau","Other Agencies","U.S. Institute of Peace","0","0","0","0","0","0","0.0","0.0","null","2021","2","2021","1","03","31"
"2021-03-31","Agency","Other Agencies/Boards/Commissions","null","1024","1","0","0","1024","1","0.0","0.0","Non-CFO","2021","2","2021","1","03","31"
"2021-03-31","Bureau","Other Agencies/Boards/Commissions","Medicare Payment Advisory Commission","0","0","0","0","0","0","0.0","0.0","null","2021","2","2021","1","03","31"
"2021-03-31","Bureau","Other Agencies/Boards/Commissions","U.S. Comm. on Int. Religious Freedom","1024","1","0","0","1024","1","0.0","0.0","null","2021","2","2021","1","03","31"
"2021-03-31","Bureau","Other Agencies/Boards/Commissions","U.S.-China Security Review Commission","0","0","0","0","0","0","0.0","0.0","null","2021","2","2021","1","03","31"
"2021-03-31","Agency","Pension Benefit Guaranty Corp","null","2921238","1158","2921238","1158","0","0","100.0","100.0","Non-CFO","2021","2","2021","1","03","31"
"2021-03-31","Bureau","Pension Benefit Guaranty Corp","Pension Benefit Guaranty Corporation","2921238","1158","2921238","1158","0","0","100.0","100.0","null","2021","2","2021","1","03","31"
"2021-03-31","Agency","Presidio Trust Corporation","null","1507800","75","1496803","73","10997","2","99.27065923862581","97.33333333333333","Non-CFO","2021","2","2021","1","03","31"
"2021-03-31","Bureau","Presidio Trust Corporation","Presidio Trust Corporation","1507800","75","1496803","73","10997","2","99.27065923862581","97.33333333333333","null","2021","2","2021","1","03","31"
"2021-03-31","Agency","Railroad Retirement Board","null","22230423","4447","22230423","4447","0","0","100.0","100.0","Non-CFO","2021","2","2021","1","03","31"
"2021-03-31","Bureau","Railroad Retirement Board","Railroad Retirement Board","22230423","4447","22230423","4447","0","0","100.0","100.0","null","2021","2","2021","1","03","31"
"2021-03-31","Agency","Securities & Exchange Commission","null","2084586787","1097","2084586787","1097","0","0","100.0","100.0","Non-CFO","2021","2","2021","1","03","31"
"2021-03-31","Bureau","Securities & Exchange Commission","SEC Enforcement","2084278859","1044","2084278859","1044","0","0","100.0","100.0","null","2021","2","2021","1","03","31"
"2021-03-31","Bureau","Securities & Exchange Commission","Securities and Exchange Commission","307928","53","307928","53","0","0","100.0","100.0","null","2021","2","2021","1","03","31"
"2021-03-31","Agency","Selective Service System","null","0","0","0","0","0","0","0.0","0.0","Non-CFO","2021","2","2021","1","03","31"
"2021-03-31","Bureau","Selective Service System","Selective Service System","0","0","0","0","0","0","0.0","0.0","null","2021","2","2021","1","03","31"
"2021-03-31","Agency","Small Business Administration","null","12394281956","119416","12394281956","119416","0","0","100.0","100.0","CFO","2021","2","2021","1","03","31"
"2021-03-31","Bureau","Small Business Administration","Small Business Administration","12394281956","119416","12394281956","119416","0","0","100.0","100.0","null","2021","2","2021","1","03","31"
"2021-03-31","Agency","Smithsonian Institution","null","8949","2","0","0","8949","2","0.0","0.0","Non-CFO","2021","2","2021","1","03","31"
"2021-03-31","Bureau","Smithsonian Institution","Administrative Conference of the US","0","0","0","0","0","0","0.0","0.0","null","2021","2","2021","1","03","31"
"2021-03-31","Bureau","Smithsonian Institution","JFK Center for the Performing Arts","0","0","0","0","0","0","0.0","0.0","null","2021","2","2021","1","03","31"
"2021-03-31","Bureau","Smithsonian Institution","National Gallery of Art","0","0","0","0","0","0","0.0","0.0","null","2021","2","2021","1","03","31"
"2021-03-31","Bureau","Smithsonian Institution","Smithsonian Institution","8949","2","0","0","8949","2","0.0","0.0","null","2021","2","2021","1","03","31"
"2021-03-31","Agency","Social Security Administration","null","4614357012","1384889","2746418214","473881","1867938798","911008","59.51897971608444","34.217977036426745","CFO","2021","2","2021","1","03","31"
"2021-03-31","Bureau","Social Security Administration","Social Security Administration","4614357012","1384889","2746418214","473881","1867938798","911008","59.51897971608444","34.217977036426745","null","2021","2","2021","1","03","31"
"2021-03-31","Agency","Tennessee Valley Authority","null","0","0","0","0","0","0","0.0","0.0","Non-CFO","2021","2","2021","1","03","31"
"2021-03-31","Bureau","Tennessee Valley Authority","Tennessee Valley Authority","0","0","0","0","0","0","0.0","0.0","null","2021","2","2021","1","03","31"
"2021-03-31","Agency","The Judiciary","null","1048568","317","1036604","190","11964","127","98.85901534282947","59.936908517350155","Non-CFO","2021","2","2021","1","03","31"
"2021-03-31","Bureau","The Judiciary","Administrative Office of the U.S. Courts","1048568","317","1036604","190","11964","127","98.85901534282947","59.936908517350155","null","2021","2","2021","1","03","31"
"2021-03-31","Agency","U.S. Court of Appeals / Veterans Claims","null","172","1","172","1","0","0","100.0","100.0","Non-CFO","2021","2","2021","1","03","31"
"2021-03-31","Bureau","U.S. Court of Appeals / Veterans Claims","U.S. Court of Appeals / Veterans Claims","172","1","172","1","0","0","100.0","100.0","null","2021","2","2021","1","03","31"
"2021-03-31","Agency","U.S. Postal Service","null","78327427","59422","42584770","42254","35742657","17168","54.36763548992871","71.10834371108344","Non-CFO","2021","2","2021","1","03","31"
"2021-03-31","Bureau","U.S. Postal Service","U.S. Postal Service","78327427","59422","42584770","42254","35742657","17168","54.36763548992871","71.10834371108344","null","2021","2","2021","1","03","31"
"2021-03-31","Agency","U.S. Tax Court","null","0","0","0","0","0","0","0.0","0.0","Non-CFO","2021","2","2021","1","03","31"
"2021-03-31","Bureau","U.S. Tax Court","U.S. Tax Court","0","0","0","0","0","0","0.0","0.0","null","2021","2","2021","1","03","31"
"2021-03-31","Agency","US International Development Fin. Corp.","null","0","0","0","0","0","0","0.0","0.0","Non-CFO","2021","2","2021","1","03","31"
"2021-03-31","Bureau","US International Development Fin. Corp.","US International Development Fin. Corp.","0","0","0","0","0","0","0.0","0.0","null","2021","2","2021","1","03","31"
"2020-12-31","Agency","Agency for International Development","null","36102647","64","34426410","61","1676237","3","95.3570246525137","95.3125","CFO","2021","1","2020","4","12","31"
"2020-12-31","Bureau","Agency for International Development","Agency for International Development","36102647","64","34426410","61","1676237","3","95.3570246525137","95.3125","null","2021","1","2020","4","12","31"
"2020-12-31","Agency","American Battle Monuments Commission","null","0","0","0","0","0","0","0.0","0.0","Non-CFO","2021","1","2020","4","12","31"
"2020-12-31","Bureau","American Battle Monuments Commission","American Battle Monuments Commission","0","0","0","0","0","0","0.0","0.0","null","2021","1","2020","4","12","31"
"2020-12-31","Agency","Armed Forces Retirement Home","null","111253","117","81154","104","30099","13","72.94544866205855","88.88888888888889","Non-CFO","2021","1","2020","4","12","31"
"2020-12-31","Bureau","Armed Forces Retirement Home","Armed Forces Retirement Home","111253","117","81154","104","30099","13","72.94544866205855","88.88888888888889","null","2021","1","2020","4","12","31"
"2020-12-31","Agency","Commodity Futures Trading Commission","null","651938594","366","651938594","366","0","0","100.0","100.0","Non-CFO","2021","1","2020","4","12","31"
"2020-12-31","Bureau","Commodity Futures Trading Commission","Commodity Futures Trading Commission","651938594","366","651938594","366","0","0","100.0","100.0","null","2021","1","2020","4","12","31"
"2020-12-31","Agency","Consumer Product Safety Commission","null","2500","1","2500","1","0","0","100.0","100.0","Non-CFO","2021","1","2020","4","12","31"
"2020-12-31","Bureau","Consumer Product Safety Commission","Consumer Product Safety Commission","2500","1","2500","1","0","0","100.0","100.0","null","2021","1","2020","4","12","31"
"2020-12-31","Agency","Corp. for National and Community Service","null","4699773","1386","1133298","3","3566475","1383","24.11388805374217","0.21645021645021645","Non-CFO","2021","1","2020","4","12","31"
"2020-12-31","Bureau","Corp. for National and Community Service","Corp. for National and Community Service","4699773","1386","1133298","3","3566475","1383","24.11388805374217","0.21645021645021645","null","2021","1","2020","4","12","31"
"2020-12-31","Agency","Department of Agriculture","null","1625098929","48942","1604552729","45187","20546200","3755","98.73569543162255","92.32765314045196","CFO","2021","1","2020","4","12","31"
"2020-12-31","Bureau","Department of Agriculture","Agricultural Marketing Service","5496304","1492","4763503","531","732801","961","86.66738593789572","35.58981233243968","null","2021","1","2020","4","12","31"
"2020-12-31","Bureau","Department of Agriculture","Commodity Credit Corporation","130340355","10966","130340355","10966","0","0","100.0","100.0","null","2021","1","2020","4","12","31"
"2020-12-31","Bureau","Department of Agriculture","Farm Service Agency","643825444","11690","643825444","11690","0","0","100.0","100.0","null","2021","1","2020","4","12","31"
"2020-12-31","Bureau","Department of Agriculture","Federal Crop Insurance Corporation","32029","1","27679","0","4350","1","86.41855818164788","0.0","null","2021","1","2020","4","12","31"
"2020-12-31","Bureau","Department of Agriculture","Food Safety and Inspection Service","752630","848","752630","848","0","0","100.0","100.0","null","2021","1","2020","4","12","31"
"2020-12-31","Bureau","Department of Agriculture","Food and Nutrition Service","7983494","521","50472","6","7933022","515","0.6322043957194682","1.1516314779270633","null","2021","1","2020","4","12","31"
"2020-12-31","Bureau","Department of Agriculture","Forest Service","68191722","1171","61737947","297","6453775","874","90.53583805964014","25.362937660119556","null","2021","1","2020","4","12","31"
"2020-12-31","Bureau","Department of Agriculture","Rural Development","734681166","19175","734671619","19168","9547","7","99.99870052473892","99.96349413298566","null","2021","1","2020","4","12","31"
"2020-12-31","Bureau","Department of Agriculture","U.S. Department of Agriculture","33795785","3078","28383080","1681","5412705","1397","83.9840826304227","54.6133853151397","null","2021","1","2020","4","12","31"
"2020-12-31","Agency","Department of Commerce","null","29246509","2057","29243770","2016","2739","41","99.99063477969285","98.00680602819641","CFO","2021","1","2020","4","12","31"
"2020-12-31","Bureau","Department of Commerce","Bureau of Industry and Security","1738130","23","1738130","23","0","0","100.0","100.0","null","2021","1","2020","4","12","31"
"2020-12-31","Bureau","Department of Commerce","Bureau of the Census","281317","501","281317","501","0","0","100.0","100.0","null","2021","1","2020","4","12","31"
"2020-12-31","Bureau","Department of Commerce","Economic Development Administration","5105195","11","5105195","11","0","0","100.0","100.0","null","2021","1","2020","4","12","31"
"2020-12-31","Bureau","Department of Commerce","Economic and Statistical Analysis","0","0","0","0","0","0","0.0","0.0","null","2021","1","2020","4","12","31"
"2020-12-31","Bureau","Department of Commerce","General Administration","4660","1","4660","1","0","0","100.0","100.0","null","2021","1","2020","4","12","31"
"2020-12-31","Bureau","Department of Commerce","International Trade Administration","2739","41","0","0","2739","41","0.0","0.0","null","2021","1","2020","4","12","31"
"2020-12-31","Bureau","Department of Commerce","Minority Business Development Agency","0","0","0","0","0","0","0.0","0.0","null","2021","1","2020","4","12","31"
"2020-12-31","Bureau","Department of Commerce","NOAA","20793411","904","20793411","904","0","0","100.0","100.0","null","2021","1","2020","4","12","31"
"2020-12-31","Bureau","Department of Commerce","Nat'l Institute of Standards& Technology","670552","5","670552","5","0","0","100.0","100.0","null","2021","1","2020","4","12","31"
"2020-12-31","Bureau","Department of Commerce","Nat'l Telecomm & Information Admin.","296093","1","296093","1","0","0","100.0","100.0","null","2021","1","2020","4","12","31"
"2020-12-31","Bureau","Department of Commerce","National Technical Information Service","2100","1","2100","1","0","0","100.0","100.0","null","2021","1","2020","4","12","31"
"2020-12-31","Bureau","Department of Commerce","Office of the Inspector General","0","0","0","0","0","0","0.0","0.0","null","2021","1","2020","4","12","31"
"2020-12-31","Bureau","Department of Commerce","Patent and Trademark Office","352312","569","352312","569","0","0","100.0","100.0","null","2021","1","2020","4","12","31"
"2020-12-31","Agency","Department of Defense","null","2353137731","1727361","1062557722","274104","1290580009","1453257","45.154931137347866","15.868367990246393","CFO","2021","1","2020","4","12","31"
"2020-12-31","Bureau","Department of Defense","Consolidated Report","2353137731","1727361","1062557722","274104","1290580009","1453257","45.154931137347866","15.868367990246393","null","2021","1","2020","4","12","31"
"2020-12-31","Agency","Department of Education","null","136760468004","23486089","136708601686","23485691","51866318","398","99.96207506543595","99.9983053798357","CFO","2021","1","2020","4","12","31"
"2020-12-31","Bureau","Department of Education","Departmental Management","849109626","2138","797243308","1740","51866318","398","93.89168177914402","81.3844714686623","null","2021","1","2020","4","12","31"
"2020-12-31","Bureau","Department of Education","Federal Student Aid","135911358378","23483951","135911358378","23483951","0","0","100.0","100.0","null","2021","1","2020","4","12","31"
"2020-12-31","Bureau","Department of Education","Office of Postsecondary Education","0","0","0","0","0","0","0.0","0.0","null","2021","1","2020","4","12","31"
"2020-12-31","Agency","Department of Energy","null","14505094","107","14505094","107","0","0","100.0","100.0","CFO","2021","1","2020","4","12","31"
"2020-12-31","Bureau","Department of Energy","Bonneville Power Administration","1649642","31","1649642","31","0","0","100.0","100.0","null","2021","1","2020","4","12","31"
"2020-12-31","Bureau","Department of Energy","Energy Consolidated Reports","12855452","76","12855452","76","0","0","100.0","100.0","null","2021","1","2020","4","12","31"
"2020-12-31","Agency","Department of Health & Human Services","null","9776287975","1164806","9587923296","1144745","188364679","20061","98.07324948404049","98.27773895395457","CFO","2021","1","2020","4","12","31"
"2020-12-31","Bureau","Department of Health & Human Services","Administration for Children and Families","29708295","1814","29708295","1814","0","0","100.0","100.0","null","2021","1","2020","4","12","31"
"2020-12-31","Bureau","Department of Health & Human Services","Administration for Community Living","0","0","0","0","0","0","0.0","0.0","null","2021","1","2020","4","12","31"
"2020-12-31","Bureau","Department of Health & Human Services","Centers for Disease Control","7110339","112","63283","14","7047056","98","0.8900138235321832","12.5","null","2021","1","2020","4","12","31"
"2020-12-31","Bureau","Department of Health & Human Services","Centers for Medicare & Medicaid Services","9481865417","1147020","9392617270","1140446","89248147","6574","99.05874906387105","99.42686265278722","null","2021","1","2020","4","12","31"
"2020-12-31","Bureau","Department of Health & Human Services","Food and Drug Administration","102590561","11410","30528633","1177","72061928","10233","29.757740578102503","10.315512708150745","null","2021","1","2020","4","12","31"
"2020-12-31","Bureau","Department of Health & Human Services","Health Resources and Services Admin","92118711","578","92118711","578","0","0","100.0","100.0","null","2021","1","2020","4","12","31"
"2020-12-31","Bureau","Department of Health & Human Services","Indian Health Services","39255755","2992","29148387","205","10107368","2787","74.25251915292421","6.851604278074866","null","2021","1","2020","4","12","31"
"2020-12-31","Bureau","Department of Health & Human Services","National Institutes of Health","16222450","478","6322270","109","9900180","369","38.97235004576991","22.803347280334727","null","2021","1","2020","4","12","31"
"2020-12-31","Bureau","Department of Health & Human Services","Office of the Inspector General","131","1","131","1","0","0","100.0","100.0","null","2021","1","2020","4","12","31"
"2020-12-31","Bureau","Department of Health & Human Services","Office of the Secretary","8329","8","8329","8","0","0","100.0","100.0","null","2021","1","2020","4","12","31"
"2020-12-31","Bureau","Department of Health & Human Services","Program Support Center","6447712","380","6447712","380","0","0","100.0","100.0","null","2021","1","2020","4","12","31"
"2020-12-31","Bureau","Department of Health & Human Services","Substance Abuse & Mental Health Admin.","960275","13","960275","13","0","0","100.0","100.0","null","2021","1","2020","4","12","31"
"2020-12-31","Agency","Department of Homeland Security","null","403276883","58356","403274080","58351","2803","5","99.99930494404262","99.99143190074714","CFO","2021","1","2020","4","12","31"
"2020-12-31","Bureau","Department of Homeland Security","Bureau of Customs & Border Protection","8771871","629","8771871","629","0","0","100.0","100.0","null","2021","1","2020","4","12","31"
"2020-12-31","Bureau","Department of Homeland Security","Citizenship and Immigration Services","1062493","1244","1062493","1244","0","0","100.0","100.0","null","2021","1","2020","4","12","31"
"2020-12-31","Bureau","Department of Homeland Security","Domestic Nuclear Detection Office","2803","5","0","0","2803","5","0.0","0.0","null","2021","1","2020","4","12","31"
"2020-12-31","Bureau","Department of Homeland Security","Emergency Preparedness & Resp","301354801","43093","301354801","43093","0","0","100.0","100.0","null","2021","1","2020","4","12","31"
"2020-12-31","Bureau","Department of Homeland Security","Federal Law Enforcement Training Ctr.","0","0","0","0","0","0","0.0","0.0","null","2021","1","2020","4","12","31"
"2020-12-31","Bureau","Department of Homeland Security","Immigration and Customs Enforcement","13307886","521","13307886","521","0","0","100.0","100.0","null","2021","1","2020","4","12","31"
"2020-12-31","Bureau","Department of Homeland Security","Info Analysis Infrastructure Prot-NPPD","0","0","0","0","0","0","0.0","0.0","null","2021","1","2020","4","12","31"
"2020-12-31","Bureau","Department of Homeland Security","Management Headquarters","0","0","0","0","0","0","0.0","0.0","null","2021","1","2020","4","12","31"
"2020-12-31","Bureau","Department of Homeland Security","Office of Biometric Identity Management","0","0","0","0","0","0","0.0","0.0","null","2021","1","2020","4","12","31"
"2020-12-31","Bureau","Department of Homeland Security","Office of Health Affairs","0","0","0","0","0","0","0.0","0.0","null","2021","1","2020","4","12","31"
"2020-12-31","Bureau","Department of Homeland Security","Office of the Inspector General DHS","100","1","100","1","0","0","100.0","100.0","null","2021","1","2020","4","12","31"
"2020-12-31","Bureau","Department of Homeland Security","Science and Technology","0","0","0","0","0","0","0.0","0.0","null","2021","1","2020","4","12","31"
"2020-12-31","Bureau","Department of Homeland Security","Transportation Safety Administration","0","0","0","0","0","0","0.0","0.0","null","2021","1","2020","4","12","31"
"2020-12-31","Bureau","Department of Homeland Security","U.S. Coast Guard","78776929","12863","78776929","12863","0","0","100.0","100.0","null","2021","1","2020","4","12","31"
"2020-12-31","Bureau","Department of Homeland Security","U.S. Secret Service","0","0","0","0","0","0","0.0","0.0","null","2021","1","2020","4","12","31"
"2020-12-31","Agency","Department of Housing and Urban Development","null","141128522","4908","140337966","4900","790556","8","99.43983258040497","99.83700081499593","CFO","2021","1","2020","4","12","31"
"2020-12-31","Bureau","Department of Housing and Urban Development","Community Planning and Development","0","0","0","0","0","0","0.0","0.0","null","2021","1","2020","4","12","31"
"2020-12-31","Bureau","Department of Housing and Urban Development","Government National Mortgage Association","0","0","0","0","0","0","0.0","0.0","null","2021","1","2020","4","12","31"
"2020-12-31","Bureau","Department of Housing and Urban Development","Housing Programs","138594151","4895","138586688","4893","7463","2","99.99461521287432","99.9591419816139","null","2021","1","2020","4","12","31"
"2020-12-31","Bureau","Department of Housing and Urban Development","Management and Administration","102492","8","3323","5","99169","3","3.24220426960153","62.5","null","2021","1","2020","4","12","31"
"2020-12-31","Bureau","Department of Housing and Urban Development","Policy, Development and Research","0","0","0","0","0","0","0.0","0.0","null","2021","1","2020","4","12","31"
"2020-12-31","Bureau","Department of Housing and Urban Development","Public and Indian Housing Programs","2431879","5","1747955","2","683924","3","71.87672577459652","40.0","null","2021","1","2020","4","12","31"
"2020-12-31","Agency","Department of Justice","null","91631966","38096","87782787","37715","3849179","381","95.79930545198604","98.99989500209996","CFO","2021","1","2020","4","12","31"
"2020-12-31","Bureau","Department of Justice","Bureau of ATF and Explosives","20422","4","20422","4","0","0","100.0","100.0","null","2021","1","2020","4","12","31"
"2020-12-31","Bureau","Department of Justice","Drug Enforcement Administration","307978","21","307978","21","0","0","100.0","100.0","null","2021","1","2020","4","12","31"
"2020-12-31","Bureau","Department of Justice","Federal Bureau of Investigation","260265","66","260265","66","0","0","100.0","100.0","null","2021","1","2020","4","12","31"
"2020-12-31","Bureau","Department of Justice","Federal Prison Industries","935102","183","935102","183","0","0","100.0","100.0","null","2021","1","2020","4","12","31"
"2020-12-31","Bureau","Department of Justice","Federal Prison System","902521","136","902521","136","0","0","100.0","100.0","null","2021","1","2020","4","12","31"
"2020-12-31","Bureau","Department of Justice","General Administration","0","0","0","0","0","0","0.0","0.0","null","2021","1","2020","4","12","31"
"2020-12-31","Bureau","Department of Justice","Legal Activities","89193717","37677","85356499","37305","3837218","372","95.69788306949917","99.01266024364998","null","2021","1","2020","4","12","31"
"2020-12-31","Bureau","Department of Justice","Office of Justice Assistance Programs","0","0","0","0","0","0","0.0","0.0","null","2021","1","2020","4","12","31"
"2020-12-31","Bureau","Department of Justice","U.S. Marshals Service","11961","9","0","0","11961","9","0.0","0.0","null","2021","1","2020","4","12","31"
"2020-12-31","Agency","Department of Labor","null","195229780","45768","174502907","41523","20726873","4245","89.38334459015422","90.72496067121132","CFO","2021","1","2020","4","12","31"
"2020-12-31","Bureau","Department of Labor","Bureau of Labor Statistics","10534","1","10534","1","0","0","100.0","100.0","null","2021","1","2020","4","12","31"
"2020-12-31","Bureau","Department of Labor","Departmental Management","0","0","0","0","0","0","0.0","0.0","null","2021","1","2020","4","12","31"
"2020-12-31","Bureau","Department of Labor","Employee Benefit Security Administration","17652069","396","17652069","396","0","0","100.0","100.0","null","2021","1","2020","4","12","31"
"2020-12-31","Bureau","Department of Labor","Employment Standards Administration","87233557","25976","73790907","24243","13442650","1733","84.59004715352832","93.32845703726517","null","2021","1","2020","4","12","31"
"2020-12-31","Bureau","Department of Labor","Employment and Training Administration","3363727","10","3363727","10","0","0","100.0","100.0","null","2021","1","2020","4","12","31"
"2020-12-31","Bureau","Department of Labor","Mine Safety and Health Administration","29639462","13921","25274649","12786","4364813","1135","85.27364295613732","91.84685008260901","null","2021","1","2020","4","12","31"
"2020-12-31","Bureau","Department of Labor","Occupational Safety and Health Admin","57330431","5464","54411021","4087","2919410","1377","94.90774803350074","74.79868228404099","null","2021","1","2020","4","12","31"
"2020-12-31","Agency","Department of State","null","20452786","24307","16342616","22097","4110170","2210","79.90410695149306","90.90796889784836","CFO","2021","1","2020","4","12","31"
"2020-12-31","Bureau","Department of State","Civil Monetary Penalties","0","0","0","0","0","0","0.0","0.0","null","2021","1","2020","4","12","31"
"2020-12-31","Bureau","Department of State","Department of State","18058344","8876","13948174","6666","4110170","2210","77.23949660057423","75.10139702568725","null","2021","1","2020","4","12","31"
"2020-12-31","Bureau","Department of State","International Commissions","0","0","0","0","0","0","0.0","0.0","null","2021","1","2020","4","12","31"
"2020-12-31","Bureau","Department of State","Passport NSF","2394442","15431","2394442","15431","0","0","100.0","100.0","null","2021","1","2020","4","12","31"
"2020-12-31","Agency","Department of Transportation","null","66193861","7494","65584126","7441","609735","53","99.0788647303713","99.29276754737123","CFO","2021","1","2020","4","12","31"
"2020-12-31","Bureau","Department of Transportation","Federal Aviation Administration","2521618","319","1911883","266","609735","53","75.8196919596862","83.38557993730407","null","2021","1","2020","4","12","31"
"2020-12-31","Bureau","Department of Transportation","Federal Highway Administration","123342","7","123342","7","0","0","100.0","100.0","null","2021","1","2020","4","12","31"
"2020-12-31","Bureau","Department of Transportation","Federal Motor Carrier Safety Admin","61175749","7101","61175749","7101","0","0","100.0","100.0","null","2021","1","2020","4","12","31"
"2020-12-31","Bureau","Department of Transportation","Federal Railroad Administration","127629","12","127629","12","0","0","100.0","100.0","null","2021","1","2020","4","12","31"
"2020-12-31","Bureau","Department of Transportation","Federal Transit Administration","784592","2","784592","2","0","0","100.0","100.0","null","2021","1","2020","4","12","31"
"2020-12-31","Bureau","Department of Transportation","Maritime Administration","5395","6","5395","6","0","0","100.0","100.0","null","2021","1","2020","4","12","31"
"2020-12-31","Bureau","Department of Transportation","National Highway Traffic Safety Admin.","18189","3","18189","3","0","0","100.0","100.0","null","2021","1","2020","4","12","31"
"2020-12-31","Bureau","Department of Transportation","Office of the Inspector General","211","1","211","1","0","0","100.0","100.0","null","2021","1","2020","4","12","31"
"2020-12-31","Bureau","Department of Transportation","Office of the Secretary","1040394","15","1040394","15","0","0","100.0","100.0","null","2021","1","2020","4","12","31"
"2020-12-31","Bureau","Department of Transportation","Pipeline Hazardous Material Safety Admin","386240","24","386240","24","0","0","100.0","100.0","null","2021","1","2020","4","12","31"
"2020-12-31","Bureau","Department of Transportation","Research Innovative Technology Admin","1599","2","1599","2","0","0","100.0","100.0","null","2021","1","2020","4","12","31"
"2020-12-31","Bureau","Department of Transportation","St. Lawrence Seaway Development Corp.","8903","2","8903","2","0","0","100.0","100.0","null","2021","1","2020","4","12","31"
"2020-12-31","Bureau","Department of Transportation","Surface Transportation Board","0","0","0","0","0","0","0.0","0.0","null","2021","1","2020","4","12","31"
"2020-12-31","Agency","Department of Veterans Affairs","null","10934013","12054","6567801","8637","4366212","3417","60.06761652835057","71.65256346441015","CFO","2021","1","2020","4","12","31"
"2020-12-31","Bureau","Department of Veterans Affairs","Administration and Cemeteries","1156676","679","3351","5","1153325","674","0.28970947784859374","0.7363770250368189","null","2021","1","2020","4","12","31"
"2020-12-31","Bureau","Department of Veterans Affairs","Housing Credit Assistance","944684","22","0","0","944684","22","0.0","0.0","null","2021","1","2020","4","12","31"
"2020-12-31","Bureau","Department of Veterans Affairs","Life Insurance","735269","135","735269","135","0","0","100.0","100.0","null","2021","1","2020","4","12","31"
"2020-12-31","Bureau","Department of Veterans Affairs","Medical and Construction","6807140","9524","5829181","8497","977959","1027","85.63333499825184","89.21671566568669","null","2021","1","2020","4","12","31"
"2020-12-31","Bureau","Department of Veterans Affairs","Veterans Benefits","1290244","1694","0","0","1290244","1694","0.0","0.0","null","2021","1","2020","4","12","31"
"2020-12-31","Agency","Department of the Interior","null","91207816","33548","91207730","33547","86","1","99.99990570983522","99.99701919637535","CFO","2021","1","2020","4","12","31"
"2020-12-31","Bureau","Department of the Interior","Bureau of Indian Affairs","54852510","30210","54852510","30210","0","0","100.0","100.0","null","2021","1","2020","4","12","31"
"2020-12-31","Bureau","Department of the Interior","Bureau of Land Management","15889204","351","15889204","351","0","0","100.0","100.0","null","2021","1","2020","4","12","31"
"2020-12-31","Bureau","Department of the Interior","Bureau of Ocean Energy Mgmt., Reg & Enf","0","0","0","0","0","0","0.0","0.0","null","2021","1","2020","4","12","31"
"2020-12-31","Bureau","Department of the Interior","Bureau of Reclamation","95773","78","95773","78","0","0","100.0","100.0","null","2021","1","2020","4","12","31"
"2020-12-31","Bureau","Department of the Interior","Bureau of Safety and Environmental Enf.","86","1","0","0","86","1","0.0","0.0","null","2021","1","2020","4","12","31"
"2020-12-31","Bureau","Department of the Interior","Fish and Wildlife Service","703719","76","703719","76","0","0","100.0","100.0","null","2021","1","2020","4","12","31"
"2020-12-31","Bureau","Department of the Interior","Geological Survey","135591","120","135591","120","0","0","100.0","100.0","null","2021","1","2020","4","12","31"
"2020-12-31","Bureau","Department of the Interior","National Park Service","7821051","1865","7821051","1865","0","0","100.0","100.0","null","2021","1","2020","4","12","31"
"2020-12-31","Bureau","Department of the Interior","Office of Natural Resources Revenue","8372806","501","8372806","501","0","0","100.0","100.0","null","2021","1","2020","4","12","31"
"2020-12-31","Bureau","Department of the Interior","Office of Surface Mining","3248441","325","3248441","325","0","0","100.0","100.0","null","2021","1","2020","4","12","31"
"2020-12-31","Bureau","Department of the Interior","Office of the Secretary","88635","21","88635","21","0","0","100.0","100.0","null","2021","1","2020","4","12","31"
"2020-12-31","Agency","Department of the Treasury","null","45475337","5822","44869812","5791","605525","31","98.66845406775106","99.46753692889041","CFO","2021","1","2020","4","12","31"
"2020-12-31","Bureau","Department of the Treasury","Bureau of Engraving and Printing","84528","1","84528","1","0","0","100.0","100.0","null","2021","1","2020","4","12","31"
"2020-12-31","Bureau","Department of the Treasury","Bureau of the Fiscal Service","13618512","4215","13618512","4215","0","0","100.0","100.0","null","2021","1","2020","4","12","31"
"2020-12-31","Bureau","Department of the Treasury","Community Dev Financial Inst Fund","4506298","8","4506298","8","0","0","100.0","100.0","null","2021","1","2020","4","12","31"
"2020-12-31","Bureau","Department of the Treasury","Comptroller of the Currency","1102473","25","1101200","21","1273","4","99.88453231961236","84.0","null","2021","1","2020","4","12","31"
"2020-12-31","Bureau","Department of the Treasury","D.C. Pension Program","402782","23","402782","23","0","0","100.0","100.0","null","2021","1","2020","4","12","31"
"2020-12-31","Bureau","Department of the Treasury","Departmental Offices","23835114","1380","23293772","1354","541342","26","97.72880465350407","98.1159420289855","null","2021","1","2020","4","12","31"
"2020-12-31","Bureau","Department of the Treasury","Financial Crimes Enforcement Network","1607855","4","1544945","3","62910","1","96.08733374589127","75.0","null","2021","1","2020","4","12","31"
"2020-12-31","Bureau","Department of the Treasury","Interest on Tax/Deposit of Earnings","0","0","0","0","0","0","0.0","0.0","null","2021","1","2020","4","12","31"
"2020-12-31","Bureau","Department of the Treasury","Internal Revenue Service","267235","138","267235","138","0","0","100.0","100.0","null","2021","1","2020","4","12","31"
"2020-12-31","Bureau","Department of the Treasury","International Monetary Funds","0","0","0","0","0","0","0.0","0.0","null","2021","1","2020","4","12","31"
"2020-12-31","Bureau","Department of the Treasury","Office of Financial Research","0","0","0","0","0","0","0.0","0.0","null","2021","1","2020","4","12","31"
"2020-12-31","Bureau","Department of the Treasury","Office of Sec International Affairs","0","0","0","0","0","0","0.0","0.0","null","2021","1","2020","4","12","31"
"2020-12-31","Bureau","Department of the Treasury","Office of the Secretary","0","0","0","0","0","0","0.0","0.0","null","2021","1","2020","4","12","31"
"2020-12-31","Bureau","Department of the Treasury","Pandemic Receivables","0","0","0","0","0","0","0.0","0.0","null","2021","1","2020","4","12","31"
"2020-12-31","Bureau","Department of the Treasury","Spec Insp Gen-Troubled Asset Rel Prog","3916","1","3916","1","0","0","100.0","100.0","null","2021","1","2020","4","12","31"
"2020-12-31","Bureau","Department of the Treasury","Tobacco Tax and Trade","1000","1","1000","1","0","0","100.0","100.0","null","2021","1","2020","4","12","31"
"2020-12-31","Bureau","Department of the Treasury","Treasury Forfeiture Fund","0","0","0","0","0","0","0.0","0.0","null","2021","1","2020","4","12","31"
"2020-12-31","Bureau","Department of the Treasury","Treasury Franchise Fund","66","1","66","1","0","0","100.0","100.0","null","2021","1","2020","4","12","31"
"2020-12-31","Bureau","Department of the Treasury","Treasury IG for Tax Admin","0","0","0","0","0","0","0.0","0.0","null","2021","1","2020","4","12","31"
"2020-12-31","Bureau","Department of the Treasury","U.S. Mint","45558","25","45558","25","0","0","100.0","100.0","null","2021","1","2020","4","12","31"
"2020-12-31","Bureau","Department of the Treasury","U.S. Treasury IG Office","0","0","0","0","0","0","0.0","0.0","null","2021","1","2020","4","12","31"
"2020-12-31","Agency","Environmental Protection Agency","null","24191595","232","24187235","230","4360","2","99.98197721150672","99.13793103448276","CFO","2021","1","2020","4","12","31"
"2020-12-31","Bureau","Environmental Protection Agency","Environmental Protection Agency","24191595","232","24187235","230","4360","2","99.98197721150672","99.13793103448276","null","2021","1","2020","4","12","31"
"2020-12-31","Agency","Equal Employment Opportunity Commission","null","24541","11","24541","11","0","0","100.0","100.0","Non-CFO","2021","1","2020","4","12","31"
"2020-12-31","Bureau","Equal Employment Opportunity Commission","Equal Employment Opportunity Commission","24541","11","24541","11","0","0","100.0","100.0","null","2021","1","2020","4","12","31"
"2020-12-31","Agency","Export - Import  Bank","null","0","0","0","0","0","0","0.0","0.0","Non-CFO","2021","1","2020","4","12","31"
"2020-12-31","Bureau","Export - Import  Bank","Export-Import Bank","0","0","0","0","0","0","0.0","0.0","null","2021","1","2020","4","12","31"
"2020-12-31","Agency","Farm Credit Administration","null","630","1","630","1","0","0","100.0","100.0","Non-CFO","2021","1","2020","4","12","31"
"2020-12-31","Bureau","Farm Credit Administration","Farm Credit Administration","630","1","630","1","0","0","100.0","100.0","null","2021","1","2020","4","12","31"
"2020-12-31","Bureau","Farm Credit Administration","Farm Credit System Insurance Corporation","0","0","0","0","0","0","0.0","0.0","null","2021","1","2020","4","12","31"
"2020-12-31","Agency","Federal Communications Commission","null","205320179","20509","205320179","20509","0","0","100.0","100.0","Non-CFO","2021","1","2020","4","12","31"
"2020-12-31","Bureau","Federal Communications Commission","Federal Communications Commission","205320179","20509","205320179","20509","0","0","100.0","100.0","null","2021","1","2020","4","12","31"
"2020-12-31","Agency","Federal Deposit Insurance Corporation","null","0","0","0","0","0","0","0.0","0.0","Non-CFO","2021","1","2020","4","12","31"
"2020-12-31","Bureau","Federal Deposit Insurance Corporation","Federal Deposit Insurance Corporation","0","0","0","0","0","0","0.0","0.0","null","2021","1","2020","4","12","31"
"2020-12-31","Agency","Federal Election Commission","null","658984","112","586484","110","72500","2","88.99821543466912","98.21428571428571","Non-CFO","2021","1","2020","4","12","31"
"2020-12-31","Bureau","Federal Election Commission","Federal Election Commission","658984","112","586484","110","72500","2","88.99821543466912","98.21428571428571","null","2021","1","2020","4","12","31"
"2020-12-31","Agency","Federal Labor Relations Authority","null","0","0","0","0","0","0","0.0","0.0","Non-CFO","2021","1","2020","4","12","31"
"2020-12-31","Bureau","Federal Labor Relations Authority","Federal Labor Relations Authority","0","0","0","0","0","0","0.0","0.0","null","2021","1","2020","4","12","31"
"2020-12-31","Agency","Federal Maritime Commission","null","397016","6","397016","6","0","0","100.0","100.0","Non-CFO","2021","1","2020","4","12","31"
"2020-12-31","Bureau","Federal Maritime Commission","Salaries and Expenses","397016","6","397016","6","0","0","100.0","100.0","null","2021","1","2020","4","12","31"
"2020-12-31","Agency","Federal Mediation/Conciliation Service","null","0","0","0","0","0","0","0.0","0.0","Non-CFO","2021","1","2020","4","12","31"
"2020-12-31","Bureau","Federal Mediation/Conciliation Service","Federal Mediation/Conciliation Service","0","0","0","0","0","0","0.0","0.0","null","2021","1","2020","4","12","31"
"2020-12-31","Agency","Federal Trade Commission","null","483060628","55","483060628","55","0","0","100.0","100.0","Non-CFO","2021","1","2020","4","12","31"
"2020-12-31","Bureau","Federal Trade Commission","Federal Trade Commission","483060628","55","483060628","55","0","0","100.0","100.0","null","2021","1","2020","4","12","31"
"2020-12-31","Agency","Funds Appropriated to the President","null","0","0","0","0","0","0","0.0","0.0","Non-CFO","2021","1","2020","4","12","31"
"2020-12-31","Bureau","Funds Appropriated to the President","African Development Foundation","0","0","0","0","0","0","0.0","0.0","null","2021","1","2020","4","12","31"
"2020-12-31","Bureau","Funds Appropriated to the President","Defense Security Assistance Agency","0","0","0","0","0","0","0.0","0.0","null","2021","1","2020","4","12","31"
"2020-12-31","Bureau","Funds Appropriated to the President","Executive Branch","0","0","0","0","0","0","0.0","0.0","null","2021","1","2020","4","12","31"
"2020-12-31","Bureau","Funds Appropriated to the President","Inter-American Foundation","0","0","0","0","0","0","0.0","0.0","null","2021","1","2020","4","12","31"
"2020-12-31","Bureau","Funds Appropriated to the President","Peace Corps","0","0","0","0","0","0","0.0","0.0","null","2021","1","2020","4","12","31"
"2020-12-31","Bureau","Funds Appropriated to the President","Trade and Development Agency","0","0","0","0","0","0","0.0","0.0","null","2021","1","2020","4","12","31"
"2020-12-31","Agency","General Services Administration","null","6489524","2087","4870367","1381","1619157","706","75.04968006898503","66.1715380929564","CFO","2021","1","2020","4","12","31"
"2020-12-31","Bureau","General Services Administration","General Services Administration","6489524","2087","4870367","1381","1619157","706","75.04968006898503","66.1715380929564","null","2021","1","2020","4","12","31"
"2020-12-31","Agency","Legis Branch-Library of Congress","null","0","0","0","0","0","0","0.0","0.0","Non-CFO","2021","1","2020","4","12","31"
"2020-12-31","Bureau","Legis Branch-Library of Congress","Library of Congress","0","0","0","0","0","0","0.0","0.0","null","2021","1","2020","4","12","31"
"2020-12-31","Agency","Legislative Branch - U.S. House/Senate","null","216891","161","0","0","216891","161","0.0","0.0","Non-CFO","2021","1","2020","4","12","31"
"2020-12-31","Bureau","Legislative Branch - U.S. House/Senate","U.S. House of Representatives","216891","161","0","0","216891","161","0.0","0.0","null","2021","1","2020","4","12","31"
"2020-12-31","Agency","Legislative Branch-CBO","null","0","0","0","0","0","0","0.0","0.0","Non-CFO","2021","1","2020","4","12","31"
"2020-12-31","Bureau","Legislative Branch-CBO","Congressional Budget Office","0","0","0","0","0","0","0.0","0.0","null","2021","1","2020","4","12","31"
"2020-12-31","Agency","Legislative Branch-GAO","null","0","0","0","0","0","0","0.0","0.0","Non-CFO","2021","1","2020","4","12","31"
"2020-12-31","Bureau","Legislative Branch-GAO","Government Accountability Office","0","0","0","0","0","0","0.0","0.0","null","2021","1","2020","4","12","31"
"2020-12-31","Agency","Legislative Branch-GPO","null","84359","27","84359","27","0","0","100.0","100.0","Non-CFO","2021","1","2020","4","12","31"
"2020-12-31","Bureau","Legislative Branch-GPO","Government Publishing Office","84359","27","84359","27","0","0","100.0","100.0","null","2021","1","2020","4","12","31"
"2020-12-31","Agency","Legislative Branch-Office of Tech.","null","0","0","0","0","0","0","0.0","0.0","Non-CFO","2021","1","2020","4","12","31"
"2020-12-31","Bureau","Legislative Branch-Office of Tech.","Medicaid & CHIP Payment & Access Comm.","0","0","0","0","0","0","0.0","0.0","null","2021","1","2020","4","12","31"
"2020-12-31","Bureau","Legislative Branch-Office of Tech.","Open World Leadership","0","0","0","0","0","0","0.0","0.0","null","2021","1","2020","4","12","31"
"2020-12-31","Agency","Merit Systems Protection Board","null","144","1","144","1","0","0","100.0","100.0","Non-CFO","2021","1","2020","4","12","31"
"2020-12-31","Bureau","Merit Systems Protection Board","Merit Systems Protection Board","144","1","144","1","0","0","100.0","100.0","null","2021","1","2020","4","12","31"
"2020-12-31","Agency","National Aeronautics and Space Administration","null","1268442","128","1268442","128","0","0","100.0","100.0","CFO","2021","1","2020","4","12","31"
"2020-12-31","Bureau","National Aeronautics and Space Administration","National Aeronautics and Space Admin","1268442","128","1268442","128","0","0","100.0","100.0","null","2021","1","2020","4","12","31"
"2020-12-31","Agency","National Archives & Records Admin","null","118848","101","118848","101","0","0","100.0","100.0","Non-CFO","2021","1","2020","4","12","31"
"2020-12-31","Bureau","National Archives & Records Admin","Nat'l Archives & Records Administration","118848","101","118848","101","0","0","100.0","100.0","null","2021","1","2020","4","12","31"
"2020-12-31","Agency","National Credit Union Administration","null","0","0","0","0","0","0","0.0","0.0","Non-CFO","2021","1","2020","4","12","31"
"2020-12-31","Bureau","National Credit Union Administration","National Credit Union Administration","0","0","0","0","0","0","0.0","0.0","null","2021","1","2020","4","12","31"
"2020-12-31","Agency","National Foundation  Arts & Humanities","null","0","0","0","0","0","0","0.0","0.0","Non-CFO","2021","1","2020","4","12","31"
"2020-12-31","Bureau","National Foundation  Arts & Humanities","National Endowment for the Arts","0","0","0","0","0","0","0.0","0.0","null","2021","1","2020","4","12","31"
"2020-12-31","Bureau","National Foundation  Arts & Humanities","National Endowment for the Humanities","0","0","0","0","0","0","0.0","0.0","null","2021","1","2020","4","12","31"
"2020-12-31","Agency","National Labor Relations Board","null","0","0","0","0","0","0","0.0","0.0","Non-CFO","2021","1","2020","4","12","31"
"2020-12-31","Bureau","National Labor Relations Board","National Labor Relations Board","0","0","0","0","0","0","0.0","0.0","null","2021","1","2020","4","12","31"
"2020-12-31","Agency","National Science Foundation","null","478657","82","477731","81","926","1","99.80654205412226","98.78048780487805","CFO","2021","1","2020","4","12","31"
"2020-12-31","Bureau","National Science Foundation","National Science Foundation","478657","82","477731","81","926","1","99.80654205412226","98.78048780487805","null","2021","1","2020","4","12","31"
"2020-12-31","Agency","Neighborhood Reinvestment Corporation","null","0","0","0","0","0","0","0.0","0.0","Non-CFO","2021","1","2020","4","12","31"
"2020-12-31","Bureau","Neighborhood Reinvestment Corporation","Neighborhood Reinvestment Corporation","0","0","0","0","0","0","0.0","0.0","null","2021","1","2020","4","12","31"
"2020-12-31","Agency","Nuclear Regulatory Commission","null","2471882","310","2461655","309","10227","1","99.5862666583599","99.6774193548387","CFO","2021","1","2020","4","12","31"
"2020-12-31","Bureau","Nuclear Regulatory Commission","Nuclear Regulatory Commission","2471882","310","2461655","309","10227","1","99.5862666583599","99.6774193548387","null","2021","1","2020","4","12","31"
"2020-12-31","Agency","Occupational Safety & Health Rev Comm","null","0","0","0","0","0","0","0.0","0.0","Non-CFO","2021","1","2020","4","12","31"
"2020-12-31","Bureau","Occupational Safety & Health Rev Comm","Occupational Safety & Health Rev Comm","0","0","0","0","0","0","0.0","0.0","null","2021","1","2020","4","12","31"
"2020-12-31","Agency","Office of Compliance","null","0","0","0","0","0","0","0.0","0.0","Non-CFO","2021","1","2020","4","12","31"
"2020-12-31","Bureau","Office of Compliance","Office of Compliance","0","0","0","0","0","0","0.0","0.0","null","2021","1","2020","4","12","31"
"2020-12-31","Agency","Office of Government Ethics","null","0","0","0","0","0","0","0.0","0.0","Non-CFO","2021","1","2020","4","12","31"
"2020-12-31","Bureau","Office of Government Ethics","Office of Government Ethics","0","0","0","0","0","0","0.0","0.0","null","2021","1","2020","4","12","31"
"2020-12-31","Agency","Office of Personnel Management","null","22659885","1396","22286724","1350","373161","46","98.3532087651813","96.70487106017193","CFO","2021","1","2020","4","12","31"
"2020-12-31","Bureau","Office of Personnel Management","Office of Personnel Management","22659885","1396","22286724","1350","373161","46","98.3532087651813","96.70487106017193","null","2021","1","2020","4","12","31"
"2020-12-31","Agency","Office of Special Counsel","null","0","0","0","0","0","0","0.0","0.0","Non-CFO","2021","1","2020","4","12","31"
"2020-12-31","Bureau","Office of Special Counsel","Office of Special Counsel","0","0","0","0","0","0","0.0","0.0","null","2021","1","2020","4","12","31"
"2020-12-31","Agency","Other Agencies","null","5929279","119","5747","3","5923532","116","0.09692578136397359","2.5210084033613445","Non-CFO","2021","1","2020","4","12","31"
"2020-12-31","Bureau","Other Agencies","Advisory Council on Hist. Preservation","0","0","0","0","0","0","0.0","0.0","null","2021","1","2020","4","12","31"
"2020-12-31","Bureau","Other Agencies","Archit.&Trans. Barriers Compliance Bd","0","0","0","0","0","0","0.0","0.0","null","2021","1","2020","4","12","31"
"2020-12-31","Bureau","Other Agencies","Architect of the Capitol","0","0","0","0","0","0","0.0","0.0","null","2021","1","2020","4","12","31"
"2020-12-31","Bureau","Other Agencies","Chemical Safety Board","0","0","0","0","0","0","0.0","0.0","null","2021","1","2020","4","12","31"
"2020-12-31","Bureau","Other Agencies","Comm. for Purchase from Blind/Handic.","0","0","0","0","0","0","0.0","0.0","null","2021","1","2020","4","12","31"
"2020-12-31","Bureau","Other Agencies","Commission On Fine Arts","0","0","0","0","0","0","0.0","0.0","null","2021","1","2020","4","12","31"
"2020-12-31","Bureau","Other Agencies","Consumer Financial Protection Bureau","5681484","74","0","0","5681484","74","0.0","0.0","null","2021","1","2020","4","12","31"
"2020-12-31","Bureau","Other Agencies","Council of Insps. Gen. of Intg. & Effy.","5475","9","0","0","5475","9","0.0","0.0","null","2021","1","2020","4","12","31"
"2020-12-31","Bureau","Other Agencies","Defense Nuclear Facilities Safety Board","0","0","0","0","0","0","0.0","0.0","null","2021","1","2020","4","12","31"
"2020-12-31","Bureau","Other Agencies","Delta Regional Authority","0","0","0","0","0","0","0.0","0.0","null","2021","1","2020","4","12","31"
"2020-12-31","Bureau","Other Agencies","Denali Commission","0","0","0","0","0","0","0.0","0.0","null","2021","1","2020","4","12","31"
"2020-12-31","Bureau","Other Agencies","District of Columbia Government","0","0","0","0","0","0","0.0","0.0","null","2021","1","2020","4","12","31"
"2020-12-31","Bureau","Other Agencies","Election Assistance Commission","5576","1","0","0","5576","1","0.0","0.0","null","2021","1","2020","4","12","31"
"2020-12-31","Bureau","Other Agencies","Federal Housing Finance Agency","191","1","0","0","191","1","0.0","0.0","null","2021","1","2020","4","12","31"
"2020-12-31","Bureau","Other Agencies","Federal Housing Finance Agency OIG","0","0","0","0","0","0","0.0","0.0","null","2021","1","2020","4","12","31"
"2020-12-31","Bureau","Other Agencies","Federal Mine Safety & Health Review Comm","0","0","0","0","0","0","0.0","0.0","null","2021","1","2020","4","12","31"
"2020-12-31","Bureau","Other Agencies","Gulf Coast Ecosystem Restoration Council","0","0","0","0","0","0","0.0","0.0","null","2021","1","2020","4","12","31"
"2020-12-31","Bureau","Other Agencies","James Madison Memorial Fellowship","221290","25","0","0","221290","25","0.0","0.0","null","2021","1","2020","4","12","31"
"2020-12-31","Bureau","Other Agencies","John C. Stennis","2934","2","0","0","2934","2","0.0","0.0","null","2021","1","2020","4","12","31"
"2020-12-31","Bureau","Other Agencies","Millennium Challenge Corporation","817","1","817","1","0","0","100.0","100.0","null","2021","1","2020","4","12","31"
"2020-12-31","Bureau","Other Agencies","Morris K. Udall Scholarship","0","0","0","0","0","0","0.0","0.0","null","2021","1","2020","4","12","31"
"2020-12-31","Bureau","Other Agencies","National Capital Planning Commission","0","0","0","0","0","0","0.0","0.0","null","2021","1","2020","4","12","31"
"2020-12-31","Bureau","Other Agencies","National Council on Disability","1579","2","0","0","1579","2","0.0","0.0","null","2021","1","2020","4","12","31"
"2020-12-31","Bureau","Other Agencies","National Mediation Board","0","0","0","0","0","0","0.0","0.0","null","2021","1","2020","4","12","31"
"2020-12-31","Bureau","Other Agencies","National Transportation Safety Board","0","0","0","0","0","0","0.0","0.0","null","2021","1","2020","4","12","31"
"2020-12-31","Bureau","Other Agencies","Privacy & Civil Liberties Oversight Bd","0","0","0","0","0","0","0.0","0.0","null","2021","1","2020","4","12","31"
"2020-12-31","Bureau","Other Agencies","Surface Transportation Board","0","0","0","0","0","0","0.0","0.0","null","2021","1","2020","4","12","31"
"2020-12-31","Bureau","Other Agencies","U.S.  Agency of Global Media","4930","2","4930","2","0","0","100.0","100.0","null","2021","1","2020","4","12","31"
"2020-12-31","Bureau","Other Agencies","U.S. Holocaust Memorial Council","0","0","0","0","0","0","0.0","0.0","null","2021","1","2020","4","12","31"
"2020-12-31","Bureau","Other Agencies","U.S. Inst. for Env. Conflict Resolution","5003","2","0","0","5003","2","0.0","0.0","null","2021","1","2020","4","12","31"
"2020-12-31","Bureau","Other Agencies","U.S. Institute of Peace","0","0","0","0","0","0","0.0","0.0","null","2021","1","2020","4","12","31"
"2020-12-31","Agency","Other Agencies/Boards/Commissions","null","482","1","0","0","482","1","0.0","0.0","Non-CFO","2021","1","2020","4","12","31"
"2020-12-31","Bureau","Other Agencies/Boards/Commissions","Medicare Payment Advisory Commission","0","0","0","0","0","0","0.0","0.0","null","2021","1","2020","4","12","31"
"2020-12-31","Bureau","Other Agencies/Boards/Commissions","U.S. Comm. on Int. Religious Freedom","0","0","0","0","0","0","0.0","0.0","null","2021","1","2020","4","12","31"
"2020-12-31","Bureau","Other Agencies/Boards/Commissions","U.S.-China Security Review Commission","482","1","0","0","482","1","0.0","0.0","null","2021","1","2020","4","12","31"
"2020-12-31","Agency","Pension Benefit Guaranty Corp","null","3262012","1153","3262012","1153","0","0","100.0","100.0","Non-CFO","2021","1","2020","4","12","31"
"2020-12-31","Bureau","Pension Benefit Guaranty Corp","Pension Benefit Guaranty Corporation","3262012","1153","3262012","1153","0","0","100.0","100.0","null","2021","1","2020","4","12","31"
"2020-12-31","Agency","Presidio Trust Corporation","null","1517237","78","1517237","78","0","0","100.0","100.0","Non-CFO","2021","1","2020","4","12","31"
"2020-12-31","Bureau","Presidio Trust Corporation","Presidio Trust Corporation","1517237","78","1517237","78","0","0","100.0","100.0","null","2021","1","2020","4","12","31"
"2020-12-31","Agency","Railroad Retirement Board","null","22009163","4400","22009163","4400","0","0","100.0","100.0","Non-CFO","2021","1","2020","4","12","31"
"2020-12-31","Bureau","Railroad Retirement Board","Railroad Retirement Board","22009163","4400","22009163","4400","0","0","100.0","100.0","null","2021","1","2020","4","12","31"
"2020-12-31","Agency","Securities & Exchange Commission","null","1958786528","991","1958786528","991","0","0","100.0","100.0","Non-CFO","2021","1","2020","4","12","31"
"2020-12-31","Bureau","Securities & Exchange Commission","SEC Enforcement","1958478368","938","1958478368","938","0","0","100.0","100.0","null","2021","1","2020","4","12","31"
"2020-12-31","Bureau","Securities & Exchange Commission","Securities and Exchange Commission","308160","53","308160","53","0","0","100.0","100.0","null","2021","1","2020","4","12","31"
"2020-12-31","Agency","Selective Service System","null","0","0","0","0","0","0","0.0","0.0","Non-CFO","2021","1","2020","4","12","31"
"2020-12-31","Bureau","Selective Service System","Selective Service System","0","0","0","0","0","0","0.0","0.0","null","2021","1","2020","4","12","31"
"2020-12-31","Agency","Small Business Administration","null","12370402730","119782","12370402730","119782","0","0","100.0","100.0","CFO","2021","1","2020","4","12","31"
"2020-12-31","Bureau","Small Business Administration","Small Business Administration","12370402730","119782","12370402730","119782","0","0","100.0","100.0","null","2021","1","2020","4","12","31"
"2020-12-31","Agency","Smithsonian Institution","null","5670","1","0","0","5670","1","0.0","0.0","Non-CFO","2021","1","2020","4","12","31"
"2020-12-31","Bureau","Smithsonian Institution","Administrative Conference of the US","0","0","0","0","0","0","0.0","0.0","null","2021","1","2020","4","12","31"
"2020-12-31","Bureau","Smithsonian Institution","JFK Center for the Performing Arts","0","0","0","0","0","0","0.0","0.0","null","2021","1","2020","4","12","31"
"2020-12-31","Bureau","Smithsonian Institution","National Gallery of Art","0","0","0","0","0","0","0.0","0.0","null","2021","1","2020","4","12","31"
"2020-12-31","Bureau","Smithsonian Institution","Smithsonian Institution","5670","1","0","0","5670","1","0.0","0.0","null","2021","1","2020","4","12","31"
"2020-12-31","Agency","Social Security Administration","null","5019638635","1492872","2932640041","496438","2086998594","996434","58.42332992960558","33.253889147897475","CFO","2021","1","2020","4","12","31"
"2020-12-31","Bureau","Social Security Administration","Social Security Administration","5019638635","1492872","2932640041","496438","2086998594","996434","58.42332992960558","33.253889147897475","null","2021","1","2020","4","12","31"
"2020-12-31","Agency","Tennessee Valley Authority","null","0","0","0","0","0","0","0.0","0.0","Non-CFO","2021","1","2020","4","12","31"
"2020-12-31","Bureau","Tennessee Valley Authority","Tennessee Valley Authority","0","0","0","0","0","0","0.0","0.0","null","2021","1","2020","4","12","31"
"2020-12-31","Agency","The Judiciary","null","1052246","316","985926","187","66320","129","93.69729131780971","59.177215189873415","Non-CFO","2021","1","2020","4","12","31"
"2020-12-31","Bureau","The Judiciary","Administrative Office of the U.S. Courts","1052246","316","985926","187","66320","129","93.69729131780971","59.177215189873415","null","2021","1","2020","4","12","31"
"2020-12-31","Agency","U.S. Court of Appeals / Veterans Claims","null","172","1","172","1","0","0","100.0","100.0","Non-CFO","2021","1","2020","4","12","31"
"2020-12-31","Bureau","U.S. Court of Appeals / Veterans Claims","U.S. Court of Appeals / Veterans Claims","172","1","172","1","0","0","100.0","100.0","null","2021","1","2020","4","12","31"
"2020-12-31","Agency","U.S. Postal Service","null","92799917","64244","45423368","53702","47376549","10542","48.94763860618539","83.59068551148745","Non-CFO","2021","1","2020","4","12","31"
"2020-12-31","Bureau","U.S. Postal Service","U.S. Postal Service","92799917","64244","45423368","53702","47376549","10542","48.94763860618539","83.59068551148745","null","2021","1","2020","4","12","31"
"2020-12-31","Agency","U.S. Tax Court","null","0","0","0","0","0","0","0.0","0.0","Non-CFO","2021","1","2020","4","12","31"
"2020-12-31","Bureau","U.S. Tax Court","U.S. Tax Court","0","0","0","0","0","0","0.0","0.0","null","2021","1","2020","4","12","31"
"2020-12-31","Agency","US International Development Fin. Corp.","null","0","0","0","0","0","0","0.0","0.0","Non-CFO","2021","1","2020","4","12","31"
"2020-12-31","Bureau","US International Development Fin. Corp.","US International Development Fin. Corp.","0","0","0","0","0","0","0.0","0.0","null","2021","1","2020","4","12","31"
"2020-09-30","Agency","Agency for International Development","null","35237263","60","35237193","59","70","1","99.99980134665964","98.33333333333333","CFO","2020","4","2020","3","09","30"
"2020-09-30","Bureau","Agency for International Development","Agency for International Development","35237263","60","35237193","59","70","1","99.99980134665964","98.33333333333333","null","2020","4","2020","3","09","30"
"2020-09-30","Agency","American Battle Monuments Commission","null","0","0","0","0","0","0","0.0","0.0","Non-CFO","2020","4","2020","3","09","30"
"2020-09-30","Bureau","American Battle Monuments Commission","American Battle Monuments Commission","0","0","0","0","0","0","0.0","0.0","null","2020","4","2020","3","09","30"
"2020-09-30","Agency","Armed Forces Retirement Home","null","92350","109","81154","104","11196","5","87.87655657823498","95.41284403669725","Non-CFO","2020","4","2020","3","09","30"
"2020-09-30","Bureau","Armed Forces Retirement Home","Armed Forces Retirement Home","92350","109","81154","104","11196","5","87.87655657823498","95.41284403669725","null","2020","4","2020","3","09","30"
"2020-09-30","Agency","Commodity Futures Trading Commission","null","649461611","366","649461611","366","0","0","100.0","100.0","Non-CFO","2020","4","2020","3","09","30"
"2020-09-30","Bureau","Commodity Futures Trading Commission","Commodity Futures Trading Commission","649461611","366","649461611","366","0","0","100.0","100.0","null","2020","4","2020","3","09","30"
"2020-09-30","Agency","Consumer Product Safety Commission","null","2979","2","2979","2","0","0","100.0","100.0","Non-CFO","2020","4","2020","3","09","30"
"2020-09-30","Bureau","Consumer Product Safety Commission","Consumer Product Safety Commission","2979","2","2979","2","0","0","100.0","100.0","null","2020","4","2020","3","09","30"
"2020-09-30","Agency","Corp. for National and Community Service","null","4660637","1325","3586179","152","1074458","1173","76.94611273094215","11.471698113207546","Non-CFO","2020","4","2020","3","09","30"
"2020-09-30","Bureau","Corp. for National and Community Service","Corp. for National and Community Service","4660637","1325","3586179","152","1074458","1173","76.94611273094215","11.471698113207546","null","2020","4","2020","3","09","30"
"2020-09-30","Agency","Department of Agriculture","null","1599864013","48236","1586833545","44874","13030468","3362","99.18552652637234","93.03010199850733","CFO","2020","4","2020","3","09","30"
"2020-09-30","Bureau","Department of Agriculture","Agricultural Marketing Service","5507299","1556","4702197","553","805102","1003","85.38118231822895","35.53984575835476","null","2020","4","2020","3","09","30"
"2020-09-30","Bureau","Department of Agriculture","Commodity Credit Corporation","130201388","11516","130201388","11516","0","0","100.0","100.0","null","2020","4","2020","3","09","30"
"2020-09-30","Bureau","Department of Agriculture","Farm Service Agency","652259180","12290","652259180","12290","0","0","100.0","100.0","null","2020","4","2020","3","09","30"
"2020-09-30","Bureau","Department of Agriculture","Federal Crop Insurance Corporation","33139","446","28825","445","4314","1","86.98210567609162","99.77578475336323","null","2020","4","2020","3","09","30"
"2020-09-30","Bureau","Department of Agriculture","Food Safety and Inspection Service","729314","775","726896","770","2418","5","99.66845556235037","99.35483870967742","null","2020","4","2020","3","09","30"
"2020-09-30","Bureau","Department of Agriculture","Food and Nutrition Service","408824","42","50472","6","358352","36","12.34565485392247","14.285714285714286","null","2020","4","2020","3","09","30"
"2020-09-30","Bureau","Department of Agriculture","Forest Service","68317962","1589","61072475","308","7245487","1281","89.39446261584911","19.383259911894275","null","2020","4","2020","3","09","30"
"2020-09-30","Bureau","Department of Agriculture","Rural Development","709887621","17290","709877196","17282","10425","8","99.99853145769956","99.95373048004627","null","2020","4","2020","3","09","30"
"2020-09-30","Bureau","Department of Agriculture","U.S. Department of Agriculture","32519286","2732","27914916","1704","4604370","1028","85.84110979558407","62.37188872620791","null","2020","4","2020","3","09","30"
"2020-09-30","Agency","Department of Commerce","null","22926999","1792","22926999","1792","0","0","100.0","100.0","CFO","2020","4","2020","3","09","30"
"2020-09-30","Bureau","Department of Commerce","Bureau of Industry and Security","1729075","23","1729075","23","0","0","100.0","100.0","null","2020","4","2020","3","09","30"
"2020-09-30","Bureau","Department of Commerce","Bureau of the Census","254493","396","254493","396","0","0","100.0","100.0","null","2020","4","2020","3","09","30"
"2020-09-30","Bureau","Department of Commerce","Economic Development Administration","5088380","9","5088380","9","0","0","100.0","100.0","null","2020","4","2020","3","09","30"
"2020-09-30","Bureau","Department of Commerce","Economic and Statistical Analysis","0","0","0","0","0","0","0.0","0.0","null","2020","4","2020","3","09","30"
"2020-09-30","Bureau","Department of Commerce","General Administration","4660","1","4660","1","0","0","100.0","100.0","null","2020","4","2020","3","09","30"
"2020-09-30","Bureau","Department of Commerce","International Trade Administration","2738","1","2738","1","0","0","100.0","100.0","null","2020","4","2020","3","09","30"
"2020-09-30","Bureau","Department of Commerce","Minority Business Development Agency","0","0","0","0","0","0","0.0","0.0","null","2020","4","2020","3","09","30"
"2020-09-30","Bureau","Department of Commerce","NOAA","14511695","828","14511695","828","0","0","100.0","100.0","null","2020","4","2020","3","09","30"
"2020-09-30","Bureau","Department of Commerce","Nat'l Institute of Standards& Technology","680558","6","680558","6","0","0","100.0","100.0","null","2020","4","2020","3","09","30"
"2020-09-30","Bureau","Department of Commerce","Nat'l Telecomm & Information Admin.","296093","1","296093","1","0","0","100.0","100.0","null","2020","4","2020","3","09","30"
"2020-09-30","Bureau","Department of Commerce","National Technical Information Service","0","0","0","0","0","0","0.0","0.0","null","2020","4","2020","3","09","30"
"2020-09-30","Bureau","Department of Commerce","Office of the Inspector General","0","0","0","0","0","0","0.0","0.0","null","2020","4","2020","3","09","30"
"2020-09-30","Bureau","Department of Commerce","Patent and Trademark Office","359307","527","359307","527","0","0","100.0","100.0","null","2020","4","2020","3","09","30"
"2020-09-30","Agency","Department of Defense","null","2322857447","1313767","1100836267","286775","1222021180","1026992","47.39146900390913","21.828452077118698","CFO","2020","4","2020","3","09","30"
"2020-09-30","Bureau","Department of Defense","Consolidated Report","2322857447","1313767","1100836267","286775","1222021180","1026992","47.39146900390913","21.828452077118698","null","2020","4","2020","3","09","30"
"2020-09-30","Agency","Department of Education","null","160466449801","27110432","138705006144","24312637","21761443657","2797795","86.43863331930935","89.68000583686752","CFO","2020","4","2020","3","09","30"
"2020-09-30","Bureau","Department of Education","Departmental Management","876381793","2083","795068713","1781","81313080","302","90.72172874317118","85.50168026884302","null","2020","4","2020","3","09","30"
"2020-09-30","Bureau","Department of Education","Federal Student Aid","159590068008","27108349","137909937431","24310856","21680130577","2797493","86.41511289041294","89.6803268985507","null","2020","4","2020","3","09","30"
"2020-09-30","Bureau","Department of Education","Office of Postsecondary Education","0","0","0","0","0","0","0.0","0.0","null","2020","4","2020","3","09","30"
"2020-09-30","Agency","Department of Energy","null","14503961","93","13881555","92","622406","1","95.70871708769764","98.9247311827957","CFO","2020","4","2020","3","09","30"
"2020-09-30","Bureau","Department of Energy","Bonneville Power Administration","1685189","32","1062783","31","622406","1","63.06610119102368","96.875","null","2020","4","2020","3","09","30"
"2020-09-30","Bureau","Department of Energy","Energy Consolidated Reports","12818772","61","12818772","61","0","0","100.0","100.0","null","2020","4","2020","3","09","30"
"2020-09-30","Agency","Department of Health & Human Services","null","10054470277","1218327","9876666333","1199389","177803944","18938","98.2315931212534","98.4455733148818","CFO","2020","4","2020","3","09","30"
"2020-09-30","Bureau","Department of Health & Human Services","Administration for Children and Families","29299815","1810","29299815","1810","0","0","100.0","100.0","null","2020","4","2020","3","09","30"
"2020-09-30","Bureau","Department of Health & Human Services","Administration for Community Living","0","0","0","0","0","0","0.0","0.0","null","2020","4","2020","3","09","30"
"2020-09-30","Bureau","Department of Health & Human Services","Centers for Disease Control","7083389","149","145684","16","6937705","133","2.0566991308821243","10.738255033557047","null","2020","4","2020","3","09","30"
"2020-09-30","Bureau","Department of Health & Human Services","Centers for Medicare & Medicaid Services","9819688406","1204778","9679333804","1195152","140354602","9626","98.57068171415459","99.20101462676111","null","2020","4","2020","3","09","30"
"2020-09-30","Bureau","Department of Health & Human Services","Food and Drug Administration","47399174","7129","34246300","1135","13152874","5994","72.2508371137438","15.920886519848507","null","2020","4","2020","3","09","30"
"2020-09-30","Bureau","Department of Health & Human Services","Health Resources and Services Admin","92242393","558","92242393","558","0","0","100.0","100.0","null","2020","4","2020","3","09","30"
"2020-09-30","Bureau","Department of Health & Human Services","Indian Health Services","36112976","3003","28439982","195","7672994","2808","78.75280619354108","6.4935064935064934","null","2020","4","2020","3","09","30"
"2020-09-30","Bureau","Department of Health & Human Services","National Institutes of Health","15251116","468","5565347","91","9685769","377","36.491408235305535","19.444444444444443","null","2020","4","2020","3","09","30"
"2020-09-30","Bureau","Department of Health & Human Services","Office of the Inspector General","0","0","0","0","0","0","0.0","0.0","null","2020","4","2020","3","09","30"
"2020-09-30","Bureau","Department of Health & Human Services","Office of the Secretary","8136","7","8136","7","0","0","100.0","100.0","null","2020","4","2020","3","09","30"
"2020-09-30","Bureau","Department of Health & Human Services","Program Support Center","6437306","412","6437306","412","0","0","100.0","100.0","null","2020","4","2020","3","09","30"
"2020-09-30","Bureau","Department of Health & Human Services","Substance Abuse & Mental Health Admin.","947566","13","947566","13","0","0","100.0","100.0","null","2020","4","2020","3","09","30"
"2020-09-30","Agency","Department of Homeland Security","null","375252521","63212","375251875","63208","646","4","99.99982784925781","99.9936720875783","CFO","2020","4","2020","3","09","30"
"2020-09-30","Bureau","Department of Homeland Security","Bureau of Customs & Border Protection","8916105","598","8916105","598","0","0","100.0","100.0","null","2020","4","2020","3","09","30"
"2020-09-30","Bureau","Department of Homeland Security","Citizenship and Immigration Services","1014493","1241","1014493","1241","0","0","100.0","100.0","null","2020","4","2020","3","09","30"
"2020-09-30","Bureau","Department of Homeland Security","Domestic Nuclear Detection Office","646","4","0","0","646","4","0.0","0.0","null","2020","4","2020","3","09","30"
"2020-09-30","Bureau","Department of Homeland Security","Emergency Preparedness & Resp","258752739","43019","258752739","43019","0","0","100.0","100.0","null","2020","4","2020","3","09","30"
"2020-09-30","Bureau","Department of Homeland Security","Federal Law Enforcement Training Ctr.","0","0","0","0","0","0","0.0","0.0","null","2020","4","2020","3","09","30"
"2020-09-30","Bureau","Department of Homeland Security","Immigration and Customs Enforcement","12989555","478","12989555","478","0","0","100.0","100.0","null","2020","4","2020","3","09","30"
"2020-09-30","Bureau","Department of Homeland Security","Info Analysis Infrastructure Prot-NPPD","0","0","0","0","0","0","0.0","0.0","null","2020","4","2020","3","09","30"
"2020-09-30","Bureau","Department of Homeland Security","Management Headquarters","0","0","0","0","0","0","0.0","0.0","null","2020","4","2020","3","09","30"
"2020-09-30","Bureau","Department of Homeland Security","Office of Biometric Identity Management","0","0","0","0","0","0","0.0","0.0","null","2020","4","2020","3","09","30"
"2020-09-30","Bureau","Department of Homeland Security","Office of Health Affairs","0","0","0","0","0","0","0.0","0.0","null","2020","4","2020","3","09","30"
"2020-09-30","Bureau","Department of Homeland Security","Office of the Inspector General DHS","100","1","100","1","0","0","100.0","100.0","null","2020","4","2020","3","09","30"
"2020-09-30","Bureau","Department of Homeland Security","Science and Technology","0","0","0","0","0","0","0.0","0.0","null","2020","4","2020","3","09","30"
"2020-09-30","Bureau","Department of Homeland Security","Transportation Safety Administration","9222684","5366","9222684","5366","0","0","100.0","100.0","null","2020","4","2020","3","09","30"
"2020-09-30","Bureau","Department of Homeland Security","U.S. Coast Guard","84356199","12505","84356199","12505","0","0","100.0","100.0","null","2020","4","2020","3","09","30"
"2020-09-30","Bureau","Department of Homeland Security","U.S. Secret Service","0","0","0","0","0","0","0.0","0.0","null","2020","4","2020","3","09","30"
"2020-09-30","Agency","Department of Housing and Urban Development","null","182795669","6548","181795610","6541","1000059","7","99.45290881043796","99.89309712889433","CFO","2020","4","2020","3","09","30"
"2020-09-30","Bureau","Department of Housing and Urban Development","Community Planning and Development","0","0","0","0","0","0","0.0","0.0","null","2020","4","2020","3","09","30"
"2020-09-30","Bureau","Department of Housing and Urban Development","Government National Mortgage Association","0","0","0","0","0","0","0.0","0.0","null","2020","4","2020","3","09","30"
"2020-09-30","Bureau","Department of Housing and Urban Development","Housing Programs","179033261","6532","179033261","6532","0","0","100.0","100.0","null","2020","4","2020","3","09","30"
"2020-09-30","Bureau","Department of Housing and Urban Development","Management and Administration","1230252","10","1014394","7","215858","3","82.45416386236316","70.0","null","2020","4","2020","3","09","30"
"2020-09-30","Bureau","Department of Housing and Urban Development","Policy, Development and Research","0","0","0","0","0","0","0.0","0.0","null","2020","4","2020","3","09","30"
"2020-09-30","Bureau","Department of Housing and Urban Development","Public and Indian Housing Programs","2532156","6","1747955","2","784201","4","69.03030460998454","33.333333333333336","null","2020","4","2020","3","09","30"
"2020-09-30","Agency","Department of Justice","null","91675427","37724","86941727","37362","4733700","362","94.836457102076","99.04039868518714","CFO","2020","4","2020","3","09","30"
"2020-09-30","Bureau","Department of Justice","Bureau of ATF and Explosives","20422","4","20422","4","0","0","100.0","100.0","null","2020","4","2020","3","09","30"
"2020-09-30","Bureau","Department of Justice","Drug Enforcement Administration","310341","22","310341","22","0","0","100.0","100.0","null","2020","4","2020","3","09","30"
"2020-09-30","Bureau","Department of Justice","Federal Bureau of Investigation","257351","65","257351","65","0","0","100.0","100.0","null","2020","4","2020","3","09","30"
"2020-09-30","Bureau","Department of Justice","Federal Prison Industries","1043089","183","1043089","183","0","0","100.0","100.0","null","2020","4","2020","3","09","30"
"2020-09-30","Bureau","Department of Justice","Federal Prison System","891743","127","891743","127","0","0","100.0","100.0","null","2020","4","2020","3","09","30"
"2020-09-30","Bureau","Department of Justice","General Administration","0","0","0","0","0","0","0.0","0.0","null","2020","4","2020","3","09","30"
"2020-09-30","Bureau","Department of Justice","Legal Activities","89077157","37291","84349153","36933","4728004","358","94.69223742737995","99.03998283768202","null","2020","4","2020","3","09","30"
"2020-09-30","Bureau","Department of Justice","Office of Justice Assistance Programs","69628","28","69628","28","0","0","100.0","100.0","null","2020","4","2020","3","09","30"
"2020-09-30","Bureau","Department of Justice","U.S. Marshals Service","5696","4","0","0","5696","4","0.0","0.0","null","2020","4","2020","3","09","30"
"2020-09-30","Agency","Department of Labor","null","207834655","53985","185335683","44944","22498972","9041","89.17458111112413","83.25275539501713","CFO","2020","4","2020","3","09","30"
"2020-09-30","Bureau","Department of Labor","Bureau of Labor Statistics","10534","1","10534","1","0","0","100.0","100.0","null","2020","4","2020","3","09","30"
"2020-09-30","Bureau","Department of Labor","Departmental Management","0","0","0","0","0","0","0.0","0.0","null","2020","4","2020","3","09","30"
"2020-09-30","Bureau","Department of Labor","Employee Benefit Security Administration","17405488","389","17405488","389","0","0","100.0","100.0","null","2020","4","2020","3","09","30"
"2020-09-30","Bureau","Department of Labor","Employment Standards Administration","95599933","32976","80695975","25463","14903958","7513","84.41007484806501","77.21676370693838","null","2020","4","2020","3","09","30"
"2020-09-30","Bureau","Department of Labor","Employment and Training Administration","3380915","11","3380915","11","0","0","100.0","100.0","null","2020","4","2020","3","09","30"
"2020-09-30","Bureau","Department of Labor","Mine Safety and Health Administration","33686990","16109","31967462","14877","1719528","1232","94.89557244502997","92.3521013098268","null","2020","4","2020","3","09","30"
"2020-09-30","Bureau","Department of Labor","Occupational Safety and Health Admin","57750795","4499","51875309","4203","5875486","296","89.8261383241564","93.42076016892644","null","2020","4","2020","3","09","30"
"2020-09-30","Agency","Department of State","null","17827421","22879","16700693","22229","1126728","650","93.67980371361624","97.15896673805673","CFO","2020","4","2020","3","09","30"
"2020-09-30","Bureau","Department of State","Civil Monetary Penalties","0","0","0","0","0","0","0.0","0.0","null","2020","4","2020","3","09","30"
"2020-09-30","Bureau","Department of State","Department of State","15387741","7197","14261013","6547","1126728","650","92.6777556237787","90.9684590801723","null","2020","4","2020","3","09","30"
"2020-09-30","Bureau","Department of State","International Commissions","0","0","0","0","0","0","0.0","0.0","null","2020","4","2020","3","09","30"
"2020-09-30","Bureau","Department of State","Passport NSF","2439680","15682","2439680","15682","0","0","100.0","100.0","null","2020","4","2020","3","09","30"
"2020-09-30","Agency","Department of Transportation","null","65875201","7554","65099935","7502","775266","52","98.82312920760576","99.311622981202","CFO","2020","4","2020","3","09","30"
"2020-09-30","Bureau","Department of Transportation","Federal Aviation Administration","2837371","340","2066665","289","770706","51","72.8373201812523","85.0","null","2020","4","2020","3","09","30"
"2020-09-30","Bureau","Department of Transportation","Federal Highway Administration","119035","6","119035","6","0","0","100.0","100.0","null","2020","4","2020","3","09","30"
"2020-09-30","Bureau","Department of Transportation","Federal Motor Carrier Safety Admin","60557990","7139","60557990","7139","0","0","100.0","100.0","null","2020","4","2020","3","09","30"
"2020-09-30","Bureau","Department of Transportation","Federal Railroad Administration","125997","12","125997","12","0","0","100.0","100.0","null","2020","4","2020","3","09","30"
"2020-09-30","Bureau","Department of Transportation","Federal Transit Administration","784555","2","784555","2","0","0","100.0","100.0","null","2020","4","2020","3","09","30"
"2020-09-30","Bureau","Department of Transportation","Maritime Administration","5175","6","5175","6","0","0","100.0","100.0","null","2020","4","2020","3","09","30"
"2020-09-30","Bureau","Department of Transportation","National Highway Traffic Safety Admin.","19498","4","19498","4","0","0","100.0","100.0","null","2020","4","2020","3","09","30"
"2020-09-30","Bureau","Department of Transportation","Office of the Inspector General","210","1","210","1","0","0","100.0","100.0","null","2020","4","2020","3","09","30"
"2020-09-30","Bureau","Department of Transportation","Office of the Secretary","1032686","16","1032686","16","0","0","100.0","100.0","null","2020","4","2020","3","09","30"
"2020-09-30","Bureau","Department of Transportation","Pipeline Hazardous Material Safety Admin","382191","24","382191","24","0","0","100.0","100.0","null","2020","4","2020","3","09","30"
"2020-09-30","Bureau","Department of Transportation","Research Innovative Technology Admin","1590","2","1590","2","0","0","100.0","100.0","null","2020","4","2020","3","09","30"
"2020-09-30","Bureau","Department of Transportation","St. Lawrence Seaway Development Corp.","8903","2","4343","1","4560","1","48.78130967089745","50.0","null","2020","4","2020","3","09","30"
"2020-09-30","Bureau","Department of Transportation","Surface Transportation Board","0","0","0","0","0","0","0.0","0.0","null","2020","4","2020","3","09","30"
"2020-09-30","Agency","Department of Veterans Affairs","null","128486713","65755","6532657","8631","121954056","57124","5.084305487681049","13.125998022964033","CFO","2020","4","2020","3","09","30"
"2020-09-30","Bureau","Department of Veterans Affairs","Administration and Cemeteries","1240363","685","3351","5","1237012","680","0.2701628474890012","0.7299270072992701","null","2020","4","2020","3","09","30"
"2020-09-30","Bureau","Department of Veterans Affairs","Housing Credit Assistance","943885","21","0","0","943885","21","0.0","0.0","null","2020","4","2020","3","09","30"
"2020-09-30","Bureau","Department of Veterans Affairs","Life Insurance","711165","132","711165","132","0","0","100.0","100.0","null","2020","4","2020","3","09","30"
"2020-09-30","Bureau","Department of Veterans Affairs","Medical and Construction","105191659","41846","5818141","8494","99373518","33352","5.530990817437341","20.298236390574964","null","2020","4","2020","3","09","30"
"2020-09-30","Bureau","Department of Veterans Affairs","Veterans Benefits","20399641","23071","0","0","20399641","23071","0.0","0.0","null","2020","4","2020","3","09","30"
"2020-09-30","Agency","Department of the Interior","null","72780456","33095","72779362","33077","1094","18","99.99849684920908","99.94561111950446","CFO","2020","4","2020","3","09","30"
"2020-09-30","Bureau","Department of the Interior","Bureau of Indian Affairs","33742252","29728","33741158","29710","1094","18","99.99675777419954","99.93945102260496","null","2020","4","2020","3","09","30"
"2020-09-30","Bureau","Department of the Interior","Bureau of Land Management","15893273","334","15893273","334","0","0","100.0","100.0","null","2020","4","2020","3","09","30"
"2020-09-30","Bureau","Department of the Interior","Bureau of Ocean Energy Mgmt., Reg & Enf","0","0","0","0","0","0","0.0","0.0","null","2020","4","2020","3","09","30"
"2020-09-30","Bureau","Department of the Interior","Bureau of Reclamation","86894","73","86894","73","0","0","100.0","100.0","null","2020","4","2020","3","09","30"
"2020-09-30","Bureau","Department of the Interior","Bureau of Safety and Environmental Enf.","0","0","0","0","0","0","0.0","0.0","null","2020","4","2020","3","09","30"
"2020-09-30","Bureau","Department of the Interior","Fish and Wildlife Service","699673","79","699673","79","0","0","100.0","100.0","null","2020","4","2020","3","09","30"
"2020-09-30","Bureau","Department of the Interior","Geological Survey","150791","134","150791","134","0","0","100.0","100.0","null","2020","4","2020","3","09","30"
"2020-09-30","Bureau","Department of the Interior","National Park Service","7734264","1926","7734264","1926","0","0","100.0","100.0","null","2020","4","2020","3","09","30"
"2020-09-30","Bureau","Department of the Interior","Office of Natural Resources Revenue","11371983","483","11371983","483","0","0","100.0","100.0","null","2020","4","2020","3","09","30"
"2020-09-30","Bureau","Department of the Interior","Office of Surface Mining","3054375","318","3054375","318","0","0","100.0","100.0","null","2020","4","2020","3","09","30"
"2020-09-30","Bureau","Department of the Interior","Office of the Secretary","46951","20","46951","20","0","0","100.0","100.0","null","2020","4","2020","3","09","30"
"2020-09-30","Agency","Department of the Treasury","null","45578512","5856","45033673","5820","544839","36","98.80461433229765","99.38524590163935","CFO","2020","4","2020","3","09","30"
"2020-09-30","Bureau","Department of the Treasury","Bureau of Engraving and Printing","84528","1","84528","1","0","0","100.0","100.0","null","2020","4","2020","3","09","30"
"2020-09-30","Bureau","Department of the Treasury","Bureau of the Fiscal Service","13668622","4249","13668622","4249","0","0","100.0","100.0","null","2020","4","2020","3","09","30"
"2020-09-30","Bureau","Department of the Treasury","Community Dev Financial Inst Fund","4522449","8","4522449","8","0","0","100.0","100.0","null","2020","4","2020","3","09","30"
"2020-09-30","Bureau","Department of the Treasury","Comptroller of the Currency","1108994","33","1104813","21","4181","12","99.62299164828664","63.63636363636363","null","2020","4","2020","3","09","30"
"2020-09-30","Bureau","Department of the Treasury","D.C. Pension Program","447735","24","447735","24","0","0","100.0","100.0","null","2020","4","2020","3","09","30"
"2020-09-30","Bureau","Department of the Treasury","Departmental Offices","23887698","1378","23347040","1354","540658","24","97.73666763536612","98.25834542815674","null","2020","4","2020","3","09","30"
"2020-09-30","Bureau","Department of the Treasury","Financial Crimes Enforcement Network","1544945","3","1544945","3","0","0","100.0","100.0","null","2020","4","2020","3","09","30"
"2020-09-30","Bureau","Department of the Treasury","Interest on Tax/Deposit of Earnings","0","0","0","0","0","0","0.0","0.0","null","2020","4","2020","3","09","30"
"2020-09-30","Bureau","Department of the Treasury","Internal Revenue Service","262038","132","262038","132","0","0","100.0","100.0","null","2020","4","2020","3","09","30"
"2020-09-30","Bureau","Department of the Treasury","International Monetary Funds","0","0","0","0","0","0","0.0","0.0","null","2020","4","2020","3","09","30"
"2020-09-30","Bureau","Department of the Treasury","Office of Financial Research","0","0","0","0","0","0","0.0","0.0","null","2020","4","2020","3","09","30"
"2020-09-30","Bureau","Department of the Treasury","Office of Sec International Affairs","0","0","0","0","0","0","0.0","0.0","null","2020","4","2020","3","09","30"
"2020-09-30","Bureau","Department of the Treasury","Office of the Secretary","0","0","0","0","0","0","0.0","0.0","null","2020","4","2020","3","09","30"
"2020-09-30","Bureau","Department of the Treasury","Pandemic Receivables","0","0","0","0","0","0","0.0","0.0","null","2020","4","2020","3","09","30"
"2020-09-30","Bureau","Department of the Treasury","Spec Insp Gen-Troubled Asset Rel Prog","3916","1","3916","1","0","0","100.0","100.0","null","2020","4","2020","3","09","30"
"2020-09-30","Bureau","Department of the Treasury","Tobacco Tax and Trade","1000","1","1000","1","0","0","100.0","100.0","null","2020","4","2020","3","09","30"
"2020-09-30","Bureau","Department of the Treasury","Treasury Forfeiture Fund","0","0","0","0","0","0","0.0","0.0","null","2020","4","2020","3","09","30"
"2020-09-30","Bureau","Department of the Treasury","Treasury Franchise Fund","66","1","66","1","0","0","100.0","100.0","null","2020","4","2020","3","09","30"
"2020-09-30","Bureau","Department of the Treasury","Treasury IG for Tax Admin","0","0","0","0","0","0","0.0","0.0","null","2020","4","2020","3","09","30"
"2020-09-30","Bureau","Department of the Treasury","U.S. Mint","46521","25","46521","25","0","0","100.0","100.0","null","2020","4","2020","3","09","30"
"2020-09-30","Bureau","Department of the Treasury","U.S. Treasury IG Office","0","0","0","0","0","0","0.0","0.0","null","2020","4","2020","3","09","30"
"2020-09-30","Agency","Environmental Protection Agency","null","24037442","230","24037442","230","0","0","100.0","100.0","CFO","2020","4","2020","3","09","30"
"2020-09-30","Bureau","Environmental Protection Agency","Environmental Protection Agency","24037442","230","24037442","230","0","0","100.0","100.0","null","2020","4","2020","3","09","30"
"2020-09-30","Agency","Equal Employment Opportunity Commission","null","35245","20","35245","20","0","0","100.0","100.0","Non-CFO","2020","4","2020","3","09","30"
"2020-09-30","Bureau","Equal Employment Opportunity Commission","Equal Employment Opportunity Commission","35245","20","35245","20","0","0","100.0","100.0","null","2020","4","2020","3","09","30"
"2020-09-30","Agency","Export - Import  Bank","null","0","0","0","0","0","0","0.0","0.0","Non-CFO","2020","4","2020","3","09","30"
"2020-09-30","Bureau","Export - Import  Bank","Export-Import Bank","0","0","0","0","0","0","0.0","0.0","null","2020","4","2020","3","09","30"
"2020-09-30","Agency","Farm Credit Administration","null","630","1","630","1","0","0","100.0","100.0","Non-CFO","2020","4","2020","3","09","30"
"2020-09-30","Bureau","Farm Credit Administration","Farm Credit Administration","630","1","630","1","0","0","100.0","100.0","null","2020","4","2020","3","09","30"
"2020-09-30","Bureau","Farm Credit Administration","Farm Credit System Insurance Corporation","0","0","0","0","0","0","0.0","0.0","null","2020","4","2020","3","09","30"
"2020-09-30","Agency","Federal Communications Commission","null","182392877","7629","182392877","7629","0","0","100.0","100.0","Non-CFO","2020","4","2020","3","09","30"
"2020-09-30","Bureau","Federal Communications Commission","Federal Communications Commission","182392877","7629","182392877","7629","0","0","100.0","100.0","null","2020","4","2020","3","09","30"
"2020-09-30","Agency","Federal Deposit Insurance Corporation","null","0","0","0","0","0","0","0.0","0.0","Non-CFO","2020","4","2020","3","09","30"
"2020-09-30","Bureau","Federal Deposit Insurance Corporation","Federal Deposit Insurance Corporation","0","0","0","0","0","0","0.0","0.0","null","2020","4","2020","3","09","30"
"2020-09-30","Agency","Federal Election Commission","null","574671","105","574671","105","0","0","100.0","100.0","Non-CFO","2020","4","2020","3","09","30"
"2020-09-30","Bureau","Federal Election Commission","Federal Election Commission","574671","105","574671","105","0","0","100.0","100.0","null","2020","4","2020","3","09","30"
"2020-09-30","Agency","Federal Labor Relations Authority","null","0","0","0","0","0","0","0.0","0.0","Non-CFO","2020","4","2020","3","09","30"
"2020-09-30","Bureau","Federal Labor Relations Authority","Federal Labor Relations Authority","0","0","0","0","0","0","0.0","0.0","null","2020","4","2020","3","09","30"
"2020-09-30","Agency","Federal Maritime Commission","null","475933","7","475933","7","0","0","100.0","100.0","Non-CFO","2020","4","2020","3","09","30"
"2020-09-30","Bureau","Federal Maritime Commission","Salaries and Expenses","475933","7","475933","7","0","0","100.0","100.0","null","2020","4","2020","3","09","30"
"2020-09-30","Agency","Federal Mediation/Conciliation Service","null","0","0","0","0","0","0","0.0","0.0","Non-CFO","2020","4","2020","3","09","30"
"2020-09-30","Bureau","Federal Mediation/Conciliation Service","Federal Mediation/Conciliation Service","0","0","0","0","0","0","0.0","0.0","null","2020","4","2020","3","09","30"
"2020-09-30","Agency","Federal Trade Commission","null","483063621","56","483063621","56","0","0","100.0","100.0","Non-CFO","2020","4","2020","3","09","30"
"2020-09-30","Bureau","Federal Trade Commission","Federal Trade Commission","483063621","56","483063621","56","0","0","100.0","100.0","null","2020","4","2020","3","09","30"
"2020-09-30","Agency","Funds Appropriated to the President","null","791105","4","0","0","791105","4","0.0","0.0","Non-CFO","2020","4","2020","3","09","30"
"2020-09-30","Bureau","Funds Appropriated to the President","African Development Foundation","0","0","0","0","0","0","0.0","0.0","null","2020","4","2020","3","09","30"
"2020-09-30","Bureau","Funds Appropriated to the President","Defense Security Assistance Agency","0","0","0","0","0","0","0.0","0.0","null","2020","4","2020","3","09","30"
"2020-09-30","Bureau","Funds Appropriated to the President","Executive Branch","0","0","0","0","0","0","0.0","0.0","null","2020","4","2020","3","09","30"
"2020-09-30","Bureau","Funds Appropriated to the President","Inter-American Foundation","0","0","0","0","0","0","0.0","0.0","null","2020","4","2020","3","09","30"
"2020-09-30","Bureau","Funds Appropriated to the President","Peace Corps","0","0","0","0","0","0","0.0","0.0","null","2020","4","2020","3","09","30"
"2020-09-30","Bureau","Funds Appropriated to the President","Trade and Development Agency","791105","4","0","0","791105","4","0.0","0.0","null","2020","4","2020","3","09","30"
"2020-09-30","Agency","General Services Administration","null","7328106","1611","6281400","1145","1046706","466","85.7165548642446","71.07386716325264","CFO","2020","4","2020","3","09","30"
"2020-09-30","Bureau","General Services Administration","General Services Administration","7328106","1611","6281400","1145","1046706","466","85.7165548642446","71.07386716325264","null","2020","4","2020","3","09","30"
"2020-09-30","Agency","Legis Branch-Library of Congress","null","101139","18","0","0","101139","18","0.0","0.0","Non-CFO","2020","4","2020","3","09","30"
"2020-09-30","Bureau","Legis Branch-Library of Congress","Library of Congress","101139","18","0","0","101139","18","0.0","0.0","null","2020","4","2020","3","09","30"
"2020-09-30","Agency","Legislative Branch - U.S. House/Senate","null","225416","177","65733","45","159683","132","29.1607516768996","25.423728813559322","Non-CFO","2020","4","2020","3","09","30"
"2020-09-30","Bureau","Legislative Branch - U.S. House/Senate","U.S. House of Representatives","225416","177","65733","45","159683","132","29.1607516768996","25.423728813559322","null","2020","4","2020","3","09","30"
"2020-09-30","Agency","Legislative Branch-CBO","null","0","0","0","0","0","0","0.0","0.0","Non-CFO","2020","4","2020","3","09","30"
"2020-09-30","Bureau","Legislative Branch-CBO","Congressional Budget Office","0","0","0","0","0","0","0.0","0.0","null","2020","4","2020","3","09","30"
"2020-09-30","Agency","Legislative Branch-GAO","null","28039","13","28039","13","0","0","100.0","100.0","Non-CFO","2020","4","2020","3","09","30"
"2020-09-30","Bureau","Legislative Branch-GAO","Government Accountability Office","28039","13","28039","13","0","0","100.0","100.0","null","2020","4","2020","3","09","30"
"2020-09-30","Agency","Legislative Branch-GPO","null","132743","16","0","0","132743","16","0.0","0.0","Non-CFO","2020","4","2020","3","09","30"
"2020-09-30","Bureau","Legislative Branch-GPO","Government Publishing Office","132743","16","0","0","132743","16","0.0","0.0","null","2020","4","2020","3","09","30"
"2020-09-30","Agency","Legislative Branch-Office of Tech.","null","0","0","0","0","0","0","0.0","0.0","Non-CFO","2020","4","2020","3","09","30"
"2020-09-30","Bureau","Legislative Branch-Office of Tech.","Medicaid & CHIP Payment & Access Comm.","0","0","0","0","0","0","0.0","0.0","null","2020","4","2020","3","09","30"
"2020-09-30","Bureau","Legislative Branch-Office of Tech.","Open World Leadership","0","0","0","0","0","0","0.0","0.0","null","2020","4","2020","3","09","30"
"2020-09-30","Agency","Merit Systems Protection Board","null","144","1","144","1","0","0","100.0","100.0","Non-CFO","2020","4","2020","3","09","30"
"2020-09-30","Bureau","Merit Systems Protection Board","Merit Systems Protection Board","144","1","144","1","0","0","100.0","100.0","null","2020","4","2020","3","09","30"
"2020-09-30","Agency","National Aeronautics and Space Administration","null","1267015","136","1267015","136","0","0","100.0","100.0","CFO","2020","4","2020","3","09","30"
"2020-09-30","Bureau","National Aeronautics and Space Administration","National Aeronautics and Space Admin","1267015","136","1267015","136","0","0","100.0","100.0","null","2020","4","2020","3","09","30"
"2020-09-30","Agency","National Archives & Records Admin","null","168210","108","117978","102","50232","6","70.13732833957553","94.44444444444444","Non-CFO","2020","4","2020","3","09","30"
"2020-09-30","Bureau","National Archives & Records Admin","Nat'l Archives & Records Administration","168210","108","117978","102","50232","6","70.13732833957553","94.44444444444444","null","2020","4","2020","3","09","30"
"2020-09-30","Agency","National Credit Union Administration","null","0","0","0","0","0","0","0.0","0.0","Non-CFO","2020","4","2020","3","09","30"
"2020-09-30","Bureau","National Credit Union Administration","National Credit Union Administration","0","0","0","0","0","0","0.0","0.0","null","2020","4","2020","3","09","30"
"2020-09-30","Agency","National Foundation  Arts & Humanities","null","0","0","0","0","0","0","0.0","0.0","Non-CFO","2020","4","2020","3","09","30"
"2020-09-30","Bureau","National Foundation  Arts & Humanities","National Endowment for the Arts","0","0","0","0","0","0","0.0","0.0","null","2020","4","2020","3","09","30"
"2020-09-30","Bureau","National Foundation  Arts & Humanities","National Endowment for the Humanities","0","0","0","0","0","0","0.0","0.0","null","2020","4","2020","3","09","30"
"2020-09-30","Agency","National Labor Relations Board","null","0","0","0","0","0","0","0.0","0.0","Non-CFO","2020","4","2020","3","09","30"
"2020-09-30","Bureau","National Labor Relations Board","National Labor Relations Board","0","0","0","0","0","0","0.0","0.0","null","2020","4","2020","3","09","30"
"2020-09-30","Agency","National Science Foundation","null","527693","84","527693","84","0","0","100.0","100.0","CFO","2020","4","2020","3","09","30"
"2020-09-30","Bureau","National Science Foundation","National Science Foundation","527693","84","527693","84","0","0","100.0","100.0","null","2020","4","2020","3","09","30"
"2020-09-30","Agency","Neighborhood Reinvestment Corporation","null","0","0","0","0","0","0","0.0","0.0","Non-CFO","2020","4","2020","3","09","30"
"2020-09-30","Bureau","Neighborhood Reinvestment Corporation","Neighborhood Reinvestment Corporation","0","0","0","0","0","0","0.0","0.0","null","2020","4","2020","3","09","30"
"2020-09-30","Agency","Nuclear Regulatory Commission","null","1978167","275","1963625","271","14542","4","99.2648750080251","98.54545454545455","CFO","2020","4","2020","3","09","30"
"2020-09-30","Bureau","Nuclear Regulatory Commission","Nuclear Regulatory Commission","1978167","275","1963625","271","14542","4","99.2648750080251","98.54545454545455","null","2020","4","2020","3","09","30"
"2020-09-30","Agency","Occupational Safety & Health Rev Comm","null","0","0","0","0","0","0","0.0","0.0","Non-CFO","2020","4","2020","3","09","30"
"2020-09-30","Bureau","Occupational Safety & Health Rev Comm","Occupational Safety & Health Rev Comm","0","0","0","0","0","0","0.0","0.0","null","2020","4","2020","3","09","30"
"2020-09-30","Agency","Office of Compliance","null","0","0","0","0","0","0","0.0","0.0","Non-CFO","2020","4","2020","3","09","30"
"2020-09-30","Bureau","Office of Compliance","Office of Compliance","0","0","0","0","0","0","0.0","0.0","null","2020","4","2020","3","09","30"
"2020-09-30","Agency","Office of Government Ethics","null","0","0","0","0","0","0","0.0","0.0","Non-CFO","2020","4","2020","3","09","30"
"2020-09-30","Bureau","Office of Government Ethics","Office of Government Ethics","0","0","0","0","0","0","0.0","0.0","null","2020","4","2020","3","09","30"
"2020-09-30","Agency","Office of Personnel Management","null","24989314","1651","22563437","1365","2425877","286","90.29234255890337","82.67716535433071","CFO","2020","4","2020","3","09","30"
"2020-09-30","Bureau","Office of Personnel Management","Office of Personnel Management","24989314","1651","22563437","1365","2425877","286","90.29234255890337","82.67716535433071","null","2020","4","2020","3","09","30"
"2020-09-30","Agency","Office of Special Counsel","null","0","0","0","0","0","0","0.0","0.0","Non-CFO","2020","4","2020","3","09","30"
"2020-09-30","Bureau","Office of Special Counsel","Office of Special Counsel","0","0","0","0","0","0","0.0","0.0","null","2020","4","2020","3","09","30"
"2020-09-30","Agency","Other Agencies","null","5880364","168","5747","3","5874617","165","0.0977320451591092","1.7857142857142858","Non-CFO","2020","4","2020","3","09","30"
"2020-09-30","Bureau","Other Agencies","Advisory Council on Hist. Preservation","0","0","0","0","0","0","0.0","0.0","null","2020","4","2020","3","09","30"
"2020-09-30","Bureau","Other Agencies","Archit.&Trans. Barriers Compliance Bd","0","0","0","0","0","0","0.0","0.0","null","2020","4","2020","3","09","30"
"2020-09-30","Bureau","Other Agencies","Architect of the Capitol","127812","57","0","0","127812","57","0.0","0.0","null","2020","4","2020","3","09","30"
"2020-09-30","Bureau","Other Agencies","Chemical Safety Board","0","0","0","0","0","0","0.0","0.0","null","2020","4","2020","3","09","30"
"2020-09-30","Bureau","Other Agencies","Comm. for Purchase from Blind/Handic.","0","0","0","0","0","0","0.0","0.0","null","2020","4","2020","3","09","30"
"2020-09-30","Bureau","Other Agencies","Commission On Fine Arts","0","0","0","0","0","0","0.0","0.0","null","2020","4","2020","3","09","30"
"2020-09-30","Bureau","Other Agencies","Consumer Financial Protection Bureau","5510394","68","0","0","5510394","68","0.0","0.0","null","2020","4","2020","3","09","30"
"2020-09-30","Bureau","Other Agencies","Council of Insps. Gen. of Intg. & Effy.","5475","9","0","0","5475","9","0.0","0.0","null","2020","4","2020","3","09","30"
"2020-09-30","Bureau","Other Agencies","Defense Nuclear Facilities Safety Board","0","0","0","0","0","0","0.0","0.0","null","2020","4","2020","3","09","30"
"2020-09-30","Bureau","Other Agencies","Delta Regional Authority","0","0","0","0","0","0","0.0","0.0","null","2020","4","2020","3","09","30"
"2020-09-30","Bureau","Other Agencies","Denali Commission","0","0","0","0","0","0","0.0","0.0","null","2020","4","2020","3","09","30"
"2020-09-30","Bureau","Other Agencies","District of Columbia Government","0","0","0","0","0","0","0.0","0.0","null","2020","4","2020","3","09","30"
"2020-09-30","Bureau","Other Agencies","Election Assistance Commission","0","0","0","0","0","0","0.0","0.0","null","2020","4","2020","3","09","30"
"2020-09-30","Bureau","Other Agencies","Federal Housing Finance Agency","0","0","0","0","0","0","0.0","0.0","null","2020","4","2020","3","09","30"
"2020-09-30","Bureau","Other Agencies","Federal Housing Finance Agency OIG","0","0","0","0","0","0","0.0","0.0","null","2020","4","2020","3","09","30"
"2020-09-30","Bureau","Other Agencies","Federal Mine Safety & Health Review Comm","0","0","0","0","0","0","0.0","0.0","null","2020","4","2020","3","09","30"
"2020-09-30","Bureau","Other Agencies","Gulf Coast Ecosystem Restoration Council","0","0","0","0","0","0","0.0","0.0","null","2020","4","2020","3","09","30"
"2020-09-30","Bureau","Other Agencies","James Madison Memorial Fellowship","221291","25","0","0","221291","25","0.0","0.0","null","2020","4","2020","3","09","30"
"2020-09-30","Bureau","Other Agencies","John C. Stennis","3063","2","0","0","3063","2","0.0","0.0","null","2020","4","2020","3","09","30"
"2020-09-30","Bureau","Other Agencies","Millennium Challenge Corporation","817","1","817","1","0","0","100.0","100.0","null","2020","4","2020","3","09","30"
"2020-09-30","Bureau","Other Agencies","Morris K. Udall Scholarship","0","0","0","0","0","0","0.0","0.0","null","2020","4","2020","3","09","30"
"2020-09-30","Bureau","Other Agencies","National Capital Planning Commission","0","0","0","0","0","0","0.0","0.0","null","2020","4","2020","3","09","30"
"2020-09-30","Bureau","Other Agencies","National Council on Disability","1579","2","0","0","1579","2","0.0","0.0","null","2020","4","2020","3","09","30"
"2020-09-30","Bureau","Other Agencies","National Mediation Board","0","0","0","0","0","0","0.0","0.0","null","2020","4","2020","3","09","30"
"2020-09-30","Bureau","Other Agencies","National Transportation Safety Board","0","0","0","0","0","0","0.0","0.0","null","2020","4","2020","3","09","30"
"2020-09-30","Bureau","Other Agencies","Privacy & Civil Liberties Oversight Bd","0","0","0","0","0","0","0.0","0.0","null","2020","4","2020","3","09","30"
"2020-09-30","Bureau","Other Agencies","Surface Transportation Board","0","0","0","0","0","0","0.0","0.0","null","2020","4","2020","3","09","30"
"2020-09-30","Bureau","Other Agencies","U.S.  Agency of Global Media","4930","2","4930","2","0","0","100.0","100.0","null","2020","4","2020","3","09","30"
"2020-09-30","Bureau","Other Agencies","U.S. Holocaust Memorial Council","0","0","0","0","0","0","0.0","0.0","null","2020","4","2020","3","09","30"
"2020-09-30","Bureau","Other Agencies","U.S. Inst. for Env. Conflict Resolution","5003","2","0","0","5003","2","0.0","0.0","null","2020","4","2020","3","09","30"
"2020-09-30","Bureau","Other Agencies","U.S. Institute of Peace","0","0","0","0","0","0","0.0","0.0","null","2020","4","2020","3","09","30"
"2020-09-30","Agency","Other Agencies/Boards/Commissions","null","393","1","0","0","393","1","0.0","0.0","Non-CFO","2020","4","2020","3","09","30"
"2020-09-30","Bureau","Other Agencies/Boards/Commissions","Medicare Payment Advisory Commission","0","0","0","0","0","0","0.0","0.0","null","2020","4","2020","3","09","30"
"2020-09-30","Bureau","Other Agencies/Boards/Commissions","U.S. Comm. on Int. Religious Freedom","393","1","0","0","393","1","0.0","0.0","null","2020","4","2020","3","09","30"
"2020-09-30","Bureau","Other Agencies/Boards/Commissions","U.S.-China Security Review Commission","0","0","0","0","0","0","0.0","0.0","null","2020","4","2020","3","09","30"
"2020-09-30","Agency","Overseas Private Investment Corp Accts","null","0","0","0","0","0","0","0.0","0.0","Non-CFO","2020","4","2020","3","09","30"
"2020-09-30","Bureau","Overseas Private Investment Corp Accts","Overseas Private Investment Corp Accts","0","0","0","0","0","0","0.0","0.0","null","2020","4","2020","3","09","30"
"2020-09-30","Agency","Pension Benefit Guaranty Corp","null","3967058","1483","3967058","1483","0","0","100.0","100.0","Non-CFO","2020","4","2020","3","09","30"
"2020-09-30","Bureau","Pension Benefit Guaranty Corp","Pension Benefit Guaranty Corporation","3967058","1483","3967058","1483","0","0","100.0","100.0","null","2020","4","2020","3","09","30"
"2020-09-30","Agency","Presidio Trust Corporation","null","1506648","83","1481604","79","25044","4","98.3377670165825","95.18072289156626","Non-CFO","2020","4","2020","3","09","30"
"2020-09-30","Bureau","Presidio Trust Corporation","Presidio Trust Corporation","1506648","83","1481604","79","25044","4","98.3377670165825","95.18072289156626","null","2020","4","2020","3","09","30"
"2020-09-30","Agency","Railroad Retirement Board","null","21927392","4411","21927392","4411","0","0","100.0","100.0","Non-CFO","2020","4","2020","3","09","30"
"2020-09-30","Bureau","Railroad Retirement Board","Railroad Retirement Board","21927392","4411","21927392","4411","0","0","100.0","100.0","null","2020","4","2020","3","09","30"
"2020-09-30","Agency","Securities & Exchange Commission","null","1902795132","983","1902795132","983","0","0","100.0","100.0","Non-CFO","2020","4","2020","3","09","30"
"2020-09-30","Bureau","Securities & Exchange Commission","SEC Enforcement","1902482096","924","1902482096","924","0","0","100.0","100.0","null","2020","4","2020","3","09","30"
"2020-09-30","Bureau","Securities & Exchange Commission","Securities and Exchange Commission","313036","59","313036","59","0","0","100.0","100.0","null","2020","4","2020","3","09","30"
"2020-09-30","Agency","Selective Service System","null","0","0","0","0","0","0","0.0","0.0","Non-CFO","2020","4","2020","3","09","30"
"2020-09-30","Bureau","Selective Service System","Selective Service System","0","0","0","0","0","0","0.0","0.0","null","2020","4","2020","3","09","30"
"2020-09-30","Agency","Small Business Administration","null","12344834017","120252","12344834017","120252","0","0","100.0","100.0","CFO","2020","4","2020","3","09","30"
"2020-09-30","Bureau","Small Business Administration","Small Business Administration","12344834017","120252","12344834017","120252","0","0","100.0","100.0","null","2020","4","2020","3","09","30"
"2020-09-30","Agency","Smithsonian Institution","null","5670","1","0","0","5670","1","0.0","0.0","Non-CFO","2020","4","2020","3","09","30"
"2020-09-30","Bureau","Smithsonian Institution","Administrative Conference of the US","0","0","0","0","0","0","0.0","0.0","null","2020","4","2020","3","09","30"
"2020-09-30","Bureau","Smithsonian Institution","JFK Center for the Performing Arts","0","0","0","0","0","0","0.0","0.0","null","2020","4","2020","3","09","30"
"2020-09-30","Bureau","Smithsonian Institution","National Gallery of Art","0","0","0","0","0","0","0.0","0.0","null","2020","4","2020","3","09","30"
"2020-09-30","Bureau","Smithsonian Institution","Smithsonian Institution","5670","1","0","0","5670","1","0.0","0.0","null","2020","4","2020","3","09","30"
"2020-09-30","Agency","Social Security Administration","null","5542485458","1700085","2926738062","502802","2615747396","1197283","52.8055163009144","29.575109479820128","CFO","2020","4","2020","3","09","30"
"2020-09-30","Bureau","Social Security Administration","Social Security Administration","5542485458","1700085","2926738062","502802","2615747396","1197283","52.8055163009144","29.575109479820128","null","2020","4","2020","3","09","30"
"2020-09-30","Agency","Tennessee Valley Authority","null","0","0","0","0","0","0","0.0","0.0","Non-CFO","2020","4","2020","3","09","30"
"2020-09-30","Bureau","Tennessee Valley Authority","Tennessee Valley Authority","0","0","0","0","0","0","0.0","0.0","null","2020","4","2020","3","09","30"
"2020-09-30","Agency","The Judiciary","null","1039255","317","1027290","190","11965","127","98.84869449750062","59.936908517350155","Non-CFO","2020","4","2020","3","09","30"
"2020-09-30","Bureau","The Judiciary","Administrative Office of the U.S. Courts","1039255","317","1027290","190","11965","127","98.84869449750062","59.936908517350155","null","2020","4","2020","3","09","30"
"2020-09-30","Agency","U.S. Court of Appeals / Veterans Claims","null","171","1","171","1","0","0","100.0","100.0","Non-CFO","2020","4","2020","3","09","30"
"2020-09-30","Bureau","U.S. Court of Appeals / Veterans Claims","U.S. Court of Appeals / Veterans Claims","171","1","171","1","0","0","100.0","100.0","null","2020","4","2020","3","09","30"
"2020-09-30","Agency","U.S. Postal Service","null","72153293","49851","44495457","42447","27657836","7404","61.66795048425579","85.14774026599265","Non-CFO","2020","4","2020","3","09","30"
"2020-09-30","Bureau","U.S. Postal Service","U.S. Postal Service","72153293","49851","44495457","42447","27657836","7404","61.66795048425579","85.14774026599265","null","2020","4","2020","3","09","30"
"2020-09-30","Agency","US International Development Fin. Corp.","null","68649283","6","0","0","68649283","6","0.0","0.0","Non-CFO","2020","4","2020","3","09","30"
"2020-09-30","Bureau","US International Development Fin. Corp.","US International Development Fin. Corp.","68649283","6","0","0","68649283","6","0.0","0.0","null","2020","4","2020","3","09","30"
"2020-06-30","Agency","Agency for International Development","null","33141602","59","33141530","58","72","1","99.9997827503933","98.30508474576271","CFO","2020","3","2020","2","06","30"
"2020-06-30","Bureau","Agency for International Development","Agency for International Development","33141602","59","33141530","58","72","1","99.9997827503933","98.30508474576271","null","2020","3","2020","2","06","30"
"2020-06-30","Agency","American Battle Monuments Commission","null","0","0","0","0","0","0","0.0","0.0","Non-CFO","2020","3","2020","2","06","30"
"2020-06-30","Bureau","American Battle Monuments Commission","American Battle Monuments Commission","0","0","0","0","0","0","0.0","0.0","null","2020","3","2020","2","06","30"
"2020-06-30","Agency","Armed Forces Retirement Home","null","78519","104","78519","104","0","0","100.0","100.0","Non-CFO","2020","3","2020","2","06","30"
"2020-06-30","Bureau","Armed Forces Retirement Home","Armed Forces Retirement Home","78519","104","78519","104","0","0","100.0","100.0","null","2020","3","2020","2","06","30"
"2020-06-30","Agency","Commodity Futures Trading Commission","null","646950459","366","646950459","366","0","0","100.0","100.0","Non-CFO","2020","3","2020","2","06","30"
"2020-06-30","Bureau","Commodity Futures Trading Commission","Commodity Futures Trading Commission","646950459","366","646950459","366","0","0","100.0","100.0","null","2020","3","2020","2","06","30"
"2020-06-30","Agency","Consumer Product Safety Commission","null","479","1","479","1","0","0","100.0","100.0","Non-CFO","2020","3","2020","2","06","30"
"2020-06-30","Bureau","Consumer Product Safety Commission","Consumer Product Safety Commission","479","1","479","1","0","0","100.0","100.0","null","2020","3","2020","2","06","30"
"2020-06-30","Agency","Corp. for National and Community Service","null","4686569","1371","3586180","155","1100389","1216","76.520371299345","11.305616338439096","Non-CFO","2020","3","2020","2","06","30"
"2020-06-30","Bureau","Corp. for National and Community Service","Corp. for National and Community Service","4686569","1371","3586180","155","1100389","1216","76.520371299345","11.305616338439096","null","2020","3","2020","2","06","30"
"2020-06-30","Agency","Department of Agriculture","null","1289531265","39511","1280301569","36242","9229696","3269","99.28425961816444","91.7263546860368","CFO","2020","3","2020","2","06","30"
"2020-06-30","Bureau","Department of Agriculture","Agricultural Marketing Service","5344186","1410","4497605","482","846581","928","84.15884102836242","34.184397163120565","null","2020","3","2020","2","06","30"
"2020-06-30","Bureau","Department of Agriculture","Commodity Credit Corporation","134440537","10992","134440537","10992","0","0","100.0","100.0","null","2020","3","2020","2","06","30"
"2020-06-30","Bureau","Department of Agriculture","Farm Service Agency","353709270","5149","353709270","5149","0","0","100.0","100.0","null","2020","3","2020","2","06","30"
"2020-06-30","Bureau","Department of Agriculture","Federal Crop Insurance Corporation","32842","445","28563","444","4279","1","86.97095182997381","99.7752808988764","null","2020","3","2020","2","06","30"
"2020-06-30","Bureau","Department of Agriculture","Food Safety and Inspection Service","712164","855","709793","852","2371","3","99.6670710679001","99.64912280701755","null","2020","3","2020","2","06","30"
"2020-06-30","Bureau","Department of Agriculture","Food and Nutrition Service","500463","41","50472","7","449991","34","10.085061233297965","17.073170731707318","null","2020","3","2020","2","06","30"
"2020-06-30","Bureau","Department of Agriculture","Forest Service","65347963","1479","61184548","290","4163415","1189","93.62885266982232","19.607843137254903","null","2020","3","2020","2","06","30"
"2020-06-30","Bureau","Department of Agriculture","Rural Development","697896965","16076","697882749","16068","14216","8","99.99796302309468","99.95023637720826","null","2020","3","2020","2","06","30"
"2020-06-30","Bureau","Department of Agriculture","U.S. Department of Agriculture","31546875","3064","27798032","1958","3748843","1106","88.11659474987617","63.90339425587467","null","2020","3","2020","2","06","30"
"2020-06-30","Agency","Department of Commerce","null","22907214","1682","22907214","1682","0","0","100.0","100.0","CFO","2020","3","2020","2","06","30"
"2020-06-30","Bureau","Department of Commerce","Bureau of Industry and Security","1725097","23","1725097","23","0","0","100.0","100.0","null","2020","3","2020","2","06","30"
"2020-06-30","Bureau","Department of Commerce","Bureau of the Census","250622","296","250622","296","0","0","100.0","100.0","null","2020","3","2020","2","06","30"
"2020-06-30","Bureau","Department of Commerce","Economic Development Administration","5092842","9","5092842","9","0","0","100.0","100.0","null","2020","3","2020","2","06","30"
"2020-06-30","Bureau","Department of Commerce","Economic and Statistical Analysis","0","0","0","0","0","0","0.0","0.0","null","2020","3","2020","2","06","30"
"2020-06-30","Bureau","Department of Commerce","General Administration","4660","1","4660","1","0","0","100.0","100.0","null","2020","3","2020","2","06","30"
"2020-06-30","Bureau","Department of Commerce","International Trade Administration","2740","1","2740","1","0","0","100.0","100.0","null","2020","3","2020","2","06","30"
"2020-06-30","Bureau","Department of Commerce","Minority Business Development Agency","0","0","0","0","0","0","0.0","0.0","null","2020","3","2020","2","06","30"
"2020-06-30","Bureau","Department of Commerce","NOAA","14451524","840","14451524","840","0","0","100.0","100.0","null","2020","3","2020","2","06","30"
"2020-06-30","Bureau","Department of Commerce","Nat'l Institute of Standards& Technology","670559","5","670559","5","0","0","100.0","100.0","null","2020","3","2020","2","06","30"
"2020-06-30","Bureau","Department of Commerce","Nat'l Telecomm & Information Admin.","296093","1","296093","1","0","0","100.0","100.0","null","2020","3","2020","2","06","30"
"2020-06-30","Bureau","Department of Commerce","National Technical Information Service","0","0","0","0","0","0","0.0","0.0","null","2020","3","2020","2","06","30"
"2020-06-30","Bureau","Department of Commerce","Office of the Inspector General","0","0","0","0","0","0","0.0","0.0","null","2020","3","2020","2","06","30"
"2020-06-30","Bureau","Department of Commerce","Patent and Trademark Office","413077","506","413077","506","0","0","100.0","100.0","null","2020","3","2020","2","06","30"
"2020-06-30","Agency","Department of Defense","null","2303509389","1219052","1113241408","292325","1190267981","926727","48.32806036372531","23.979698979206795","CFO","2020","3","2020","2","06","30"
"2020-06-30","Bureau","Department of Defense","Consolidated Report","2303509389","1219052","1113241408","292325","1190267981","926727","48.32806036372531","23.979698979206795","null","2020","3","2020","2","06","30"
"2020-06-30","Agency","Department of Education","null","150865106113","27065755","143026829478","24784939","7838276635","2280816","94.80444694140935","91.5730560629105","CFO","2020","3","2020","2","06","30"
"2020-06-30","Bureau","Department of Education","Departmental Management","1025601053","2180","728388695","1789","297212358","391","71.02066567398502","82.06422018348624","null","2020","3","2020","2","06","30"
"2020-06-30","Bureau","Department of Education","Federal Student Aid","149839505060","27063575","142298440783","24783150","7541064277","2280425","94.96723893076106","91.57382200984163","null","2020","3","2020","2","06","30"
"2020-06-30","Bureau","Department of Education","Office of Postsecondary Education","0","0","0","0","0","0","0.0","0.0","null","2020","3","2020","2","06","30"
"2020-06-30","Agency","Department of Energy","null","15081450","99","15081450","99","0","0","100.0","100.0","CFO","2020","3","2020","2","06","30"
"2020-06-30","Bureau","Department of Energy","Bonneville Power Administration","1100046","39","1100046","39","0","0","100.0","100.0","null","2020","3","2020","2","06","30"
"2020-06-30","Bureau","Department of Energy","Energy Consolidated Reports","13981404","60","13981404","60","0","0","100.0","100.0","null","2020","3","2020","2","06","30"
"2020-06-30","Agency","Department of Health & Human Services","null","10012326547","1209727","9882965442","1191011","129361105","18716","98.70798156259934","98.45287407820112","CFO","2020","3","2020","2","06","30"
"2020-06-30","Bureau","Department of Health & Human Services","Administration for Children and Families","29819544","1686","29819544","1686","0","0","100.0","100.0","null","2020","3","2020","2","06","30"
"2020-06-30","Bureau","Department of Health & Human Services","Administration for Community Living","0","0","0","0","0","0","0.0","0.0","null","2020","3","2020","2","06","30"
"2020-06-30","Bureau","Department of Health & Human Services","Centers for Disease Control","7283862","166","143555","16","7140307","150","1.9708638082379923","9.63855421686747","null","2020","3","2020","2","06","30"
"2020-06-30","Bureau","Department of Health & Human Services","Centers for Medicare & Medicaid Services","9764635474","1196579","9692595862","1186911","72039612","9668","99.2622396177326","99.19202994536926","null","2020","3","2020","2","06","30"
"2020-06-30","Bureau","Department of Health & Human Services","Food and Drug Administration","46206217","6370","32471399","1093","13734818","5277","70.27495672281503","17.1585557299843","null","2020","3","2020","2","06","30"
"2020-06-30","Bureau","Department of Health & Human Services","Health Resources and Services Admin","86555722","547","86555722","547","0","0","100.0","100.0","null","2020","3","2020","2","06","30"
"2020-06-30","Bureau","Department of Health & Human Services","Indian Health Services","56230681","3509","28371794","188","27858887","3321","50.456073971432076","5.3576517526360785","null","2020","3","2020","2","06","30"
"2020-06-30","Bureau","Department of Health & Human Services","National Institutes of Health","14228451","397","5640970","97","8587481","300","39.645707041476264","24.43324937027708","null","2020","3","2020","2","06","30"
"2020-06-30","Bureau","Department of Health & Human Services","Office of the Inspector General","0","0","0","0","0","0","0.0","0.0","null","2020","3","2020","2","06","30"
"2020-06-30","Bureau","Department of Health & Human Services","Office of the Secretary","8092","8","8092","8","0","0","100.0","100.0","null","2020","3","2020","2","06","30"
"2020-06-30","Bureau","Department of Health & Human Services","Program Support Center","6371211","452","6371211","452","0","0","100.0","100.0","null","2020","3","2020","2","06","30"
"2020-06-30","Bureau","Department of Health & Human Services","Substance Abuse & Mental Health Admin.","987293","13","987293","13","0","0","100.0","100.0","null","2020","3","2020","2","06","30"
"2020-06-30","Agency","Department of Homeland Security","null","370920255","63371","370161719","63114","758536","257","99.79549890043077","99.59445172081867","CFO","2020","3","2020","2","06","30"
"2020-06-30","Bureau","Department of Homeland Security","Bureau of Customs & Border Protection","8810668","1027","8810668","1027","0","0","100.0","100.0","null","2020","3","2020","2","06","30"
"2020-06-30","Bureau","Department of Homeland Security","Citizenship and Immigration Services","1010952","1232","1010952","1232","0","0","100.0","100.0","null","2020","3","2020","2","06","30"
"2020-06-30","Bureau","Department of Homeland Security","Domestic Nuclear Detection Office","536","7","0","0","536","7","0.0","0.0","null","2020","3","2020","2","06","30"
"2020-06-30","Bureau","Department of Homeland Security","Emergency Preparedness & Resp","258920557","43080","258920557","43080","0","0","100.0","100.0","null","2020","3","2020","2","06","30"
"2020-06-30","Bureau","Department of Homeland Security","Federal Law Enforcement Training Ctr.","0","0","0","0","0","0","0.0","0.0","null","2020","3","2020","2","06","30"
"2020-06-30","Bureau","Department of Homeland Security","Immigration and Customs Enforcement","12611373","460","12611373","460","0","0","100.0","100.0","null","2020","3","2020","2","06","30"
"2020-06-30","Bureau","Department of Homeland Security","Info Analysis Infrastructure Prot-NPPD","0","0","0","0","0","0","0.0","0.0","null","2020","3","2020","2","06","30"
"2020-06-30","Bureau","Department of Homeland Security","Management Headquarters","0","0","0","0","0","0","0.0","0.0","null","2020","3","2020","2","06","30"
"2020-06-30","Bureau","Department of Homeland Security","Office of Biometric Identity Management","0","0","0","0","0","0","0.0","0.0","null","2020","3","2020","2","06","30"
"2020-06-30","Bureau","Department of Homeland Security","Office of Health Affairs","0","0","0","0","0","0","0.0","0.0","null","2020","3","2020","2","06","30"
"2020-06-30","Bureau","Department of Homeland Security","Office of the Inspector General DHS","99","1","99","1","0","0","100.0","100.0","null","2020","3","2020","2","06","30"
"2020-06-30","Bureau","Department of Homeland Security","Science and Technology","0","0","0","0","0","0","0.0","0.0","null","2020","3","2020","2","06","30"
"2020-06-30","Bureau","Department of Homeland Security","Transportation Safety Administration","8703416","5769","8703416","5769","0","0","100.0","100.0","null","2020","3","2020","2","06","30"
"2020-06-30","Bureau","Department of Homeland Security","U.S. Coast Guard","80862654","11795","80104654","11545","758000","250","99.0626080613184","97.88045782111064","null","2020","3","2020","2","06","30"
"2020-06-30","Bureau","Department of Homeland Security","U.S. Secret Service","0","0","0","0","0","0","0.0","0.0","null","2020","3","2020","2","06","30"
"2020-06-30","Agency","Department of Housing and Urban Development","null","176955627","6663","176955627","6663","0","0","100.0","100.0","CFO","2020","3","2020","2","06","30"
"2020-06-30","Bureau","Department of Housing and Urban Development","Community Planning and Development","0","0","0","0","0","0","0.0","0.0","null","2020","3","2020","2","06","30"
"2020-06-30","Bureau","Department of Housing and Urban Development","Government National Mortgage Association","0","0","0","0","0","0","0.0","0.0","null","2020","3","2020","2","06","30"
"2020-06-30","Bureau","Department of Housing and Urban Development","Housing Programs","176951741","6657","176951741","6657","0","0","100.0","100.0","null","2020","3","2020","2","06","30"
"2020-06-30","Bureau","Department of Housing and Urban Development","Management and Administration","3322","5","3322","5","0","0","100.0","100.0","null","2020","3","2020","2","06","30"
"2020-06-30","Bureau","Department of Housing and Urban Development","Policy, Development and Research","0","0","0","0","0","0","0.0","0.0","null","2020","3","2020","2","06","30"
"2020-06-30","Bureau","Department of Housing and Urban Development","Public and Indian Housing Programs","564","1","564","1","0","0","100.0","100.0","null","2020","3","2020","2","06","30"
"2020-06-30","Agency","Department of Justice","null","89973842","37655","80218810","37016","9755032","639","89.15792436650644","98.3030142079405","CFO","2020","3","2020","2","06","30"
"2020-06-30","Bureau","Department of Justice","Bureau of ATF and Explosives","20885","4","20885","4","0","0","100.0","100.0","null","2020","3","2020","2","06","30"
"2020-06-30","Bureau","Department of Justice","Drug Enforcement Administration","309373","19","309373","19","0","0","100.0","100.0","null","2020","3","2020","2","06","30"
"2020-06-30","Bureau","Department of Justice","Federal Bureau of Investigation","263029","66","234354","65","28675","1","89.0981602789046","98.48484848484848","null","2020","3","2020","2","06","30"
"2020-06-30","Bureau","Department of Justice","Federal Prison Industries","1043089","183","1043089","183","0","0","100.0","100.0","null","2020","3","2020","2","06","30"
"2020-06-30","Bureau","Department of Justice","Federal Prison System","877499","125","877499","125","0","0","100.0","100.0","null","2020","3","2020","2","06","30"
"2020-06-30","Bureau","Department of Justice","General Administration","0","0","0","0","0","0","0.0","0.0","null","2020","3","2020","2","06","30"
"2020-06-30","Bureau","Department of Justice","Legal Activities","87457119","37256","77733610","36620","9723509","636","88.88196968848241","98.29289242001289","null","2020","3","2020","2","06","30"
"2020-06-30","Bureau","Department of Justice","Office of Justice Assistance Programs","0","0","0","0","0","0","0.0","0.0","null","2020","3","2020","2","06","30"
"2020-06-30","Bureau","Department of Justice","U.S. Marshals Service","2848","2","0","0","2848","2","0.0","0.0","null","2020","3","2020","2","06","30"
"2020-06-30","Agency","Department of Labor","null","193830368","54401","149173758","19988","44656610","34413","76.9609837401743","36.74197165493281","CFO","2020","3","2020","2","06","30"
"2020-06-30","Bureau","Department of Labor","Bureau of Labor Statistics","11281","1","11281","1","0","0","100.0","100.0","null","2020","3","2020","2","06","30"
"2020-06-30","Bureau","Department of Labor","Departmental Management","0","0","0","0","0","0","0.0","0.0","null","2020","3","2020","2","06","30"
"2020-06-30","Bureau","Department of Labor","Employee Benefit Security Administration","16677336","361","16677336","361","0","0","100.0","100.0","null","2020","3","2020","2","06","30"
"2020-06-30","Bureau","Department of Labor","Employment Standards Administration","86354246","33176","58164886","2874","28189360","30302","67.35613903686914","8.662888835302628","null","2020","3","2020","2","06","30"
"2020-06-30","Bureau","Department of Labor","Employment and Training Administration","3520914","12","3380914","11","140000","1","96.02375973965852","91.66666666666667","null","2020","3","2020","2","06","30"
"2020-06-30","Bureau","Department of Labor","Mine Safety and Health Administration","40654851","17444","29436030","13487","11218821","3957","72.40471745917849","77.3159825728044","null","2020","3","2020","2","06","30"
"2020-06-30","Bureau","Department of Labor","Occupational Safety and Health Admin","46611740","3407","41503311","3254","5108429","153","89.04046705829904","95.50924567067801","null","2020","3","2020","2","06","30"
"2020-06-30","Agency","Department of State","null","17005582","23195","16804587","23149","200995","46","98.8180645625654","99.80168139685277","CFO","2020","3","2020","2","06","30"
"2020-06-30","Bureau","Department of State","Civil Monetary Penalties","0","0","0","0","0","0","0.0","0.0","null","2020","3","2020","2","06","30"
"2020-06-30","Bureau","Department of State","Department of State","14486666","7014","14285671","6968","200995","46","98.6125517078947","99.34416880524665","null","2020","3","2020","2","06","30"
"2020-06-30","Bureau","Department of State","International Commissions","0","0","0","0","0","0","0.0","0.0","null","2020","3","2020","2","06","30"
"2020-06-30","Bureau","Department of State","Passport NSF","2518916","16181","2518916","16181","0","0","100.0","100.0","null","2020","3","2020","2","06","30"
"2020-06-30","Agency","Department of Transportation","null","64034901","7361","63957158","7347","77743","14","99.87859276927749","99.80980844993887","CFO","2020","3","2020","2","06","30"
"2020-06-30","Bureau","Department of Transportation","Federal Aviation Administration","2173457","319","2108773","306","64684","13","97.02391167619143","95.92476489028213","null","2020","3","2020","2","06","30"
"2020-06-30","Bureau","Department of Transportation","Federal Highway Administration","110600","6","110600","6","0","0","100.0","100.0","null","2020","3","2020","2","06","30"
"2020-06-30","Bureau","Department of Transportation","Federal Motor Carrier Safety Admin","59385795","6966","59385795","6966","0","0","100.0","100.0","null","2020","3","2020","2","06","30"
"2020-06-30","Bureau","Department of Transportation","Federal Railroad Administration","165063","15","165063","15","0","0","100.0","100.0","null","2020","3","2020","2","06","30"
"2020-06-30","Bureau","Department of Transportation","Federal Transit Administration","784517","2","784517","2","0","0","100.0","100.0","null","2020","3","2020","2","06","30"
"2020-06-30","Bureau","Department of Transportation","Maritime Administration","2969","4","2969","4","0","0","100.0","100.0","null","2020","3","2020","2","06","30"
"2020-06-30","Bureau","Department of Transportation","National Highway Traffic Safety Admin.","19109","4","19109","4","0","0","100.0","100.0","null","2020","3","2020","2","06","30"
"2020-06-30","Bureau","Department of Transportation","Office of the Inspector General","209","1","209","1","0","0","100.0","100.0","null","2020","3","2020","2","06","30"
"2020-06-30","Bureau","Department of Transportation","Office of the Secretary","1026163","17","1026163","17","0","0","100.0","100.0","null","2020","3","2020","2","06","30"
"2020-06-30","Bureau","Department of Transportation","Pipeline Hazardous Material Safety Admin","348036","23","348036","23","0","0","100.0","100.0","null","2020","3","2020","2","06","30"
"2020-06-30","Bureau","Department of Transportation","Research Innovative Technology Admin","1581","2","1581","2","0","0","100.0","100.0","null","2020","3","2020","2","06","30"
"2020-06-30","Bureau","Department of Transportation","St. Lawrence Seaway Development Corp.","17402","2","4343","1","13059","1","24.956901505574073","50.0","null","2020","3","2020","2","06","30"
"2020-06-30","Bureau","Department of Transportation","Surface Transportation Board","0","0","0","0","0","0","0.0","0.0","null","2020","3","2020","2","06","30"
"2020-06-30","Agency","Department of Veterans Affairs","null","778448292","8442973","619054849","8334515","159393443","108458","79.52420929712824","98.71540510670826","CFO","2020","3","2020","2","06","30"
"2020-06-30","Bureau","Department of Veterans Affairs","Administration and Cemeteries","2979212","732","3463","5","2975749","727","0.11623879066008058","0.6830601092896175","null","2020","3","2020","2","06","30"
"2020-06-30","Bureau","Department of Veterans Affairs","Housing Credit Assistance","1011537","31","251441","13","760096","18","24.857321086623624","41.935483870967744","null","2020","3","2020","2","06","30"
"2020-06-30","Bureau","Department of Veterans Affairs","Life Insurance","618100","123","617602","122","498","1","99.919430512862","99.1869918699187","null","2020","3","2020","2","06","30"
"2020-06-30","Bureau","Department of Veterans Affairs","Medical and Construction","626704654","8401166","479686264","8300631","147018390","100535","76.54104065421541","98.80332087236462","null","2020","3","2020","2","06","30"
"2020-06-30","Bureau","Department of Veterans Affairs","Veterans Benefits","147134789","40921","138496079","33744","8638710","7177","94.12871010403937","82.46132792453753","null","2020","3","2020","2","06","30"
"2020-06-30","Agency","Department of the Interior","null","51246561","31367","51232792","31349","13769","18","99.97313185561856","99.94261485000159","CFO","2020","3","2020","2","06","30"
"2020-06-30","Bureau","Department of the Interior","Bureau of Indian Affairs","20081464","28114","20067695","28096","13769","18","99.93143428188303","99.93597495909512","null","2020","3","2020","2","06","30"
"2020-06-30","Bureau","Department of the Interior","Bureau of Land Management","15843183","315","15843183","315","0","0","100.0","100.0","null","2020","3","2020","2","06","30"
"2020-06-30","Bureau","Department of the Interior","Bureau of Ocean Energy Mgmt., Reg & Enf","0","0","0","0","0","0","0.0","0.0","null","2020","3","2020","2","06","30"
"2020-06-30","Bureau","Department of the Interior","Bureau of Reclamation","92509","88","92509","88","0","0","100.0","100.0","null","2020","3","2020","2","06","30"
"2020-06-30","Bureau","Department of the Interior","Bureau of Safety and Environmental Enf.","0","0","0","0","0","0","0.0","0.0","null","2020","3","2020","2","06","30"
"2020-06-30","Bureau","Department of the Interior","Fish and Wildlife Service","606963","82","606963","82","0","0","100.0","100.0","null","2020","3","2020","2","06","30"
"2020-06-30","Bureau","Department of the Interior","Geological Survey","208651","147","208651","147","0","0","100.0","100.0","null","2020","3","2020","2","06","30"
"2020-06-30","Bureau","Department of the Interior","National Park Service","7698374","1881","7698374","1881","0","0","100.0","100.0","null","2020","3","2020","2","06","30"
"2020-06-30","Bureau","Department of the Interior","Office of Natural Resources Revenue","3868467","408","3868467","408","0","0","100.0","100.0","null","2020","3","2020","2","06","30"
"2020-06-30","Bureau","Department of the Interior","Office of Surface Mining","2770270","298","2770270","298","0","0","100.0","100.0","null","2020","3","2020","2","06","30"
"2020-06-30","Bureau","Department of the Interior","Office of the Secretary","76680","34","76680","34","0","0","100.0","100.0","null","2020","3","2020","2","06","30"
"2020-06-30","Agency","Department of the Treasury","null","43832283","5907","43228180","5875","604103","32","98.6217852261996","99.4582698493313","CFO","2020","3","2020","2","06","30"
"2020-06-30","Bureau","Department of the Treasury","Bureau of Engraving and Printing","84528","1","0","0","84528","1","0.0","0.0","null","2020","3","2020","2","06","30"
"2020-06-30","Bureau","Department of the Treasury","Bureau of the Fiscal Service","13076243","4315","13076243","4315","0","0","100.0","100.0","null","2020","3","2020","2","06","30"
"2020-06-30","Bureau","Department of the Treasury","Community Dev Financial Inst Fund","3439449","6","3439449","6","0","0","100.0","100.0","null","2020","3","2020","2","06","30"
"2020-06-30","Bureau","Department of the Treasury","Comptroller of the Currency","1110145","28","1107611","21","2534","7","99.77174152925969","75.0","null","2020","3","2020","2","06","30"
"2020-06-30","Bureau","Department of the Treasury","D.C. Pension Program","398640","22","398640","22","0","0","100.0","100.0","null","2020","3","2020","2","06","30"
"2020-06-30","Bureau","Department of the Treasury","Departmental Offices","23863186","1375","23346453","1352","516733","23","97.83460180044693","98.32727272727273","null","2020","3","2020","2","06","30"
"2020-06-30","Bureau","Department of the Treasury","Financial Crimes Enforcement Network","1544945","3","1544945","3","0","0","100.0","100.0","null","2020","3","2020","2","06","30"
"2020-06-30","Bureau","Department of the Treasury","Interest on Tax/Deposit of Earnings","0","0","0","0","0","0","0.0","0.0","null","2020","3","2020","2","06","30"
"2020-06-30","Bureau","Department of the Treasury","Internal Revenue Service","263359","131","263359","131","0","0","100.0","100.0","null","2020","3","2020","2","06","30"
"2020-06-30","Bureau","Department of the Treasury","International Monetary Funds","0","0","0","0","0","0","0.0","0.0","null","2020","3","2020","2","06","30"
"2020-06-30","Bureau","Department of the Treasury","Office of Financial Research","0","0","0","0","0","0","0.0","0.0","null","2020","3","2020","2","06","30"
"2020-06-30","Bureau","Department of the Treasury","Office of Sec International Affairs","0","0","0","0","0","0","0.0","0.0","null","2020","3","2020","2","06","30"
"2020-06-30","Bureau","Department of the Treasury","Office of the Secretary","0","0","0","0","0","0","0.0","0.0","null","2020","3","2020","2","06","30"
"2020-06-30","Bureau","Department of the Treasury","Spec Insp Gen-Troubled Asset Rel Prog","3916","1","3916","1","0","0","100.0","100.0","null","2020","3","2020","2","06","30"
"2020-06-30","Bureau","Department of the Treasury","Tobacco Tax and Trade","1000","1","1000","1","0","0","100.0","100.0","null","2020","3","2020","2","06","30"
"2020-06-30","Bureau","Department of the Treasury","Treasury Forfeiture Fund","0","0","0","0","0","0","0.0","0.0","null","2020","3","2020","2","06","30"
"2020-06-30","Bureau","Department of the Treasury","Treasury Franchise Fund","0","0","0","0","0","0","0.0","0.0","null","2020","3","2020","2","06","30"
"2020-06-30","Bureau","Department of the Treasury","Treasury IG for Tax Admin","0","0","0","0","0","0","0.0","0.0","null","2020","3","2020","2","06","30"
"2020-06-30","Bureau","Department of the Treasury","U.S. Mint","46872","24","46564","23","308","1","99.34289127837515","95.83333333333333","null","2020","3","2020","2","06","30"
"2020-06-30","Bureau","Department of the Treasury","U.S. Treasury IG Office","0","0","0","0","0","0","0.0","0.0","null","2020","3","2020","2","06","30"
"2020-06-30","Agency","Environmental Protection Agency","null","24014850","219","24014850","219","0","0","100.0","100.0","CFO","2020","3","2020","2","06","30"
"2020-06-30","Bureau","Environmental Protection Agency","Environmental Protection Agency","24014850","219","24014850","219","0","0","100.0","100.0","null","2020","3","2020","2","06","30"
"2020-06-30","Agency","Equal Employment Opportunity Commission","null","38394","20","38394","20","0","0","100.0","100.0","Non-CFO","2020","3","2020","2","06","30"
"2020-06-30","Bureau","Equal Employment Opportunity Commission","Equal Employment Opportunity Commission","38394","20","38394","20","0","0","100.0","100.0","null","2020","3","2020","2","06","30"
"2020-06-30","Agency","Export - Import  Bank","null","0","0","0","0","0","0","0.0","0.0","Non-CFO","2020","3","2020","2","06","30"
"2020-06-30","Bureau","Export - Import  Bank","Export-Import Bank","0","0","0","0","0","0","0.0","0.0","null","2020","3","2020","2","06","30"
"2020-06-30","Agency","Farm Credit Administration","null","630","1","630","1","0","0","100.0","100.0","Non-CFO","2020","3","2020","2","06","30"
"2020-06-30","Bureau","Farm Credit Administration","Farm Credit Administration","630","1","630","1","0","0","100.0","100.0","null","2020","3","2020","2","06","30"
"2020-06-30","Bureau","Farm Credit Administration","Farm Credit System Insurance Corporation","0","0","0","0","0","0","0.0","0.0","null","2020","3","2020","2","06","30"
"2020-06-30","Agency","Federal Communications Commission","null","186638852","14571","186638852","14571","0","0","100.0","100.0","Non-CFO","2020","3","2020","2","06","30"
"2020-06-30","Bureau","Federal Communications Commission","Federal Communications Commission","186638852","14571","186638852","14571","0","0","100.0","100.0","null","2020","3","2020","2","06","30"
"2020-06-30","Agency","Federal Deposit Insurance Corporation","null","0","0","0","0","0","0","0.0","0.0","Non-CFO","2020","3","2020","2","06","30"
"2020-06-30","Bureau","Federal Deposit Insurance Corporation","Federal Deposit Insurance Corporation","0","0","0","0","0","0","0.0","0.0","null","2020","3","2020","2","06","30"
"2020-06-30","Agency","Federal Election Commission","null","604297","105","604297","105","0","0","100.0","100.0","Non-CFO","2020","3","2020","2","06","30"
"2020-06-30","Bureau","Federal Election Commission","Federal Election Commission","604297","105","604297","105","0","0","100.0","100.0","null","2020","3","2020","2","06","30"
"2020-06-30","Agency","Federal Labor Relations Authority","null","0","0","0","0","0","0","0.0","0.0","Non-CFO","2020","3","2020","2","06","30"
"2020-06-30","Bureau","Federal Labor Relations Authority","Federal Labor Relations Authority","0","0","0","0","0","0","0.0","0.0","null","2020","3","2020","2","06","30"
"2020-06-30","Agency","Federal Maritime Commission","null","390457","5","390457","5","0","0","100.0","100.0","Non-CFO","2020","3","2020","2","06","30"
"2020-06-30","Bureau","Federal Maritime Commission","Salaries and Expenses","390457","5","390457","5","0","0","100.0","100.0","null","2020","3","2020","2","06","30"
"2020-06-30","Agency","Federal Mediation/Conciliation Service","null","0","0","0","0","0","0","0.0","0.0","Non-CFO","2020","3","2020","2","06","30"
"2020-06-30","Bureau","Federal Mediation/Conciliation Service","Federal Mediation/Conciliation Service","0","0","0","0","0","0","0.0","0.0","null","2020","3","2020","2","06","30"
"2020-06-30","Agency","Federal Trade Commission","null","483073914","57","483073914","57","0","0","100.0","100.0","Non-CFO","2020","3","2020","2","06","30"
"2020-06-30","Bureau","Federal Trade Commission","Federal Trade Commission","483073914","57","483073914","57","0","0","100.0","100.0","null","2020","3","2020","2","06","30"
"2020-06-30","Agency","Funds Appropriated to the President","null","791105","4","0","0","791105","4","0.0","0.0","Non-CFO","2020","3","2020","2","06","30"
"2020-06-30","Bureau","Funds Appropriated to the President","African Development Foundation","0","0","0","0","0","0","0.0","0.0","null","2020","3","2020","2","06","30"
"2020-06-30","Bureau","Funds Appropriated to the President","Defense Security Assistance Agency","0","0","0","0","0","0","0.0","0.0","null","2020","3","2020","2","06","30"
"2020-06-30","Bureau","Funds Appropriated to the President","Executive Branch","0","0","0","0","0","0","0.0","0.0","null","2020","3","2020","2","06","30"
"2020-06-30","Bureau","Funds Appropriated to the President","Inter-American Foundation","0","0","0","0","0","0","0.0","0.0","null","2020","3","2020","2","06","30"
"2020-06-30","Bureau","Funds Appropriated to the President","Peace Corps","0","0","0","0","0","0","0.0","0.0","null","2020","3","2020","2","06","30"
"2020-06-30","Bureau","Funds Appropriated to the President","Trade and Development Agency","791105","4","0","0","791105","4","0.0","0.0","null","2020","3","2020","2","06","30"
"2020-06-30","Agency","General Services Administration","null","5921239","2437","4524016","1382","1397223","1055","76.40319872242955","56.70906852687731","CFO","2020","3","2020","2","06","30"
"2020-06-30","Bureau","General Services Administration","General Services Administration","5921239","2437","4524016","1382","1397223","1055","76.40319872242955","56.70906852687731","null","2020","3","2020","2","06","30"
"2020-06-30","Agency","Legis Branch-Library of Congress","null","0","0","0","0","0","0","0.0","0.0","Non-CFO","2020","3","2020","2","06","30"
"2020-06-30","Bureau","Legis Branch-Library of Congress","Library of Congress","0","0","0","0","0","0","0.0","0.0","null","2020","3","2020","2","06","30"
"2020-06-30","Agency","Legislative Branch - U.S. House/Senate","null","249325","187","0","0","249325","187","0.0","0.0","Non-CFO","2020","3","2020","2","06","30"
"2020-06-30","Bureau","Legislative Branch - U.S. House/Senate","U.S. House of Representatives","249325","187","0","0","249325","187","0.0","0.0","null","2020","3","2020","2","06","30"
"2020-06-30","Agency","Legislative Branch-CBO","null","0","0","0","0","0","0","0.0","0.0","Non-CFO","2020","3","2020","2","06","30"
"2020-06-30","Bureau","Legislative Branch-CBO","Congressional Budget Office","0","0","0","0","0","0","0.0","0.0","null","2020","3","2020","2","06","30"
"2020-06-30","Agency","Legislative Branch-GAO","null","0","0","0","0","0","0","0.0","0.0","Non-CFO","2020","3","2020","2","06","30"
"2020-06-30","Bureau","Legislative Branch-GAO","Government Accountability Office","0","0","0","0","0","0","0.0","0.0","null","2020","3","2020","2","06","30"
"2020-06-30","Agency","Legislative Branch-GPO","null","132867","50","0","0","132867","50","0.0","0.0","Non-CFO","2020","3","2020","2","06","30"
"2020-06-30","Bureau","Legislative Branch-GPO","Government Publishing Office","132867","50","0","0","132867","50","0.0","0.0","null","2020","3","2020","2","06","30"
"2020-06-30","Agency","Legislative Branch-Office of Tech.","null","0","0","0","0","0","0","0.0","0.0","Non-CFO","2020","3","2020","2","06","30"
"2020-06-30","Bureau","Legislative Branch-Office of Tech.","Medicaid & CHIP Payment & Access Comm.","0","0","0","0","0","0","0.0","0.0","null","2020","3","2020","2","06","30"
"2020-06-30","Bureau","Legislative Branch-Office of Tech.","Open World Leadership","0","0","0","0","0","0","0.0","0.0","null","2020","3","2020","2","06","30"
"2020-06-30","Agency","Merit Systems Protection Board","null","144","1","144","1","0","0","100.0","100.0","Non-CFO","2020","3","2020","2","06","30"
"2020-06-30","Bureau","Merit Systems Protection Board","Merit Systems Protection Board","144","1","144","1","0","0","100.0","100.0","null","2020","3","2020","2","06","30"
"2020-06-30","Agency","National Aeronautics and Space Administration","null","1242361","128","1242361","128","0","0","100.0","100.0","CFO","2020","3","2020","2","06","30"
"2020-06-30","Bureau","National Aeronautics and Space Administration","National Aeronautics and Space Admin","1242361","128","1242361","128","0","0","100.0","100.0","null","2020","3","2020","2","06","30"
"2020-06-30","Agency","National Archives & Records Admin","null","131952","106","130135","104","1817","2","98.62298411543591","98.11320754716981","Non-CFO","2020","3","2020","2","06","30"
"2020-06-30","Bureau","National Archives & Records Admin","Nat'l Archives & Records Administration","131952","106","130135","104","1817","2","98.62298411543591","98.11320754716981","null","2020","3","2020","2","06","30"
"2020-06-30","Agency","National Credit Union Administration","null","0","0","0","0","0","0","0.0","0.0","Non-CFO","2020","3","2020","2","06","30"
"2020-06-30","Bureau","National Credit Union Administration","National Credit Union Administration","0","0","0","0","0","0","0.0","0.0","null","2020","3","2020","2","06","30"
"2020-06-30","Agency","National Foundation  Arts & Humanities","null","0","0","0","0","0","0","0.0","0.0","Non-CFO","2020","3","2020","2","06","30"
"2020-06-30","Bureau","National Foundation  Arts & Humanities","National Endowment for the Arts","0","0","0","0","0","0","0.0","0.0","null","2020","3","2020","2","06","30"
"2020-06-30","Bureau","National Foundation  Arts & Humanities","National Endowment for the Humanities","0","0","0","0","0","0","0.0","0.0","null","2020","3","2020","2","06","30"
"2020-06-30","Agency","National Labor Relations Board","null","0","0","0","0","0","0","0.0","0.0","Non-CFO","2020","3","2020","2","06","30"
"2020-06-30","Bureau","National Labor Relations Board","National Labor Relations Board","0","0","0","0","0","0","0.0","0.0","null","2020","3","2020","2","06","30"
"2020-06-30","Agency","National Science Foundation","null","489553","86","489553","86","0","0","100.0","100.0","CFO","2020","3","2020","2","06","30"
"2020-06-30","Bureau","National Science Foundation","National Science Foundation","489553","86","489553","86","0","0","100.0","100.0","null","2020","3","2020","2","06","30"
"2020-06-30","Agency","Neighborhood Reinvestment Corporation","null","0","0","0","0","0","0","0.0","0.0","Non-CFO","2020","3","2020","2","06","30"
"2020-06-30","Bureau","Neighborhood Reinvestment Corporation","Neighborhood Reinvestment Corporation","0","0","0","0","0","0","0.0","0.0","null","2020","3","2020","2","06","30"
"2020-06-30","Agency","Nuclear Regulatory Commission","null","2409990","294","2367527","288","42463","6","98.23804248150407","97.95918367346938","CFO","2020","3","2020","2","06","30"
"2020-06-30","Bureau","Nuclear Regulatory Commission","Nuclear Regulatory Commission","2409990","294","2367527","288","42463","6","98.23804248150407","97.95918367346938","null","2020","3","2020","2","06","30"
"2020-06-30","Agency","Occupational Safety & Health Rev Comm","null","0","0","0","0","0","0","0.0","0.0","Non-CFO","2020","3","2020","2","06","30"
"2020-06-30","Bureau","Occupational Safety & Health Rev Comm","Occupational Safety & Health Rev Comm","0","0","0","0","0","0","0.0","0.0","null","2020","3","2020","2","06","30"
"2020-06-30","Agency","Office of Compliance","null","0","0","0","0","0","0","0.0","0.0","Non-CFO","2020","3","2020","2","06","30"
"2020-06-30","Bureau","Office of Compliance","Office of Compliance","0","0","0","0","0","0","0.0","0.0","null","2020","3","2020","2","06","30"
"2020-06-30","Agency","Office of Government Ethics","null","0","0","0","0","0","0","0.0","0.0","Non-CFO","2020","3","2020","2","06","30"
"2020-06-30","Bureau","Office of Government Ethics","Office of Government Ethics","0","0","0","0","0","0","0.0","0.0","null","2020","3","2020","2","06","30"
"2020-06-30","Agency","Office of Personnel Management","null","24738036","1577","22625179","1347","2112857","230","91.45907540922003","85.4153455928979","CFO","2020","3","2020","2","06","30"
"2020-06-30","Bureau","Office of Personnel Management","Office of Personnel Management","24738036","1577","22625179","1347","2112857","230","91.45907540922003","85.4153455928979","null","2020","3","2020","2","06","30"
"2020-06-30","Agency","Office of Special Counsel","null","0","0","0","0","0","0","0.0","0.0","Non-CFO","2020","3","2020","2","06","30"
"2020-06-30","Bureau","Office of Special Counsel","Office of Special Counsel","0","0","0","0","0","0","0.0","0.0","null","2020","3","2020","2","06","30"
"2020-06-30","Agency","Other Agencies","null","5750600","110","5475","3","5745125","107","0.09520745661322297","2.727272727272727","Non-CFO","2020","3","2020","2","06","30"
"2020-06-30","Bureau","Other Agencies","Advisory Council on Hist. Preservation","0","0","0","0","0","0","0.0","0.0","null","2020","3","2020","2","06","30"
"2020-06-30","Bureau","Other Agencies","Archit.&Trans. Barriers Compliance Bd","809","1","0","0","809","1","0.0","0.0","null","2020","3","2020","2","06","30"
"2020-06-30","Bureau","Other Agencies","Architect of the Capitol","0","0","0","0","0","0","0.0","0.0","null","2020","3","2020","2","06","30"
"2020-06-30","Bureau","Other Agencies","Chemical Safety Board","0","0","0","0","0","0","0.0","0.0","null","2020","3","2020","2","06","30"
"2020-06-30","Bureau","Other Agencies","Comm. for Purchase from Blind/Handic.","0","0","0","0","0","0","0.0","0.0","null","2020","3","2020","2","06","30"
"2020-06-30","Bureau","Other Agencies","Commission On Fine Arts","0","0","0","0","0","0","0.0","0.0","null","2020","3","2020","2","06","30"
"2020-06-30","Bureau","Other Agencies","Consumer Financial Protection Bureau","5510394","68","0","0","5510394","68","0.0","0.0","null","2020","3","2020","2","06","30"
"2020-06-30","Bureau","Other Agencies","Council of Insps. Gen. of Intg. & Effy.","3600","6","0","0","3600","6","0.0","0.0","null","2020","3","2020","2","06","30"
"2020-06-30","Bureau","Other Agencies","Defense Nuclear Facilities Safety Board","0","0","0","0","0","0","0.0","0.0","null","2020","3","2020","2","06","30"
"2020-06-30","Bureau","Other Agencies","Delta Regional Authority","0","0","0","0","0","0","0.0","0.0","null","2020","3","2020","2","06","30"
"2020-06-30","Bureau","Other Agencies","Denali Commission","0","0","0","0","0","0","0.0","0.0","null","2020","3","2020","2","06","30"
"2020-06-30","Bureau","Other Agencies","District of Columbia Government","0","0","0","0","0","0","0.0","0.0","null","2020","3","2020","2","06","30"
"2020-06-30","Bureau","Other Agencies","Election Assistance Commission","0","0","0","0","0","0","0.0","0.0","null","2020","3","2020","2","06","30"
"2020-06-30","Bureau","Other Agencies","Federal Housing Finance Agency","0","0","0","0","0","0","0.0","0.0","null","2020","3","2020","2","06","30"
"2020-06-30","Bureau","Other Agencies","Federal Housing Finance Agency OIG","0","0","0","0","0","0","0.0","0.0","null","2020","3","2020","2","06","30"
"2020-06-30","Bureau","Other Agencies","Federal Mine Safety & Health Review Comm","0","0","0","0","0","0","0.0","0.0","null","2020","3","2020","2","06","30"
"2020-06-30","Bureau","Other Agencies","Gulf Coast Ecosystem Restoration Council","0","0","0","0","0","0","0.0","0.0","null","2020","3","2020","2","06","30"
"2020-06-30","Bureau","Other Agencies","James Madison Memorial Fellowship","221291","25","0","0","221291","25","0.0","0.0","null","2020","3","2020","2","06","30"
"2020-06-30","Bureau","Other Agencies","John C. Stennis","1467","2","0","0","1467","2","0.0","0.0","null","2020","3","2020","2","06","30"
"2020-06-30","Bureau","Other Agencies","Millennium Challenge Corporation","545","1","545","1","0","0","100.0","100.0","null","2020","3","2020","2","06","30"
"2020-06-30","Bureau","Other Agencies","Morris K. Udall Scholarship","982","1","0","0","982","1","0.0","0.0","null","2020","3","2020","2","06","30"
"2020-06-30","Bureau","Other Agencies","National Capital Planning Commission","0","0","0","0","0","0","0.0","0.0","null","2020","3","2020","2","06","30"
"2020-06-30","Bureau","Other Agencies","National Council on Disability","1579","2","0","0","1579","2","0.0","0.0","null","2020","3","2020","2","06","30"
"2020-06-30","Bureau","Other Agencies","National Mediation Board","0","0","0","0","0","0","0.0","0.0","null","2020","3","2020","2","06","30"
"2020-06-30","Bureau","Other Agencies","National Transportation Safety Board","0","0","0","0","0","0","0.0","0.0","null","2020","3","2020","2","06","30"
"2020-06-30","Bureau","Other Agencies","Privacy & Civil Liberties Oversight Bd","0","0","0","0","0","0","0.0","0.0","null","2020","3","2020","2","06","30"
"2020-06-30","Bureau","Other Agencies","Surface Transportation Board","0","0","0","0","0","0","0.0","0.0","null","2020","3","2020","2","06","30"
"2020-06-30","Bureau","Other Agencies","U.S.  Agency of Global Media","4930","2","4930","2","0","0","100.0","100.0","null","2020","3","2020","2","06","30"
"2020-06-30","Bureau","Other Agencies","U.S. Holocaust Memorial Council","0","0","0","0","0","0","0.0","0.0","null","2020","3","2020","2","06","30"
"2020-06-30","Bureau","Other Agencies","U.S. Inst. for Env. Conflict Resolution","5003","2","0","0","5003","2","0.0","0.0","null","2020","3","2020","2","06","30"
"2020-06-30","Bureau","Other Agencies","U.S. Institute of Peace","0","0","0","0","0","0","0.0","0.0","null","2020","3","2020","2","06","30"
"2020-06-30","Agency","Other Agencies/Boards/Commissions","null","1083","2","0","0","1083","2","0.0","0.0","Non-CFO","2020","3","2020","2","06","30"
"2020-06-30","Bureau","Other Agencies/Boards/Commissions","Medicare Payment Advisory Commission","0","0","0","0","0","0","0.0","0.0","null","2020","3","2020","2","06","30"
"2020-06-30","Bureau","Other Agencies/Boards/Commissions","U.S. Comm. on Int. Religious Freedom","1083","2","0","0","1083","2","0.0","0.0","null","2020","3","2020","2","06","30"
"2020-06-30","Bureau","Other Agencies/Boards/Commissions","U.S.-China Security Review Commission","0","0","0","0","0","0","0.0","0.0","null","2020","3","2020","2","06","30"
"2020-06-30","Agency","Overseas Private Investment Corp Accts","null","0","0","0","0","0","0","0.0","0.0","Non-CFO","2020","3","2020","2","06","30"
"2020-06-30","Bureau","Overseas Private Investment Corp Accts","Overseas Private Investment Corp Accts","0","0","0","0","0","0","0.0","0.0","null","2020","3","2020","2","06","30"
"2020-06-30","Agency","Pension Benefit Guaranty Corp","null","3920900","1620","3920900","1620","0","0","100.0","100.0","Non-CFO","2020","3","2020","2","06","30"
"2020-06-30","Bureau","Pension Benefit Guaranty Corp","Pension Benefit Guaranty Corporation","3920900","1620","3920900","1620","0","0","100.0","100.0","null","2020","3","2020","2","06","30"
"2020-06-30","Agency","Presidio Trust Corporation","null","1497550","85","1433055","78","64495","7","95.69329905512336","91.76470588235294","Non-CFO","2020","3","2020","2","06","30"
"2020-06-30","Bureau","Presidio Trust Corporation","Presidio Trust Corporation","1497550","85","1433055","78","64495","7","95.69329905512336","91.76470588235294","null","2020","3","2020","2","06","30"
"2020-06-30","Agency","Railroad Retirement Board","null","21736838","4387","21736838","4387","0","0","100.0","100.0","Non-CFO","2020","3","2020","2","06","30"
"2020-06-30","Bureau","Railroad Retirement Board","Railroad Retirement Board","21736838","4387","21736838","4387","0","0","100.0","100.0","null","2020","3","2020","2","06","30"
"2020-06-30","Agency","Securities & Exchange Commission","null","2090300273","1072","2090300273","1072","0","0","100.0","100.0","Non-CFO","2020","3","2020","2","06","30"
"2020-06-30","Bureau","Securities & Exchange Commission","SEC Enforcement","2089990982","1015","2089990982","1015","0","0","100.0","100.0","null","2020","3","2020","2","06","30"
"2020-06-30","Bureau","Securities & Exchange Commission","Securities and Exchange Commission","309291","57","309291","57","0","0","100.0","100.0","null","2020","3","2020","2","06","30"
"2020-06-30","Agency","Selective Service System","null","0","0","0","0","0","0","0.0","0.0","Non-CFO","2020","3","2020","2","06","30"
"2020-06-30","Bureau","Selective Service System","Selective Service System","0","0","0","0","0","0","0.0","0.0","null","2020","3","2020","2","06","30"
"2020-06-30","Agency","Small Business Administration","null","12345902479","120727","12345902479","120727","0","0","100.0","100.0","CFO","2020","3","2020","2","06","30"
"2020-06-30","Bureau","Small Business Administration","Small Business Administration","12345902479","120727","12345902479","120727","0","0","100.0","100.0","null","2020","3","2020","2","06","30"
"2020-06-30","Agency","Smithsonian Institution","null","9780","2","0","0","9780","2","0.0","0.0","Non-CFO","2020","3","2020","2","06","30"
"2020-06-30","Bureau","Smithsonian Institution","Administrative Conference of the US","0","0","0","0","0","0","0.0","0.0","null","2020","3","2020","2","06","30"
"2020-06-30","Bureau","Smithsonian Institution","JFK Center for the Performing Arts","0","0","0","0","0","0","0.0","0.0","null","2020","3","2020","2","06","30"
"2020-06-30","Bureau","Smithsonian Institution","National Gallery of Art","0","0","0","0","0","0","0.0","0.0","null","2020","3","2020","2","06","30"
"2020-06-30","Bureau","Smithsonian Institution","Smithsonian Institution","9780","2","0","0","9780","2","0.0","0.0","null","2020","3","2020","2","06","30"
"2020-06-30","Agency","Social Security Administration","null","5539986918","1691467","2957284963","516104","2582701955","1175363","53.380721051731555","30.512212180314485","CFO","2020","3","2020","2","06","30"
"2020-06-30","Bureau","Social Security Administration","Social Security Administration","5539986918","1691467","2957284963","516104","2582701955","1175363","53.380721051731555","30.512212180314485","null","2020","3","2020","2","06","30"
"2020-06-30","Agency","Tennessee Valley Authority","null","0","0","0","0","0","0","0.0","0.0","Non-CFO","2020","3","2020","2","06","30"
"2020-06-30","Bureau","Tennessee Valley Authority","Tennessee Valley Authority","0","0","0","0","0","0","0.0","0.0","null","2020","3","2020","2","06","30"
"2020-06-30","Agency","The Judiciary","null","1142527","323","1034021","192","108506","131","90.5029815487949","59.44272445820433","Non-CFO","2020","3","2020","2","06","30"
"2020-06-30","Bureau","The Judiciary","Administrative Office of the U.S. Courts","1142527","323","1034021","192","108506","131","90.5029815487949","59.44272445820433","null","2020","3","2020","2","06","30"
"2020-06-30","Agency","U.S. Court of Appeals / Veterans Claims","null","170","1","170","1","0","0","100.0","100.0","Non-CFO","2020","3","2020","2","06","30"
"2020-06-30","Bureau","U.S. Court of Appeals / Veterans Claims","U.S. Court of Appeals / Veterans Claims","170","1","170","1","0","0","100.0","100.0","null","2020","3","2020","2","06","30"
"2020-06-30","Agency","U.S. Postal Service","null","76067203","61419","43652705","50070","32414498","11349","57.387025259756165","81.52200459141308","Non-CFO","2020","3","2020","2","06","30"
"2020-06-30","Bureau","U.S. Postal Service","U.S. Postal Service","76067203","61419","43652705","50070","32414498","11349","57.387025259756165","81.52200459141308","null","2020","3","2020","2","06","30"
"2020-06-30","Agency","US International Development Fin. Corp.","null","0","0","0","0","0","0","0.0","0.0","Non-CFO","2020","3","2020","2","06","30"
"2020-06-30","Bureau","US International Development Fin. Corp.","US International Development Fin. Corp.","0","0","0","0","0","0","0.0","0.0","null","2020","3","2020","2","06","30"
"2020-03-31","Agency","Agency for International Development","null","26764493","47","26764493","47","0","0","100.0","100.0","CFO","2020","2","2020","1","03","31"
"2020-03-31","Bureau","Agency for International Development","Agency for International Development","26764493","47","26764493","47","0","0","100.0","100.0","null","2020","2","2020","1","03","31"
"2020-03-31","Agency","American Battle Monuments Commission","null","0","0","0","0","0","0","0.0","0.0","Non-CFO","2020","2","2020","1","03","31"
"2020-03-31","Bureau","American Battle Monuments Commission","American Battle Monuments Commission","0","0","0","0","0","0","0.0","0.0","null","2020","2","2020","1","03","31"
"2020-03-31","Agency","Armed Forces Retirement Home","null","79497","105","79497","105","0","0","100.0","100.0","Non-CFO","2020","2","2020","1","03","31"
"2020-03-31","Bureau","Armed Forces Retirement Home","Armed Forces Retirement Home","79497","105","79497","105","0","0","100.0","100.0","null","2020","2","2020","1","03","31"
"2020-03-31","Agency","Commodity Futures Trading Commission","null","644465590","366","644465590","366","0","0","100.0","100.0","Non-CFO","2020","2","2020","1","03","31"
"2020-03-31","Bureau","Commodity Futures Trading Commission","Commodity Futures Trading Commission","644465590","366","644465590","366","0","0","100.0","100.0","null","2020","2","2020","1","03","31"
"2020-03-31","Agency","Consumer Product Safety Commission","null","479","1","479","1","0","0","100.0","100.0","Non-CFO","2020","2","2020","1","03","31"
"2020-03-31","Bureau","Consumer Product Safety Commission","Consumer Product Safety Commission","479","1","479","1","0","0","100.0","100.0","null","2020","2","2020","1","03","31"
"2020-03-31","Agency","Corp. for National and Community Service","null","4673335","1361","3587379","155","1085956","1206","76.76271870088492","11.38868479059515","Non-CFO","2020","2","2020","1","03","31"
"2020-03-31","Bureau","Corp. for National and Community Service","Corp. for National and Community Service","4673335","1361","3587379","155","1085956","1206","76.76271870088492","11.38868479059515","null","2020","2","2020","1","03","31"
"2020-03-31","Agency","Department of Agriculture","null","1564922373","56876","1556288096","54634","8634277","2242","99.44826164230447","96.05809128630706","CFO","2020","2","2020","1","03","31"
"2020-03-31","Bureau","Department of Agriculture","Agricultural Marketing Service","5567351","1000","5040187","544","527164","456","90.5311520685511","54.4","null","2020","2","2020","1","03","31"
"2020-03-31","Bureau","Department of Agriculture","Commodity Credit Corporation","131547623","10741","131547623","10741","0","0","100.0","100.0","null","2020","2","2020","1","03","31"
"2020-03-31","Bureau","Department of Agriculture","Farm Service Agency","638495089","10751","638495089","10751","0","0","100.0","100.0","null","2020","2","2020","1","03","31"
"2020-03-31","Bureau","Department of Agriculture","Federal Crop Insurance Corporation","48964","436","48964","436","0","0","100.0","100.0","null","2020","2","2020","1","03","31"
"2020-03-31","Bureau","Department of Agriculture","Food Safety and Inspection Service","848056","1275","846223","1273","1833","2","99.78385861311045","99.84313725490196","null","2020","2","2020","1","03","31"
"2020-03-31","Bureau","Department of Agriculture","Food and Nutrition Service","963822","39","47983","6","915839","33","4.978408876327786","15.384615384615385","null","2020","2","2020","1","03","31"
"2020-03-31","Bureau","Department of Agriculture","Forest Service","63628855","768","60992330","299","2636525","469","95.85640037055515","38.932291666666664","null","2020","2","2020","1","03","31"
"2020-03-31","Bureau","Department of Agriculture","Rural Development","693233003","28831","693228377","28826","4626","5","99.99933269189724","99.98265755610281","null","2020","2","2020","1","03","31"
"2020-03-31","Bureau","Department of Agriculture","U.S. Department of Agriculture","30589610","3035","26041320","1758","4548290","1277","85.13125862016547","57.924217462932454","null","2020","2","2020","1","03","31"
"2020-03-31","Agency","Department of Commerce","null","23915349","1419","23915349","1419","0","0","100.0","100.0","CFO","2020","2","2020","1","03","31"
"2020-03-31","Bureau","Department of Commerce","Bureau of Industry and Security","1791313","16","1791313","16","0","0","100.0","100.0","null","2020","2","2020","1","03","31"
"2020-03-31","Bureau","Department of Commerce","Bureau of the Census","185976","183","185976","183","0","0","100.0","100.0","null","2020","2","2020","1","03","31"
"2020-03-31","Bureau","Department of Commerce","Economic Development Administration","5093108","9","5093108","9","0","0","100.0","100.0","null","2020","2","2020","1","03","31"
"2020-03-31","Bureau","Department of Commerce","Economic and Statistical Analysis","0","0","0","0","0","0","0.0","0.0","null","2020","2","2020","1","03","31"
"2020-03-31","Bureau","Department of Commerce","General Administration","4660","1","4660","1","0","0","100.0","100.0","null","2020","2","2020","1","03","31"
"2020-03-31","Bureau","Department of Commerce","International Trade Administration","0","0","0","0","0","0","0.0","0.0","null","2020","2","2020","1","03","31"
"2020-03-31","Bureau","Department of Commerce","Minority Business Development Agency","0","0","0","0","0","0","0.0","0.0","null","2020","2","2020","1","03","31"
"2020-03-31","Bureau","Department of Commerce","NOAA","15432599","704","15432599","704","0","0","100.0","100.0","null","2020","2","2020","1","03","31"
"2020-03-31","Bureau","Department of Commerce","Nat'l Institute of Standards& Technology","670558","5","670558","5","0","0","100.0","100.0","null","2020","2","2020","1","03","31"
"2020-03-31","Bureau","Department of Commerce","Nat'l Telecomm & Information Admin.","296093","1","296093","1","0","0","100.0","100.0","null","2020","2","2020","1","03","31"
"2020-03-31","Bureau","Department of Commerce","National Technical Information Service","0","0","0","0","0","0","0.0","0.0","null","2020","2","2020","1","03","31"
"2020-03-31","Bureau","Department of Commerce","Office of the Inspector General","0","0","0","0","0","0","0.0","0.0","null","2020","2","2020","1","03","31"
"2020-03-31","Bureau","Department of Commerce","Patent and Trademark Office","441042","500","441042","500","0","0","100.0","100.0","null","2020","2","2020","1","03","31"
"2020-03-31","Agency","Department of Defense","null","2332641944","1276881","1126183858","298687","1206458086","978194","48.27932811963532","23.391921408494603","CFO","2020","2","2020","1","03","31"
"2020-03-31","Bureau","Department of Defense","Consolidated Report","2332641944","1276881","1126183858","298687","1206458086","978194","48.27932811963532","23.391921408494603","null","2020","2","2020","1","03","31"
"2020-03-31","Agency","Department of Education","null","156401693820","27417789","141492685788","23935408","14909008032","3482381","90.46748940637528","87.29882632038637","CFO","2020","2","2020","1","03","31"
"2020-03-31","Bureau","Department of Education","Departmental Management","890859267","2103","728388695","1789","162470572","314","81.76248729531373","85.06894912030432","null","2020","2","2020","1","03","31"
"2020-03-31","Bureau","Department of Education","Federal Student Aid","155510834553","27415686","140764297093","23933619","14746537460","3482067","90.51735687588108","87.29899736960805","null","2020","2","2020","1","03","31"
"2020-03-31","Bureau","Department of Education","Office of Postsecondary Education","0","0","0","0","0","0","0.0","0.0","null","2020","2","2020","1","03","31"
"2020-03-31","Agency","Department of Energy","null","15251116","114","15251116","114","0","0","100.0","100.0","CFO","2020","2","2020","1","03","31"
"2020-03-31","Bureau","Department of Energy","Bonneville Power Administration","1100045","39","1100045","39","0","0","100.0","100.0","null","2020","2","2020","1","03","31"
"2020-03-31","Bureau","Department of Energy","Energy Consolidated Reports","14151071","75","14151071","75","0","0","100.0","100.0","null","2020","2","2020","1","03","31"
"2020-03-31","Agency","Department of Health & Human Services","null","9848934011","1186851","9674597875","1163067","174336136","23784","98.2298984255018","97.99604162611818","CFO","2020","2","2020","1","03","31"
"2020-03-31","Bureau","Department of Health & Human Services","Administration for Children and Families","28904080","1700","28904080","1700","0","0","100.0","100.0","null","2020","2","2020","1","03","31"
"2020-03-31","Bureau","Department of Health & Human Services","Administration for Community Living","0","0","0","0","0","0","0.0","0.0","null","2020","2","2020","1","03","31"
"2020-03-31","Bureau","Department of Health & Human Services","Centers for Disease Control","7132012","170","70935","14","7061077","156","0.9946001212561055","8.235294117647058","null","2020","2","2020","1","03","31"
"2020-03-31","Bureau","Department of Health & Human Services","Centers for Medicare & Medicaid Services","9557901587","1169460","9487226248","1158997","70675339","10463","99.2605559038594","99.10531356352504","null","2020","2","2020","1","03","31"
"2020-03-31","Bureau","Department of Health & Human Services","Food and Drug Administration","93473865","10561","31811026","1030","61662839","9531","34.03200028157603","9.752864312091658","null","2020","2","2020","1","03","31"
"2020-03-31","Bureau","Department of Health & Human Services","Health Resources and Services Admin","87441932","541","87441932","541","0","0","100.0","100.0","null","2020","2","2020","1","03","31"
"2020-03-31","Bureau","Department of Health & Human Services","Indian Health Services","54845916","3500","26990350","179","27855566","3321","49.21123024000547","5.114285714285714","null","2020","2","2020","1","03","31"
"2020-03-31","Bureau","Department of Health & Human Services","National Institutes of Health","12665386","409","5584071","96","7081315","313","44.0892287057023","23.4718826405868","null","2020","2","2020","1","03","31"
"2020-03-31","Bureau","Department of Health & Human Services","Office of the Inspector General","0","0","0","0","0","0","0.0","0.0","null","2020","2","2020","1","03","31"
"2020-03-31","Bureau","Department of Health & Human Services","Office of the Secretary","3290","7","3290","7","0","0","100.0","100.0","null","2020","2","2020","1","03","31"
"2020-03-31","Bureau","Department of Health & Human Services","Program Support Center","5584227","489","5584227","489","0","0","100.0","100.0","null","2020","2","2020","1","03","31"
"2020-03-31","Bureau","Department of Health & Human Services","Substance Abuse & Mental Health Admin.","981716","14","981716","14","0","0","100.0","100.0","null","2020","2","2020","1","03","31"
"2020-03-31","Agency","Department of Homeland Security","null","371796552","62866","371775729","62841","20823","25","99.99439935634476","99.96023287627652","CFO","2020","2","2020","1","03","31"
"2020-03-31","Bureau","Department of Homeland Security","Bureau of Customs & Border Protection","8668902","605","8668902","605","0","0","100.0","100.0","null","2020","2","2020","1","03","31"
"2020-03-31","Bureau","Department of Homeland Security","Citizenship and Immigration Services","1013415","1232","1013415","1232","0","0","100.0","100.0","null","2020","2","2020","1","03","31"
"2020-03-31","Bureau","Department of Homeland Security","Domestic Nuclear Detection Office","0","0","0","0","0","0","0.0","0.0","null","2020","2","2020","1","03","31"
"2020-03-31","Bureau","Department of Homeland Security","Emergency Preparedness & Resp","258464040","42918","258464040","42918","0","0","100.0","100.0","null","2020","2","2020","1","03","31"
"2020-03-31","Bureau","Department of Homeland Security","Federal Law Enforcement Training Ctr.","0","0","0","0","0","0","0.0","0.0","null","2020","2","2020","1","03","31"
"2020-03-31","Bureau","Department of Homeland Security","Immigration and Customs Enforcement","10369911","448","10369911","448","0","0","100.0","100.0","null","2020","2","2020","1","03","31"
"2020-03-31","Bureau","Department of Homeland Security","Info Analysis Infrastructure Prot-NPPD","0","0","0","0","0","0","0.0","0.0","null","2020","2","2020","1","03","31"
"2020-03-31","Bureau","Department of Homeland Security","Management Headquarters","0","0","0","0","0","0","0.0","0.0","null","2020","2","2020","1","03","31"
"2020-03-31","Bureau","Department of Homeland Security","Office of Biometric Identity Management","0","0","0","0","0","0","0.0","0.0","null","2020","2","2020","1","03","31"
"2020-03-31","Bureau","Department of Homeland Security","Office of Health Affairs","0","0","0","0","0","0","0.0","0.0","null","2020","2","2020","1","03","31"
"2020-03-31","Bureau","Department of Homeland Security","Office of the Inspector General DHS","99","1","99","1","0","0","100.0","100.0","null","2020","2","2020","1","03","31"
"2020-03-31","Bureau","Department of Homeland Security","Science and Technology","0","0","0","0","0","0","0.0","0.0","null","2020","2","2020","1","03","31"
"2020-03-31","Bureau","Department of Homeland Security","Transportation Safety Administration","8132648","6224","8132648","6224","0","0","100.0","100.0","null","2020","2","2020","1","03","31"
"2020-03-31","Bureau","Department of Homeland Security","U.S. Coast Guard","85147537","11438","85126714","11413","20823","25","99.97554480055014","99.78143031998601","null","2020","2","2020","1","03","31"
"2020-03-31","Bureau","Department of Homeland Security","U.S. Secret Service","0","0","0","0","0","0","0.0","0.0","null","2020","2","2020","1","03","31"
"2020-03-31","Agency","Department of Housing and Urban Development","null","169747885","6376","169747883","6373","2","3","99.99999882178209","99.95294855708909","CFO","2020","2","2020","1","03","31"
"2020-03-31","Bureau","Department of Housing and Urban Development","Community Planning and Development","0","0","0","0","0","0","0.0","0.0","null","2020","2","2020","1","03","31"
"2020-03-31","Bureau","Department of Housing and Urban Development","Government National Mortgage Association","19","4","17","1","2","3","89.47368421052632","25.0","null","2020","2","2020","1","03","31"
"2020-03-31","Bureau","Department of Housing and Urban Development","Housing Programs","169747302","6371","169747302","6371","0","0","100.0","100.0","null","2020","2","2020","1","03","31"
"2020-03-31","Bureau","Department of Housing and Urban Development","Management and Administration","0","0","0","0","0","0","0.0","0.0","null","2020","2","2020","1","03","31"
"2020-03-31","Bureau","Department of Housing and Urban Development","Policy, Development and Research","0","0","0","0","0","0","0.0","0.0","null","2020","2","2020","1","03","31"
"2020-03-31","Bureau","Department of Housing and Urban Development","Public and Indian Housing Programs","564","1","564","1","0","0","100.0","100.0","null","2020","2","2020","1","03","31"
"2020-03-31","Agency","Department of Justice","null","89478774","37592","89066928","37393","411846","199","99.53972771240697","99.47063204937221","CFO","2020","2","2020","1","03","31"
"2020-03-31","Bureau","Department of Justice","Bureau of ATF and Explosives","20885","4","20885","4","0","0","100.0","100.0","null","2020","2","2020","1","03","31"
"2020-03-31","Bureau","Department of Justice","Drug Enforcement Administration","322469","20","322469","20","0","0","100.0","100.0","null","2020","2","2020","1","03","31"
"2020-03-31","Bureau","Department of Justice","Federal Bureau of Investigation","234612","65","234612","65","0","0","100.0","100.0","null","2020","2","2020","1","03","31"
"2020-03-31","Bureau","Department of Justice","Federal Prison Industries","1043089","183","1043089","183","0","0","100.0","100.0","null","2020","2","2020","1","03","31"
"2020-03-31","Bureau","Department of Justice","Federal Prison System","839812","119","839812","119","0","0","100.0","100.0","null","2020","2","2020","1","03","31"
"2020-03-31","Bureau","Department of Justice","General Administration","0","0","0","0","0","0","0.0","0.0","null","2020","2","2020","1","03","31"
"2020-03-31","Bureau","Department of Justice","Legal Activities","86999403","37200","86587557","37001","411846","199","99.52661054467235","99.46505376344086","null","2020","2","2020","1","03","31"
"2020-03-31","Bureau","Department of Justice","Office of Justice Assistance Programs","18504","1","18504","1","0","0","100.0","100.0","null","2020","2","2020","1","03","31"
"2020-03-31","Bureau","Department of Justice","U.S. Marshals Service","0","0","0","0","0","0","0.0","0.0","null","2020","2","2020","1","03","31"
"2020-03-31","Agency","Department of Labor","null","143537315","36962","117264720","17120","26272595","19842","81.69633102026467","46.317839943725986","CFO","2020","2","2020","1","03","31"
"2020-03-31","Bureau","Department of Labor","Bureau of Labor Statistics","11381","1","11381","1","0","0","100.0","100.0","null","2020","2","2020","1","03","31"
"2020-03-31","Bureau","Department of Labor","Departmental Management","0","0","0","0","0","0","0.0","0.0","null","2020","2","2020","1","03","31"
"2020-03-31","Bureau","Department of Labor","Employee Benefit Security Administration","16580156","374","16580156","374","0","0","100.0","100.0","null","2020","2","2020","1","03","31"
"2020-03-31","Bureau","Department of Labor","Employment Standards Administration","77027741","20748","57247485","2829","19780256","17919","74.32060742895213","13.63504916136495","null","2020","2","2020","1","03","31"
"2020-03-31","Bureau","Department of Labor","Employment and Training Administration","4434001","21","4294001","20","140000","1","96.84258077524115","95.23809523809524","null","2020","2","2020","1","03","31"
"2020-03-31","Bureau","Department of Labor","Mine Safety and Health Administration","36054803","14612","31044715","13433","5010088","1179","86.10424247776365","91.93128935121818","null","2020","2","2020","1","03","31"
"2020-03-31","Bureau","Department of Labor","Occupational Safety and Health Admin","9429233","1206","8086982","463","1342251","743","85.76500336771825","38.391376451077946","null","2020","2","2020","1","03","31"
"2020-03-31","Agency","Department of State","null","16334222","23921","16275805","23894","58417","27","99.64236435625767","99.88712846452907","CFO","2020","2","2020","1","03","31"
"2020-03-31","Bureau","Department of State","Civil Monetary Penalties","0","0","0","0","0","0","0.0","0.0","null","2020","2","2020","1","03","31"
"2020-03-31","Bureau","Department of State","Department of State","13687251","6894","13628834","6867","58417","27","99.57320136819293","99.60835509138381","null","2020","2","2020","1","03","31"
"2020-03-31","Bureau","Department of State","International Commissions","0","0","0","0","0","0","0.0","0.0","null","2020","2","2020","1","03","31"
"2020-03-31","Bureau","Department of State","Passport NSF","2646971","17027","2646971","17027","0","0","100.0","100.0","null","2020","2","2020","1","03","31"
"2020-03-31","Agency","Department of Transportation","null","61285588","7009","61242842","6993","42746","16","99.93025113832635","99.7717220716222","CFO","2020","2","2020","1","03","31"
"2020-03-31","Bureau","Department of Transportation","Federal Aviation Administration","2177871","328","2135184","313","42687","15","98.03996655449289","95.42682926829268","null","2020","2","2020","1","03","31"
"2020-03-31","Bureau","Department of Transportation","Federal Highway Administration","325053","6","325053","6","0","0","100.0","100.0","null","2020","2","2020","1","03","31"
"2020-03-31","Bureau","Department of Transportation","Federal Motor Carrier Safety Admin","56546542","6607","56546483","6606","59","1","99.99989566117058","99.98486453761163","null","2020","2","2020","1","03","31"
"2020-03-31","Bureau","Department of Transportation","Federal Railroad Administration","165274","15","165274","15","0","0","100.0","100.0","null","2020","2","2020","1","03","31"
"2020-03-31","Bureau","Department of Transportation","Federal Transit Administration","784479","2","784479","2","0","0","100.0","100.0","null","2020","2","2020","1","03","31"
"2020-03-31","Bureau","Department of Transportation","Maritime Administration","2816","4","2816","4","0","0","100.0","100.0","null","2020","2","2020","1","03","31"
"2020-03-31","Bureau","Department of Transportation","National Highway Traffic Safety Admin.","18828","4","18828","4","0","0","100.0","100.0","null","2020","2","2020","1","03","31"
"2020-03-31","Bureau","Department of Transportation","Office of the Inspector General","207","1","207","1","0","0","100.0","100.0","null","2020","2","2020","1","03","31"
"2020-03-31","Bureau","Department of Transportation","Office of the Secretary","910849","15","910849","15","0","0","100.0","100.0","null","2020","2","2020","1","03","31"
"2020-03-31","Bureau","Department of Transportation","Pipeline Hazardous Material Safety Admin","345573","23","345573","23","0","0","100.0","100.0","null","2020","2","2020","1","03","31"
"2020-03-31","Bureau","Department of Transportation","Research Innovative Technology Admin","3753","3","3753","3","0","0","100.0","100.0","null","2020","2","2020","1","03","31"
"2020-03-31","Bureau","Department of Transportation","St. Lawrence Seaway Development Corp.","4343","1","4343","1","0","0","100.0","100.0","null","2020","2","2020","1","03","31"
"2020-03-31","Bureau","Department of Transportation","Surface Transportation Board","0","0","0","0","0","0","0.0","0.0","null","2020","2","2020","1","03","31"
"2020-03-31","Agency","Department of Veterans Affairs","null","1211685037","9258612","1057797115","9157735","153887922","100877","87.29967629368358","98.91045223625312","CFO","2020","2","2020","1","03","31"
"2020-03-31","Bureau","Department of Veterans Affairs","Administration and Cemeteries","2285317","727","0","0","2285317","727","0.0","0.0","null","2020","2","2020","1","03","31"
"2020-03-31","Bureau","Department of Veterans Affairs","Housing Credit Assistance","2126807","81","426079","32","1700728","49","20.03374072024401","39.50617283950617","null","2020","2","2020","1","03","31"
"2020-03-31","Bureau","Department of Veterans Affairs","Life Insurance","616575","120","616575","120","0","0","100.0","100.0","null","2020","2","2020","1","03","31"
"2020-03-31","Bureau","Department of Veterans Affairs","Medical and Construction","689977207","9147384","541364690","9048973","148612517","98411","78.46124256101695","98.92416236161071","null","2020","2","2020","1","03","31"
"2020-03-31","Bureau","Department of Veterans Affairs","Veterans Benefits","516679131","110300","515389771","108610","1289360","1690","99.75045247182628","98.467815049864","null","2020","2","2020","1","03","31"
"2020-03-31","Agency","Department of the Interior","null","45558823","31365","45542002","31324","16821","41","99.96307850183048","99.86928104575163","CFO","2020","2","2020","1","03","31"
"2020-03-31","Bureau","Department of the Interior","Bureau of Indian Affairs","17610616","28249","17593795","28208","16821","41","99.90448375002896","99.85486211901306","null","2020","2","2020","1","03","31"
"2020-03-31","Bureau","Department of the Interior","Bureau of Land Management","15651489","295","15651489","295","0","0","100.0","100.0","null","2020","2","2020","1","03","31"
"2020-03-31","Bureau","Department of the Interior","Bureau of Ocean Energy Mgmt., Reg & Enf","0","0","0","0","0","0","0.0","0.0","null","2020","2","2020","1","03","31"
"2020-03-31","Bureau","Department of the Interior","Bureau of Reclamation","91302","83","91302","83","0","0","100.0","100.0","null","2020","2","2020","1","03","31"
"2020-03-31","Bureau","Department of the Interior","Bureau of Safety and Environmental Enf.","0","0","0","0","0","0","0.0","0.0","null","2020","2","2020","1","03","31"
"2020-03-31","Bureau","Department of the Interior","Fish and Wildlife Service","606056","87","606056","87","0","0","100.0","100.0","null","2020","2","2020","1","03","31"
"2020-03-31","Bureau","Department of the Interior","Geological Survey","158617","173","158617","173","0","0","100.0","100.0","null","2020","2","2020","1","03","31"
"2020-03-31","Bureau","Department of the Interior","National Park Service","6992416","1835","6992416","1835","0","0","100.0","100.0","null","2020","2","2020","1","03","31"
"2020-03-31","Bureau","Department of the Interior","Office of Natural Resources Revenue","1861894","355","1861894","355","0","0","100.0","100.0","null","2020","2","2020","1","03","31"
"2020-03-31","Bureau","Department of the Interior","Office of Surface Mining","2523888","265","2523888","265","0","0","100.0","100.0","null","2020","2","2020","1","03","31"
"2020-03-31","Bureau","Department of the Interior","Office of the Secretary","62545","23","62545","23","0","0","100.0","100.0","null","2020","2","2020","1","03","31"
"2020-03-31","Agency","Department of the Treasury","null","38564857","5764","38103484","5733","461373","31","98.80364394972345","99.46217904233171","CFO","2020","2","2020","1","03","31"
"2020-03-31","Bureau","Department of the Treasury","Bureau of Engraving and Printing","84528","1","84528","1","0","0","100.0","100.0","null","2020","2","2020","1","03","31"
"2020-03-31","Bureau","Department of the Treasury","Bureau of the Fiscal Service","13127391","4199","13127278","4198","113","1","99.9991392044314","99.97618480590617","null","2020","2","2020","1","03","31"
"2020-03-31","Bureau","Department of the Treasury","Community Dev Financial Inst Fund","3442830","6","3442830","6","0","0","100.0","100.0","null","2020","2","2020","1","03","31"
"2020-03-31","Bureau","Department of the Treasury","Comptroller of the Currency","1111501","21","1111501","21","0","0","100.0","100.0","null","2020","2","2020","1","03","31"
"2020-03-31","Bureau","Department of the Treasury","D.C. Pension Program","356580","21","356580","21","0","0","100.0","100.0","null","2020","2","2020","1","03","31"
"2020-03-31","Bureau","Department of the Treasury","Departmental Offices","18571798","1366","18110538","1336","461260","30","97.51634171338715","97.80380673499268","null","2020","2","2020","1","03","31"
"2020-03-31","Bureau","Department of the Treasury","Financial Crimes Enforcement Network","1544945","3","1544945","3","0","0","100.0","100.0","null","2020","2","2020","1","03","31"
"2020-03-31","Bureau","Department of the Treasury","Interest on Tax/Deposit of Earnings","0","0","0","0","0","0","0.0","0.0","null","2020","2","2020","1","03","31"
"2020-03-31","Bureau","Department of the Treasury","Internal Revenue Service","272859","122","272859","122","0","0","100.0","100.0","null","2020","2","2020","1","03","31"
"2020-03-31","Bureau","Department of the Treasury","International Monetary Funds","0","0","0","0","0","0","0.0","0.0","null","2020","2","2020","1","03","31"
"2020-03-31","Bureau","Department of the Treasury","Office of Financial Research","0","0","0","0","0","0","0.0","0.0","null","2020","2","2020","1","03","31"
"2020-03-31","Bureau","Department of the Treasury","Office of Sec International Affairs","0","0","0","0","0","0","0.0","0.0","null","2020","2","2020","1","03","31"
"2020-03-31","Bureau","Department of the Treasury","Office of the Secretary","0","0","0","0","0","0","0.0","0.0","null","2020","2","2020","1","03","31"
"2020-03-31","Bureau","Department of the Treasury","Spec Insp Gen-Troubled Asset Rel Prog","3916","1","3916","1","0","0","100.0","100.0","null","2020","2","2020","1","03","31"
"2020-03-31","Bureau","Department of the Treasury","Tobacco Tax and Trade","1000","1","1000","1","0","0","100.0","100.0","null","2020","2","2020","1","03","31"
"2020-03-31","Bureau","Department of the Treasury","Treasury Forfeiture Fund","0","0","0","0","0","0","0.0","0.0","null","2020","2","2020","1","03","31"
"2020-03-31","Bureau","Department of the Treasury","Treasury Franchise Fund","0","0","0","0","0","0","0.0","0.0","null","2020","2","2020","1","03","31"
"2020-03-31","Bureau","Department of the Treasury","Treasury IG for Tax Admin","0","0","0","0","0","0","0.0","0.0","null","2020","2","2020","1","03","31"
"2020-03-31","Bureau","Department of the Treasury","U.S. Mint","46700","22","46700","22","0","0","100.0","100.0","null","2020","2","2020","1","03","31"
"2020-03-31","Bureau","Department of the Treasury","U.S. Treasury IG Office","809","1","809","1","0","0","100.0","100.0","null","2020","2","2020","1","03","31"
"2020-03-31","Agency","Environmental Protection Agency","null","23555120","214","23555120","214","0","0","100.0","100.0","CFO","2020","2","2020","1","03","31"
"2020-03-31","Bureau","Environmental Protection Agency","Environmental Protection Agency","23555120","214","23555120","214","0","0","100.0","100.0","null","2020","2","2020","1","03","31"
"2020-03-31","Agency","Equal Employment Opportunity Commission","null","39643","23","39643","23","0","0","100.0","100.0","Non-CFO","2020","2","2020","1","03","31"
"2020-03-31","Bureau","Equal Employment Opportunity Commission","Equal Employment Opportunity Commission","39643","23","39643","23","0","0","100.0","100.0","null","2020","2","2020","1","03","31"
"2020-03-31","Agency","Export - Import  Bank","null","0","0","0","0","0","0","0.0","0.0","Non-CFO","2020","2","2020","1","03","31"
"2020-03-31","Bureau","Export - Import  Bank","Export-Import Bank","0","0","0","0","0","0","0.0","0.0","null","2020","2","2020","1","03","31"
"2020-03-31","Agency","Farm Credit Administration","null","630","1","630","1","0","0","100.0","100.0","Non-CFO","2020","2","2020","1","03","31"
"2020-03-31","Bureau","Farm Credit Administration","Farm Credit Administration","630","1","630","1","0","0","100.0","100.0","null","2020","2","2020","1","03","31"
"2020-03-31","Bureau","Farm Credit Administration","Farm Credit System Insurance Corporation","0","0","0","0","0","0","0.0","0.0","null","2020","2","2020","1","03","31"
"2020-03-31","Agency","Federal Communications Commission","null","214160564","12856","214160564","12856","0","0","100.0","100.0","Non-CFO","2020","2","2020","1","03","31"
"2020-03-31","Bureau","Federal Communications Commission","Federal Communications Commission","214160564","12856","214160564","12856","0","0","100.0","100.0","null","2020","2","2020","1","03","31"
"2020-03-31","Agency","Federal Deposit Insurance Corporation","null","0","0","0","0","0","0","0.0","0.0","Non-CFO","2020","2","2020","1","03","31"
"2020-03-31","Bureau","Federal Deposit Insurance Corporation","Federal Deposit Insurance Corporation","0","0","0","0","0","0","0.0","0.0","null","2020","2","2020","1","03","31"
"2020-03-31","Agency","Federal Election Commission","null","738048","104","738048","104","0","0","100.0","100.0","Non-CFO","2020","2","2020","1","03","31"
"2020-03-31","Bureau","Federal Election Commission","Federal Election Commission","738048","104","738048","104","0","0","100.0","100.0","null","2020","2","2020","1","03","31"
"2020-03-31","Agency","Federal Labor Relations Authority","null","0","0","0","0","0","0","0.0","0.0","Non-CFO","2020","2","2020","1","03","31"
"2020-03-31","Bureau","Federal Labor Relations Authority","Federal Labor Relations Authority","0","0","0","0","0","0","0.0","0.0","null","2020","2","2020","1","03","31"
"2020-03-31","Agency","Federal Maritime Commission","null","390759","8","390759","8","0","0","100.0","100.0","Non-CFO","2020","2","2020","1","03","31"
"2020-03-31","Bureau","Federal Maritime Commission","Salaries and Expenses","390759","8","390759","8","0","0","100.0","100.0","null","2020","2","2020","1","03","31"
"2020-03-31","Agency","Federal Mediation/Conciliation Service","null","0","0","0","0","0","0","0.0","0.0","Non-CFO","2020","2","2020","1","03","31"
"2020-03-31","Bureau","Federal Mediation/Conciliation Service","Federal Mediation/Conciliation Service","0","0","0","0","0","0","0.0","0.0","null","2020","2","2020","1","03","31"
"2020-03-31","Agency","Federal Trade Commission","null","483074562","59","483074562","59","0","0","100.0","100.0","Non-CFO","2020","2","2020","1","03","31"
"2020-03-31","Bureau","Federal Trade Commission","Federal Trade Commission","483074562","59","483074562","59","0","0","100.0","100.0","null","2020","2","2020","1","03","31"
"2020-03-31","Agency","Funds Appropriated to the President","null","1235225","6","0","0","1235225","6","0.0","0.0","Non-CFO","2020","2","2020","1","03","31"
"2020-03-31","Bureau","Funds Appropriated to the President","African Development Foundation","0","0","0","0","0","0","0.0","0.0","null","2020","2","2020","1","03","31"
"2020-03-31","Bureau","Funds Appropriated to the President","Defense Security Assistance Agency","0","0","0","0","0","0","0.0","0.0","null","2020","2","2020","1","03","31"
"2020-03-31","Bureau","Funds Appropriated to the President","Executive Branch","0","0","0","0","0","0","0.0","0.0","null","2020","2","2020","1","03","31"
"2020-03-31","Bureau","Funds Appropriated to the President","Inter-American Foundation","0","0","0","0","0","0","0.0","0.0","null","2020","2","2020","1","03","31"
"2020-03-31","Bureau","Funds Appropriated to the President","Peace Corps","0","0","0","0","0","0","0.0","0.0","null","2020","2","2020","1","03","31"
"2020-03-31","Bureau","Funds Appropriated to the President","Trade and Development Agency","1235225","6","0","0","1235225","6","0.0","0.0","null","2020","2","2020","1","03","31"
"2020-03-31","Agency","General Services Administration","null","19555233","5723","16372007","5330","3183226","393","83.7218712760927","93.13297221736852","CFO","2020","2","2020","1","03","31"
"2020-03-31","Bureau","General Services Administration","General Services Administration","19555233","5723","16372007","5330","3183226","393","83.7218712760927","93.13297221736852","null","2020","2","2020","1","03","31"
"2020-03-31","Agency","Legis Branch-Library of Congress","null","0","0","0","0","0","0","0.0","0.0","Non-CFO","2020","2","2020","1","03","31"
"2020-03-31","Bureau","Legis Branch-Library of Congress","Library of Congress","0","0","0","0","0","0","0.0","0.0","null","2020","2","2020","1","03","31"
"2020-03-31","Agency","Legislative Branch - U.S. House/Senate","null","261924","210","60321","38","201603","172","23.029962889998625","18.095238095238095","Non-CFO","2020","2","2020","1","03","31"
"2020-03-31","Bureau","Legislative Branch - U.S. House/Senate","U.S. House of Representatives","261924","210","60321","38","201603","172","23.029962889998625","18.095238095238095","null","2020","2","2020","1","03","31"
"2020-03-31","Agency","Legislative Branch-CBO","null","0","0","0","0","0","0","0.0","0.0","Non-CFO","2020","2","2020","1","03","31"
"2020-03-31","Bureau","Legislative Branch-CBO","Congressional Budget Office","0","0","0","0","0","0","0.0","0.0","null","2020","2","2020","1","03","31"
"2020-03-31","Agency","Legislative Branch-GAO","null","0","0","0","0","0","0","0.0","0.0","Non-CFO","2020","2","2020","1","03","31"
"2020-03-31","Bureau","Legislative Branch-GAO","Government Accountability Office","0","0","0","0","0","0","0.0","0.0","null","2020","2","2020","1","03","31"
"2020-03-31","Agency","Legislative Branch-GPO","null","128460","34","0","0","128460","34","0.0","0.0","Non-CFO","2020","2","2020","1","03","31"
"2020-03-31","Bureau","Legislative Branch-GPO","Government Publishing Office","128460","34","0","0","128460","34","0.0","0.0","null","2020","2","2020","1","03","31"
"2020-03-31","Agency","Legislative Branch-Office of Tech.","null","0","0","0","0","0","0","0.0","0.0","Non-CFO","2020","2","2020","1","03","31"
"2020-03-31","Bureau","Legislative Branch-Office of Tech.","Medicaid & CHIP Payment & Access Comm.","0","0","0","0","0","0","0.0","0.0","null","2020","2","2020","1","03","31"
"2020-03-31","Bureau","Legislative Branch-Office of Tech.","Open World Leadership","0","0","0","0","0","0","0.0","0.0","null","2020","2","2020","1","03","31"
"2020-03-31","Agency","Merit Systems Protection Board","null","144","1","144","1","0","0","100.0","100.0","Non-CFO","2020","2","2020","1","03","31"
"2020-03-31","Bureau","Merit Systems Protection Board","Merit Systems Protection Board","144","1","144","1","0","0","100.0","100.0","null","2020","2","2020","1","03","31"
"2020-03-31","Agency","National Aeronautics and Space Administration","null","1230567","117","1230567","117","0","0","100.0","100.0","CFO","2020","2","2020","1","03","31"
"2020-03-31","Bureau","National Aeronautics and Space Administration","National Aeronautics and Space Admin","1230567","117","1230567","117","0","0","100.0","100.0","null","2020","2","2020","1","03","31"
"2020-03-31","Agency","National Archives & Records Admin","null","112595","94","110802","93","1793","1","98.40756694346996","98.93617021276596","Non-CFO","2020","2","2020","1","03","31"
"2020-03-31","Bureau","National Archives & Records Admin","Nat'l Archives & Records Administration","112595","94","110802","93","1793","1","98.40756694346996","98.93617021276596","null","2020","2","2020","1","03","31"
"2020-03-31","Agency","National Credit Union Administration","null","0","0","0","0","0","0","0.0","0.0","Non-CFO","2020","2","2020","1","03","31"
"2020-03-31","Bureau","National Credit Union Administration","National Credit Union Administration","0","0","0","0","0","0","0.0","0.0","null","2020","2","2020","1","03","31"
"2020-03-31","Agency","National Foundation  Arts & Humanities","null","0","0","0","0","0","0","0.0","0.0","Non-CFO","2020","2","2020","1","03","31"
"2020-03-31","Bureau","National Foundation  Arts & Humanities","National Endowment for the Arts","0","0","0","0","0","0","0.0","0.0","null","2020","2","2020","1","03","31"
"2020-03-31","Bureau","National Foundation  Arts & Humanities","National Endowment for the Humanities","0","0","0","0","0","0","0.0","0.0","null","2020","2","2020","1","03","31"
"2020-03-31","Agency","National Labor Relations Board","null","0","0","0","0","0","0","0.0","0.0","Non-CFO","2020","2","2020","1","03","31"
"2020-03-31","Bureau","National Labor Relations Board","National Labor Relations Board","0","0","0","0","0","0","0.0","0.0","null","2020","2","2020","1","03","31"
"2020-03-31","Agency","National Science Foundation","null","509535","94","509535","94","0","0","100.0","100.0","CFO","2020","2","2020","1","03","31"
"2020-03-31","Bureau","National Science Foundation","National Science Foundation","509535","94","509535","94","0","0","100.0","100.0","null","2020","2","2020","1","03","31"
"2020-03-31","Agency","Neighborhood Reinvestment Corporation","null","0","0","0","0","0","0","0.0","0.0","Non-CFO","2020","2","2020","1","03","31"
"2020-03-31","Bureau","Neighborhood Reinvestment Corporation","Neighborhood Reinvestment Corporation","0","0","0","0","0","0","0.0","0.0","null","2020","2","2020","1","03","31"
"2020-03-31","Agency","Nuclear Regulatory Commission","null","2814739","333","1793223","261","1021516","72","63.70832251231819","78.37837837837837","CFO","2020","2","2020","1","03","31"
"2020-03-31","Bureau","Nuclear Regulatory Commission","Nuclear Regulatory Commission","2814739","333","1793223","261","1021516","72","63.70832251231819","78.37837837837837","null","2020","2","2020","1","03","31"
"2020-03-31","Agency","Occupational Safety & Health Rev Comm","null","0","0","0","0","0","0","0.0","0.0","Non-CFO","2020","2","2020","1","03","31"
"2020-03-31","Bureau","Occupational Safety & Health Rev Comm","Occupational Safety & Health Rev Comm","0","0","0","0","0","0","0.0","0.0","null","2020","2","2020","1","03","31"
"2020-03-31","Agency","Office of Compliance","null","0","0","0","0","0","0","0.0","0.0","Non-CFO","2020","2","2020","1","03","31"
"2020-03-31","Bureau","Office of Compliance","Office of Compliance","0","0","0","0","0","0","0.0","0.0","null","2020","2","2020","1","03","31"
"2020-03-31","Agency","Office of Government Ethics","null","0","0","0","0","0","0","0.0","0.0","Non-CFO","2020","2","2020","1","03","31"
"2020-03-31","Bureau","Office of Government Ethics","Office of Government Ethics","0","0","0","0","0","0","0.0","0.0","null","2020","2","2020","1","03","31"
"2020-03-31","Agency","Office of Personnel Management","null","24192848","1525","22492194","1352","1700654","173","92.97042663187071","88.65573770491804","CFO","2020","2","2020","1","03","31"
"2020-03-31","Bureau","Office of Personnel Management","Office of Personnel Management","24192848","1525","22492194","1352","1700654","173","92.97042663187071","88.65573770491804","null","2020","2","2020","1","03","31"
"2020-03-31","Agency","Office of Special Counsel","null","0","0","0","0","0","0","0.0","0.0","Non-CFO","2020","2","2020","1","03","31"
"2020-03-31","Bureau","Office of Special Counsel","Office of Special Counsel","0","0","0","0","0","0","0.0","0.0","null","2020","2","2020","1","03","31"
"2020-03-31","Agency","Other Agencies","null","5549357","108","4930","2","5544427","106","0.08883912136126762","1.8518518518518519","Non-CFO","2020","2","2020","1","03","31"
"2020-03-31","Bureau","Other Agencies","Advisory Council on Hist. Preservation","0","0","0","0","0","0","0.0","0.0","null","2020","2","2020","1","03","31"
"2020-03-31","Bureau","Other Agencies","Archit.&Trans. Barriers Compliance Bd","0","0","0","0","0","0","0.0","0.0","null","2020","2","2020","1","03","31"
"2020-03-31","Bureau","Other Agencies","Architect of the Capitol","0","0","0","0","0","0","0.0","0.0","null","2020","2","2020","1","03","31"
"2020-03-31","Bureau","Other Agencies","Chemical Safety Board","0","0","0","0","0","0","0.0","0.0","null","2020","2","2020","1","03","31"
"2020-03-31","Bureau","Other Agencies","Comm. for Purchase from Blind/Handic.","0","0","0","0","0","0","0.0","0.0","null","2020","2","2020","1","03","31"
"2020-03-31","Bureau","Other Agencies","Commission On Fine Arts","0","0","0","0","0","0","0.0","0.0","null","2020","2","2020","1","03","31"
"2020-03-31","Bureau","Other Agencies","Consumer Financial Protection Bureau","5310622","68","0","0","5310622","68","0.0","0.0","null","2020","2","2020","1","03","31"
"2020-03-31","Bureau","Other Agencies","Council of Insps. Gen. of Intg. & Effy.","5400","7","0","0","5400","7","0.0","0.0","null","2020","2","2020","1","03","31"
"2020-03-31","Bureau","Other Agencies","Defense Nuclear Facilities Safety Board","0","0","0","0","0","0","0.0","0.0","null","2020","2","2020","1","03","31"
"2020-03-31","Bureau","Other Agencies","Delta Regional Authority","0","0","0","0","0","0","0.0","0.0","null","2020","2","2020","1","03","31"
"2020-03-31","Bureau","Other Agencies","Denali Commission","0","0","0","0","0","0","0.0","0.0","null","2020","2","2020","1","03","31"
"2020-03-31","Bureau","Other Agencies","District of Columbia Government","0","0","0","0","0","0","0.0","0.0","null","2020","2","2020","1","03","31"
"2020-03-31","Bureau","Other Agencies","Election Assistance Commission","0","0","0","0","0","0","0.0","0.0","null","2020","2","2020","1","03","31"
"2020-03-31","Bureau","Other Agencies","Federal Housing Finance Agency","221","1","0","0","221","1","0.0","0.0","null","2020","2","2020","1","03","31"
"2020-03-31","Bureau","Other Agencies","Federal Housing Finance Agency OIG","0","0","0","0","0","0","0.0","0.0","null","2020","2","2020","1","03","31"
"2020-03-31","Bureau","Other Agencies","Federal Mine Safety & Health Review Comm","0","0","0","0","0","0","0.0","0.0","null","2020","2","2020","1","03","31"
"2020-03-31","Bureau","Other Agencies","Gulf Coast Ecosystem Restoration Council","0","0","0","0","0","0","0.0","0.0","null","2020","2","2020","1","03","31"
"2020-03-31","Bureau","Other Agencies","James Madison Memorial Fellowship","221290","26","0","0","221290","26","0.0","0.0","null","2020","2","2020","1","03","31"
"2020-03-31","Bureau","Other Agencies","John C. Stennis","909","1","0","0","909","1","0.0","0.0","null","2020","2","2020","1","03","31"
"2020-03-31","Bureau","Other Agencies","Millennium Challenge Corporation","0","0","0","0","0","0","0.0","0.0","null","2020","2","2020","1","03","31"
"2020-03-31","Bureau","Other Agencies","Morris K. Udall Scholarship","982","1","0","0","982","1","0.0","0.0","null","2020","2","2020","1","03","31"
"2020-03-31","Bureau","Other Agencies","National Capital Planning Commission","0","0","0","0","0","0","0.0","0.0","null","2020","2","2020","1","03","31"
"2020-03-31","Bureau","Other Agencies","National Council on Disability","0","0","0","0","0","0","0.0","0.0","null","2020","2","2020","1","03","31"
"2020-03-31","Bureau","Other Agencies","National Mediation Board","0","0","0","0","0","0","0.0","0.0","null","2020","2","2020","1","03","31"
"2020-03-31","Bureau","Other Agencies","National Transportation Safety Board","0","0","0","0","0","0","0.0","0.0","null","2020","2","2020","1","03","31"
"2020-03-31","Bureau","Other Agencies","Surface Transportation Board","0","0","0","0","0","0","0.0","0.0","null","2020","2","2020","1","03","31"
"2020-03-31","Bureau","Other Agencies","U.S.  Agency of Global Media","4930","2","4930","2","0","0","100.0","100.0","null","2020","2","2020","1","03","31"
"2020-03-31","Bureau","Other Agencies","U.S. Holocaust Memorial Council","0","0","0","0","0","0","0.0","0.0","null","2020","2","2020","1","03","31"
"2020-03-31","Bureau","Other Agencies","U.S. Inst. for Env. Conflict Resolution","5003","2","0","0","5003","2","0.0","0.0","null","2020","2","2020","1","03","31"
"2020-03-31","Bureau","Other Agencies","U.S. Institute of Peace","0","0","0","0","0","0","0.0","0.0","null","2020","2","2020","1","03","31"
"2020-03-31","Agency","Other Agencies/Boards/Commissions","null","1024","2","0","0","1024","2","0.0","0.0","Non-CFO","2020","2","2020","1","03","31"
"2020-03-31","Bureau","Other Agencies/Boards/Commissions","Medicare Payment Advisory Commission","0","0","0","0","0","0","0.0","0.0","null","2020","2","2020","1","03","31"
"2020-03-31","Bureau","Other Agencies/Boards/Commissions","U.S. Comm. on Int. Religious Freedom","1024","2","0","0","1024","2","0.0","0.0","null","2020","2","2020","1","03","31"
"2020-03-31","Bureau","Other Agencies/Boards/Commissions","U.S.-China Security Review Commission","0","0","0","0","0","0","0.0","0.0","null","2020","2","2020","1","03","31"
"2020-03-31","Agency","Overseas Private Investment Corp Accts","null","0","0","0","0","0","0","0.0","0.0","Non-CFO","2020","2","2020","1","03","31"
"2020-03-31","Bureau","Overseas Private Investment Corp Accts","Overseas Private Investment Corp Accts","0","0","0","0","0","0","0.0","0.0","null","2020","2","2020","1","03","31"
"2020-03-31","Agency","Pension Benefit Guaranty Corp","null","4200927","1671","4200927","1671","0","0","100.0","100.0","Non-CFO","2020","2","2020","1","03","31"
"2020-03-31","Bureau","Pension Benefit Guaranty Corp","Pension Benefit Guaranty Corporation","4200927","1671","4200927","1671","0","0","100.0","100.0","null","2020","2","2020","1","03","31"
"2020-03-31","Agency","Presidio Trust Corporation","null","1412588","78","1335663","69","76925","9","94.55432157147024","88.46153846153847","Non-CFO","2020","2","2020","1","03","31"
"2020-03-31","Bureau","Presidio Trust Corporation","Presidio Trust Corporation","1412588","78","1335663","69","76925","9","94.55432157147024","88.46153846153847","null","2020","2","2020","1","03","31"
"2020-03-31","Agency","Railroad Retirement Board","null","21318788","4450","21318788","4450","0","0","100.0","100.0","Non-CFO","2020","2","2020","1","03","31"
"2020-03-31","Bureau","Railroad Retirement Board","Railroad Retirement Board","21318788","4450","21318788","4450","0","0","100.0","100.0","null","2020","2","2020","1","03","31"
"2020-03-31","Agency","Securities & Exchange Commission","null","2112865997","1104","2112865997","1104","0","0","100.0","100.0","Non-CFO","2020","2","2020","1","03","31"
"2020-03-31","Bureau","Securities & Exchange Commission","SEC Enforcement","2112536859","1043","2112536859","1043","0","0","100.0","100.0","null","2020","2","2020","1","03","31"
"2020-03-31","Bureau","Securities & Exchange Commission","Securities and Exchange Commission","329138","61","329138","61","0","0","100.0","100.0","null","2020","2","2020","1","03","31"
"2020-03-31","Agency","Selective Service System","null","0","0","0","0","0","0","0.0","0.0","Non-CFO","2020","2","2020","1","03","31"
"2020-03-31","Bureau","Selective Service System","Selective Service System","0","0","0","0","0","0","0.0","0.0","null","2020","2","2020","1","03","31"
"2020-03-31","Agency","Small Business Administration","null","12376759974","121590","12376759974","121590","0","0","100.0","100.0","CFO","2020","2","2020","1","03","31"
"2020-03-31","Bureau","Small Business Administration","Small Business Administration","12376759974","121590","12376759974","121590","0","0","100.0","100.0","null","2020","2","2020","1","03","31"
"2020-03-31","Agency","Smithsonian Institution","null","0","0","0","0","0","0","0.0","0.0","Non-CFO","2020","2","2020","1","03","31"
"2020-03-31","Bureau","Smithsonian Institution","Administrative Conference of the US","0","0","0","0","0","0","0.0","0.0","null","2020","2","2020","1","03","31"
"2020-03-31","Bureau","Smithsonian Institution","JFK Center for the Performing Arts","0","0","0","0","0","0","0.0","0.0","null","2020","2","2020","1","03","31"
"2020-03-31","Bureau","Smithsonian Institution","National Gallery of Art","0","0","0","0","0","0","0.0","0.0","null","2020","2","2020","1","03","31"
"2020-03-31","Bureau","Smithsonian Institution","Smithsonian Institution","0","0","0","0","0","0","0.0","0.0","null","2020","2","2020","1","03","31"
"2020-03-31","Agency","Social Security Administration","null","5350077463","1649096","2894497447","508737","2455580016","1140359","54.10197267268988","30.849447212290855","CFO","2020","2","2020","1","03","31"
"2020-03-31","Bureau","Social Security Administration","Social Security Administration","5350077463","1649096","2894497447","508737","2455580016","1140359","54.10197267268988","30.849447212290855","null","2020","2","2020","1","03","31"
"2020-03-31","Agency","Tennessee Valley Authority","null","0","0","0","0","0","0","0.0","0.0","Non-CFO","2020","2","2020","1","03","31"
"2020-03-31","Bureau","Tennessee Valley Authority","Tennessee Valley Authority","0","0","0","0","0","0","0.0","0.0","null","2020","2","2020","1","03","31"
"2020-03-31","Agency","The Judiciary","null","1116880","328","1059871","203","57009","125","94.89569156937182","61.890243902439025","Non-CFO","2020","2","2020","1","03","31"
"2020-03-31","Bureau","The Judiciary","Administrative Office of the U.S. Courts","1116880","328","1059871","203","57009","125","94.89569156937182","61.890243902439025","null","2020","2","2020","1","03","31"
"2020-03-31","Agency","U.S. Court of Appeals / Veterans Claims","null","295","1","295","1","0","0","100.0","100.0","Non-CFO","2020","2","2020","1","03","31"
"2020-03-31","Bureau","U.S. Court of Appeals / Veterans Claims","U.S. Court of Appeals / Veterans Claims","295","1","295","1","0","0","100.0","100.0","null","2020","2","2020","1","03","31"
"2020-03-31","Agency","U.S. Postal Service","null","68433042","67267","42004153","48577","26428889","18690","61.37992959599838","72.21520210504409","Non-CFO","2020","2","2020","1","03","31"
"2020-03-31","Bureau","U.S. Postal Service","U.S. Postal Service","68433042","67267","42004153","48577","26428889","18690","61.37992959599838","72.21520210504409","null","2020","2","2020","1","03","31"
"2019-12-31","Agency","Agency for International Development","null","26725151","51","26725151","51","0","0","100.0","100.0","CFO","2020","1","2019","4","12","31"
"2019-12-31","Bureau","Agency for International Development","Agency for International Development","26725151","51","26725151","51","0","0","100.0","100.0","null","2020","1","2019","4","12","31"
"2019-12-31","Agency","American Battle Monuments Commission","null","0","0","0","0","0","0","0.0","0.0","Non-CFO","2020","1","2019","4","12","31"
"2019-12-31","Bureau","American Battle Monuments Commission","American Battle Monuments Commission","0","0","0","0","0","0","0.0","0.0","null","2020","1","2019","4","12","31"
"2019-12-31","Agency","Armed Forces Retirement Home","null","82575","107","82575","107","0","0","100.0","100.0","Non-CFO","2020","1","2019","4","12","31"
"2019-12-31","Bureau","Armed Forces Retirement Home","Armed Forces Retirement Home","82575","107","82575","107","0","0","100.0","100.0","null","2020","1","2019","4","12","31"
"2019-12-31","Agency","Commodity Futures Trading Commission","null","642771311","370","642771311","370","0","0","100.0","100.0","Non-CFO","2020","1","2019","4","12","31"
"2019-12-31","Bureau","Commodity Futures Trading Commission","Commodity Futures Trading Commission","642771311","370","642771311","370","0","0","100.0","100.0","null","2020","1","2019","4","12","31"
"2019-12-31","Agency","Consumer Product Safety Commission","null","479","1","479","1","0","0","100.0","100.0","Non-CFO","2020","1","2019","4","12","31"
"2019-12-31","Bureau","Consumer Product Safety Commission","Consumer Product Safety Commission","479","1","479","1","0","0","100.0","100.0","null","2020","1","2019","4","12","31"
"2019-12-31","Agency","Corp. for National and Community Service","null","4666478","1346","3587386","162","1079092","1184","76.87566511617541","12.035661218424963","Non-CFO","2020","1","2019","4","12","31"
"2019-12-31","Bureau","Corp. for National and Community Service","Corp. for National and Community Service","4666478","1346","3587386","162","1079092","1184","76.87566511617541","12.035661218424963","null","2020","1","2019","4","12","31"
"2019-12-31","Agency","Department of Agriculture","null","1423234129","61832","1416799923","60133","6434206","1699","99.54791654662463","97.25223185405615","CFO","2020","1","2019","4","12","31"
"2019-12-31","Bureau","Department of Agriculture","Agricultural Marketing Service","5111573","904","4485497","497","626076","407","87.75179382158878","54.97787610619469","null","2020","1","2019","4","12","31"
"2019-12-31","Bureau","Department of Agriculture","Commodity Credit Corporation","133240124","11125","133240124","11125","0","0","100.0","100.0","null","2020","1","2019","4","12","31"
"2019-12-31","Bureau","Department of Agriculture","Farm Service Agency","473793050","10341","473793050","10341","0","0","100.0","100.0","null","2020","1","2019","4","12","31"
"2019-12-31","Bureau","Department of Agriculture","Federal Crop Insurance Corporation","57112","410","57112","410","0","0","100.0","100.0","null","2020","1","2019","4","12","31"
"2019-12-31","Bureau","Department of Agriculture","Food Safety and Inspection Service","988510","1608","983922","1606","4588","2","99.53586711312987","99.87562189054727","null","2020","1","2019","4","12","31"
"2019-12-31","Bureau","Department of Agriculture","Food and Nutrition Service","694096","35","47781","4","646315","31","6.883918074733178","11.428571428571429","null","2020","1","2019","4","12","31"
"2019-12-31","Bureau","Department of Agriculture","Forest Service","61212435","608","59946810","289","1265625","319","97.93240540096143","47.5328947368421","null","2020","1","2019","4","12","31"
"2019-12-31","Bureau","Department of Agriculture","Rural Development","718878827","34147","718877843","34145","984","2","99.99986312018618","99.99414297009986","null","2020","1","2019","4","12","31"
"2019-12-31","Bureau","Department of Agriculture","U.S. Department of Agriculture","29258402","2654","25367784","1716","3890618","938","86.70256154112586","64.65712132629993","null","2020","1","2019","4","12","31"
"2019-12-31","Agency","Department of Commerce","null","22849752","1399","22849752","1399","0","0","100.0","100.0","CFO","2020","1","2019","4","12","31"
"2019-12-31","Bureau","Department of Commerce","Bureau of Industry and Security","2021957","15","2021957","15","0","0","100.0","100.0","null","2020","1","2019","4","12","31"
"2019-12-31","Bureau","Department of Commerce","Bureau of the Census","402879","258","402879","258","0","0","100.0","100.0","null","2020","1","2019","4","12","31"
"2019-12-31","Bureau","Department of Commerce","Economic Development Administration","5113160","9","5113160","9","0","0","100.0","100.0","null","2020","1","2019","4","12","31"
"2019-12-31","Bureau","Department of Commerce","Economic and Statistical Analysis","0","0","0","0","0","0","0.0","0.0","null","2020","1","2019","4","12","31"
"2019-12-31","Bureau","Department of Commerce","General Administration","4660","1","4660","1","0","0","100.0","100.0","null","2020","1","2019","4","12","31"
"2019-12-31","Bureau","Department of Commerce","International Trade Administration","0","0","0","0","0","0","0.0","0.0","null","2020","1","2019","4","12","31"
"2019-12-31","Bureau","Department of Commerce","Minority Business Development Agency","0","0","0","0","0","0","0.0","0.0","null","2020","1","2019","4","12","31"
"2019-12-31","Bureau","Department of Commerce","NOAA","13968693","603","13968693","603","0","0","100.0","100.0","null","2020","1","2019","4","12","31"
"2019-12-31","Bureau","Department of Commerce","Nat'l Institute of Standards& Technology","670005","5","670005","5","0","0","100.0","100.0","null","2020","1","2019","4","12","31"
"2019-12-31","Bureau","Department of Commerce","Nat'l Telecomm & Information Admin.","297608","2","297608","2","0","0","100.0","100.0","null","2020","1","2019","4","12","31"
"2019-12-31","Bureau","Department of Commerce","National Technical Information Service","0","0","0","0","0","0","0.0","0.0","null","2020","1","2019","4","12","31"
"2019-12-31","Bureau","Department of Commerce","Office of the Inspector General","0","0","0","0","0","0","0.0","0.0","null","2020","1","2019","4","12","31"
"2019-12-31","Bureau","Department of Commerce","Patent and Trademark Office","370790","506","370790","506","0","0","100.0","100.0","null","2020","1","2019","4","12","31"
"2019-12-31","Agency","Department of Defense","null","2344831466","1479320","1133358009","303631","1211473457","1175689","48.334305703146","20.525038531217046","CFO","2020","1","2019","4","12","31"
"2019-12-31","Bureau","Department of Defense","Consolidated Report","2344831466","1479320","1133358009","303631","1211473457","1175689","48.334305703146","20.525038531217046","null","2020","1","2019","4","12","31"
"2019-12-31","Agency","Department of Education","null","174655076575","29348155","148363488087","24128386","26291588488","5219769","84.9465649647407","82.21431977580873","CFO","2020","1","2019","4","12","31"
"2019-12-31","Bureau","Department of Education","Departmental Management","819240102","2420","13882449","301","805357653","2119","1.6945519349100417","12.438016528925619","null","2020","1","2019","4","12","31"
"2019-12-31","Bureau","Department of Education","Federal Student Aid","173835836473","29345735","148349605638","24128085","25486230835","5217650","85.33890862085937","82.22007388807948","null","2020","1","2019","4","12","31"
"2019-12-31","Bureau","Department of Education","Office of Postsecondary Education","0","0","0","0","0","0","0.0","0.0","null","2020","1","2019","4","12","31"
"2019-12-31","Agency","Department of Energy","null","14494235","109","14494235","109","0","0","100.0","100.0","CFO","2020","1","2019","4","12","31"
"2019-12-31","Bureau","Department of Energy","Bonneville Power Administration","1097032","40","1097032","40","0","0","100.0","100.0","null","2020","1","2019","4","12","31"
"2019-12-31","Bureau","Department of Energy","Energy Consolidated Reports","13397203","69","13397203","69","0","0","100.0","100.0","null","2020","1","2019","4","12","31"
"2019-12-31","Agency","Department of Health & Human Services","null","9515405146","1491063","9392960851","1153323","122444295","337740","98.71319935282554","77.34904561376682","CFO","2020","1","2019","4","12","31"
"2019-12-31","Bureau","Department of Health & Human Services","Administration for Children and Families","27666355","1677","27666355","1677","0","0","100.0","100.0","null","2020","1","2019","4","12","31"
"2019-12-31","Bureau","Department of Health & Human Services","Administration for Community Living","0","0","0","0","0","0","0.0","0.0","null","2020","1","2019","4","12","31"
"2019-12-31","Bureau","Department of Health & Human Services","Centers for Disease Control","6979689","147","128698","13","6850991","134","1.8438930445181727","8.843537414965986","null","2020","1","2019","4","12","31"
"2019-12-31","Bureau","Department of Health & Human Services","Centers for Medicare & Medicaid Services","9261767728","1157716","9192493424","1149115","69274304","8601","99.25204015006152","99.25707168251972","null","2020","1","2019","4","12","31"
"2019-12-31","Bureau","Department of Health & Human Services","Food and Drug Administration","44168100","326615","34732967","1122","9435133","325493","78.63812797018663","0.3435237205884604","null","2020","1","2019","4","12","31"
"2019-12-31","Bureau","Department of Health & Human Services","Health Resources and Services Admin","99612650","529","99612650","529","0","0","100.0","100.0","null","2020","1","2019","4","12","31"
"2019-12-31","Bureau","Department of Health & Human Services","Indian Health Services","48099205","3359","26012154","183","22087051","3176","54.08021608673158","5.448050014885383","null","2020","1","2019","4","12","31"
"2019-12-31","Bureau","Department of Health & Human Services","National Institutes of Health","20564168","441","5767352","105","14796816","336","28.045637440814527","23.80952380952381","null","2020","1","2019","4","12","31"
"2019-12-31","Bureau","Department of Health & Human Services","Office of the Inspector General","0","0","0","0","0","0","0.0","0.0","null","2020","1","2019","4","12","31"
"2019-12-31","Bureau","Department of Health & Human Services","Office of the Secretary","6690","13","6690","13","0","0","100.0","100.0","null","2020","1","2019","4","12","31"
"2019-12-31","Bureau","Department of Health & Human Services","Program Support Center","5572574","551","5572574","551","0","0","100.0","100.0","null","2020","1","2019","4","12","31"
"2019-12-31","Bureau","Department of Health & Human Services","Substance Abuse & Mental Health Admin.","967987","15","967987","15","0","0","100.0","100.0","null","2020","1","2019","4","12","31"
"2019-12-31","Agency","Department of Homeland Security","null","372187403","64065","372187403","64065","0","0","100.0","100.0","CFO","2020","1","2019","4","12","31"
"2019-12-31","Bureau","Department of Homeland Security","Bureau of Customs & Border Protection","9528980","639","9528980","639","0","0","100.0","100.0","null","2020","1","2019","4","12","31"
"2019-12-31","Bureau","Department of Homeland Security","Citizenship and Immigration Services","999615","1234","999615","1234","0","0","100.0","100.0","null","2020","1","2019","4","12","31"
"2019-12-31","Bureau","Department of Homeland Security","Domestic Nuclear Detection Office","0","0","0","0","0","0","0.0","0.0","null","2020","1","2019","4","12","31"
"2019-12-31","Bureau","Department of Homeland Security","Emergency Preparedness & Resp","258351059","43221","258351059","43221","0","0","100.0","100.0","null","2020","1","2019","4","12","31"
"2019-12-31","Bureau","Department of Homeland Security","Federal Law Enforcement Training Ctr.","0","0","0","0","0","0","0.0","0.0","null","2020","1","2019","4","12","31"
"2019-12-31","Bureau","Department of Homeland Security","Immigration and Customs Enforcement","10097359","430","10097359","430","0","0","100.0","100.0","null","2020","1","2019","4","12","31"
"2019-12-31","Bureau","Department of Homeland Security","Info Analysis Infrastructure Prot-NPPD","0","0","0","0","0","0","0.0","0.0","null","2020","1","2019","4","12","31"
"2019-12-31","Bureau","Department of Homeland Security","Management Headquarters","191","1","191","1","0","0","100.0","100.0","null","2020","1","2019","4","12","31"
"2019-12-31","Bureau","Department of Homeland Security","Office of Biometric Identity Management","0","0","0","0","0","0","0.0","0.0","null","2020","1","2019","4","12","31"
"2019-12-31","Bureau","Department of Homeland Security","Office of Health Affairs","0","0","0","0","0","0","0.0","0.0","null","2020","1","2019","4","12","31"
"2019-12-31","Bureau","Department of Homeland Security","Office of the Inspector General DHS","98","1","98","1","0","0","100.0","100.0","null","2020","1","2019","4","12","31"
"2019-12-31","Bureau","Department of Homeland Security","Science and Technology","0","0","0","0","0","0","0.0","0.0","null","2020","1","2019","4","12","31"
"2019-12-31","Bureau","Department of Homeland Security","Transportation Safety Administration","16108915","7022","16108915","7022","0","0","100.0","100.0","null","2020","1","2019","4","12","31"
"2019-12-31","Bureau","Department of Homeland Security","U.S. Coast Guard","77101186","11517","77101186","11517","0","0","100.0","100.0","null","2020","1","2019","4","12","31"
"2019-12-31","Bureau","Department of Homeland Security","U.S. Secret Service","0","0","0","0","0","0","0.0","0.0","null","2020","1","2019","4","12","31"
"2019-12-31","Agency","Department of Housing and Urban Development","null","165700841","6366","165696422","6365","4419","1","99.99733314570202","99.98429154885328","CFO","2020","1","2019","4","12","31"
"2019-12-31","Bureau","Department of Housing and Urban Development","Community Planning and Development","0","0","0","0","0","0","0.0","0.0","null","2020","1","2019","4","12","31"
"2019-12-31","Bureau","Department of Housing and Urban Development","Government National Mortgage Association","0","0","0","0","0","0","0.0","0.0","null","2020","1","2019","4","12","31"
"2019-12-31","Bureau","Department of Housing and Urban Development","Housing Programs","165700277","6365","165695858","6364","4419","1","99.99733313662475","99.98428908091124","null","2020","1","2019","4","12","31"
"2019-12-31","Bureau","Department of Housing and Urban Development","Management and Administration","0","0","0","0","0","0","0.0","0.0","null","2020","1","2019","4","12","31"
"2019-12-31","Bureau","Department of Housing and Urban Development","Policy, Development and Research","0","0","0","0","0","0","0.0","0.0","null","2020","1","2019","4","12","31"
"2019-12-31","Bureau","Department of Housing and Urban Development","Public and Indian Housing Programs","564","1","564","1","0","0","100.0","100.0","null","2020","1","2019","4","12","31"
"2019-12-31","Agency","Department of Justice","null","85954046","36690","85430622","36495","523424","195","99.39104204588577","99.46852003270646","CFO","2020","1","2019","4","12","31"
"2019-12-31","Bureau","Department of Justice","Bureau of ATF and Explosives","20885","4","20885","4","0","0","100.0","100.0","null","2020","1","2019","4","12","31"
"2019-12-31","Bureau","Department of Justice","Drug Enforcement Administration","330452","21","330452","21","0","0","100.0","100.0","null","2020","1","2019","4","12","31"
"2019-12-31","Bureau","Department of Justice","Federal Bureau of Investigation","217857","59","217857","59","0","0","100.0","100.0","null","2020","1","2019","4","12","31"
"2019-12-31","Bureau","Department of Justice","Federal Prison Industries","1043089","183","1043089","183","0","0","100.0","100.0","null","2020","1","2019","4","12","31"
"2019-12-31","Bureau","Department of Justice","Federal Prison System","841391","117","841391","117","0","0","100.0","100.0","null","2020","1","2019","4","12","31"
"2019-12-31","Bureau","Department of Justice","General Administration","0","0","0","0","0","0","0.0","0.0","null","2020","1","2019","4","12","31"
"2019-12-31","Bureau","Department of Justice","Legal Activities","83479785","36304","82957825","36110","521960","194","99.37474683242176","99.46562362274129","null","2020","1","2019","4","12","31"
"2019-12-31","Bureau","Department of Justice","Office of Justice Assistance Programs","19123","1","19123","1","0","0","100.0","100.0","null","2020","1","2019","4","12","31"
"2019-12-31","Bureau","Department of Justice","U.S. Marshals Service","1464","1","0","0","1464","1","0.0","0.0","null","2020","1","2019","4","12","31"
"2019-12-31","Agency","Department of Labor","null","141670563","36685","110249624","17540","31420939","19145","77.821123644437","47.81245740765981","CFO","2020","1","2019","4","12","31"
"2019-12-31","Bureau","Department of Labor","Bureau of Labor Statistics","11381","1","11381","1","0","0","100.0","100.0","null","2020","1","2019","4","12","31"
"2019-12-31","Bureau","Department of Labor","Departmental Management","0","0","0","0","0","0","0.0","0.0","null","2020","1","2019","4","12","31"
"2019-12-31","Bureau","Department of Labor","Employee Benefit Security Administration","16923949","386","16923949","386","0","0","100.0","100.0","null","2020","1","2019","4","12","31"
"2019-12-31","Bureau","Department of Labor","Employment Standards Administration","69990603","18837","52272694","2643","17717909","16194","74.68530311133338","14.030896639592292","null","2020","1","2019","4","12","31"
"2019-12-31","Bureau","Department of Labor","Employment and Training Administration","5857592","37","3167034","4","2690558","33","54.067166166574935","10.81081081081081","null","2020","1","2019","4","12","31"
"2019-12-31","Bureau","Department of Labor","Mine Safety and Health Administration","42522341","16277","32742187","13493","9780154","2784","76.99996338395385","82.89611107697979","null","2020","1","2019","4","12","31"
"2019-12-31","Bureau","Department of Labor","Occupational Safety and Health Admin","6364697","1147","5132379","1013","1232318","134","80.63822991102326","88.31734960767218","null","2020","1","2019","4","12","31"
"2019-12-31","Agency","Department of State","null","17904449","25456","17333672","25350","570777","106","96.8120940219942","99.5835952231301","CFO","2020","1","2019","4","12","31"
"2019-12-31","Bureau","Department of State","Civil Monetary Penalties","0","0","0","0","0","0","0.0","0.0","null","2020","1","2019","4","12","31"
"2019-12-31","Bureau","Department of State","Department of State","15100904","7326","14530127","7220","570777","106","96.22024615215089","98.55309855309855","null","2020","1","2019","4","12","31"
"2019-12-31","Bureau","Department of State","International Commissions","0","0","0","0","0","0","0.0","0.0","null","2020","1","2019","4","12","31"
"2019-12-31","Bureau","Department of State","Passport NSF","2803545","18130","2803545","18130","0","0","100.0","100.0","null","2020","1","2019","4","12","31"
"2019-12-31","Agency","Department of Transportation","null","60559705","6887","60545069","6880","14636","7","99.97583211477004","99.89835922753014","CFO","2020","1","2019","4","12","31"
"2019-12-31","Bureau","Department of Transportation","Federal Aviation Administration","2201481","338","2186845","331","14636","7","99.33517482095007","97.92899408284023","null","2020","1","2019","4","12","31"
"2019-12-31","Bureau","Department of Transportation","Federal Highway Administration","6540","5","6540","5","0","0","100.0","100.0","null","2020","1","2019","4","12","31"
"2019-12-31","Bureau","Department of Transportation","Federal Motor Carrier Safety Admin","56016741","6467","56016741","6467","0","0","100.0","100.0","null","2020","1","2019","4","12","31"
"2019-12-31","Bureau","Department of Transportation","Federal Railroad Administration","207383","18","207383","18","0","0","100.0","100.0","null","2020","1","2019","4","12","31"
"2019-12-31","Bureau","Department of Transportation","Federal Transit Administration","784441","2","784441","2","0","0","100.0","100.0","null","2020","1","2019","4","12","31"
"2019-12-31","Bureau","Department of Transportation","Maritime Administration","5300","6","5300","6","0","0","100.0","100.0","null","2020","1","2019","4","12","31"
"2019-12-31","Bureau","Department of Transportation","National Highway Traffic Safety Admin.","18588","5","18588","5","0","0","100.0","100.0","null","2020","1","2019","4","12","31"
"2019-12-31","Bureau","Department of Transportation","Office of the Inspector General","205","1","205","1","0","0","100.0","100.0","null","2020","1","2019","4","12","31"
"2019-12-31","Bureau","Department of Transportation","Office of the Secretary","968738","17","968738","17","0","0","100.0","100.0","null","2020","1","2019","4","12","31"
"2019-12-31","Bureau","Department of Transportation","Pipeline Hazardous Material Safety Admin","342272","23","342272","23","0","0","100.0","100.0","null","2020","1","2019","4","12","31"
"2019-12-31","Bureau","Department of Transportation","Research Innovative Technology Admin","3673","4","3673","4","0","0","100.0","100.0","null","2020","1","2019","4","12","31"
"2019-12-31","Bureau","Department of Transportation","St. Lawrence Seaway Development Corp.","4343","1","4343","1","0","0","100.0","100.0","null","2020","1","2019","4","12","31"
"2019-12-31","Bureau","Department of Transportation","Surface Transportation Board","0","0","0","0","0","0","0.0","0.0","null","2020","1","2019","4","12","31"
"2019-12-31","Agency","Department of Veterans Affairs","null","1187413935","9293487","1099279379","9187245","88134556","106242","92.57760470867305","98.85681230306773","CFO","2020","1","2019","4","12","31"
"2019-12-31","Bureau","Department of Veterans Affairs","Administration and Cemeteries","1967123","674","5042","6","1962081","668","0.25631340795669616","0.8902077151335311","null","2020","1","2019","4","12","31"
"2019-12-31","Bureau","Department of Veterans Affairs","Housing Credit Assistance","1461406","52","468963","30","992443","22","32.08985045907845","57.69230769230769","null","2020","1","2019","4","12","31"
"2019-12-31","Bureau","Department of Veterans Affairs","Life Insurance","581240","110","581240","110","0","0","100.0","100.0","null","2020","1","2019","4","12","31"
"2019-12-31","Bureau","Department of Veterans Affairs","Medical and Construction","643975290","9169539","560084491","9065677","83890799","103862","86.97297857500091","98.8673149217207","null","2020","1","2019","4","12","31"
"2019-12-31","Bureau","Department of Veterans Affairs","Veterans Benefits","539428876","123112","538139643","121422","1289233","1690","99.7610003732911","98.6272662291247","null","2020","1","2019","4","12","31"
"2019-12-31","Agency","Department of the Interior","null","43234943","32781","43225448","32624","9495","157","99.97803859715971","99.52106403099356","CFO","2020","1","2019","4","12","31"
"2019-12-31","Bureau","Department of the Interior","Bureau of Indian Affairs","14715389","29599","14705894","29442","9495","157","99.93547571185512","99.46957667488766","null","2020","1","2019","4","12","31"
"2019-12-31","Bureau","Department of the Interior","Bureau of Land Management","15627509","280","15627509","280","0","0","100.0","100.0","null","2020","1","2019","4","12","31"
"2019-12-31","Bureau","Department of the Interior","Bureau of Ocean Energy Mgmt., Reg & Enf","0","0","0","0","0","0","0.0","0.0","null","2020","1","2019","4","12","31"
"2019-12-31","Bureau","Department of the Interior","Bureau of Reclamation","112632","91","112632","91","0","0","100.0","100.0","null","2020","1","2019","4","12","31"
"2019-12-31","Bureau","Department of the Interior","Bureau of Safety and Environmental Enf.","14571","5","14571","5","0","0","100.0","100.0","null","2020","1","2019","4","12","31"
"2019-12-31","Bureau","Department of the Interior","Fish and Wildlife Service","607089","91","607089","91","0","0","100.0","100.0","null","2020","1","2019","4","12","31"
"2019-12-31","Bureau","Department of the Interior","Geological Survey","152493","171","152493","171","0","0","100.0","100.0","null","2020","1","2019","4","12","31"
"2019-12-31","Bureau","Department of the Interior","National Park Service","6945634","1935","6945634","1935","0","0","100.0","100.0","null","2020","1","2019","4","12","31"
"2019-12-31","Bureau","Department of the Interior","Office of Natural Resources Revenue","2654844","334","2654844","334","0","0","100.0","100.0","null","2020","1","2019","4","12","31"
"2019-12-31","Bureau","Department of the Interior","Office of Surface Mining","2367200","250","2367200","250","0","0","100.0","100.0","null","2020","1","2019","4","12","31"
"2019-12-31","Bureau","Department of the Interior","Office of the Secretary","37582","25","37582","25","0","0","100.0","100.0","null","2020","1","2019","4","12","31"
"2019-12-31","Agency","Department of the Treasury","null","46565852","6226","41055002","6132","5510850","94","88.16546940878479","98.49020237712817","CFO","2020","1","2019","4","12","31"
"2019-12-31","Bureau","Department of the Treasury","Bureau of Engraving and Printing","84528","1","84528","1","0","0","100.0","100.0","null","2020","1","2019","4","12","31"
"2019-12-31","Bureau","Department of the Treasury","Bureau of the Fiscal Service","13192642","4601","13192642","4601","0","0","100.0","100.0","null","2020","1","2019","4","12","31"
"2019-12-31","Bureau","Department of the Treasury","Community Dev Financial Inst Fund","3140760","7","3140760","7","0","0","100.0","100.0","null","2020","1","2019","4","12","31"
"2019-12-31","Bureau","Department of the Treasury","Comptroller of the Currency","1116538","24","1116338","22","200","2","99.9820874882897","91.66666666666667","null","2020","1","2019","4","12","31"
"2019-12-31","Bureau","Department of the Treasury","D.C. Pension Program","350002","19","350002","19","0","0","100.0","100.0","null","2020","1","2019","4","12","31"
"2019-12-31","Bureau","Department of the Treasury","Departmental Offices","26839170","1427","21329269","1336","5509901","91","79.4706729008386","93.6229852838122","null","2020","1","2019","4","12","31"
"2019-12-31","Bureau","Department of the Treasury","Financial Crimes Enforcement Network","1544945","3","1544945","3","0","0","100.0","100.0","null","2020","1","2019","4","12","31"
"2019-12-31","Bureau","Department of the Treasury","Interest on Tax/Deposit of Earnings","0","0","0","0","0","0","0.0","0.0","null","2020","1","2019","4","12","31"
"2019-12-31","Bureau","Department of the Treasury","Internal Revenue Service","245803","122","245803","122","0","0","100.0","100.0","null","2020","1","2019","4","12","31"
"2019-12-31","Bureau","Department of the Treasury","International Monetary Funds","0","0","0","0","0","0","0.0","0.0","null","2020","1","2019","4","12","31"
"2019-12-31","Bureau","Department of the Treasury","Office of Financial Research","0","0","0","0","0","0","0.0","0.0","null","2020","1","2019","4","12","31"
"2019-12-31","Bureau","Department of the Treasury","Office of Sec International Affairs","0","0","0","0","0","0","0.0","0.0","null","2020","1","2019","4","12","31"
"2019-12-31","Bureau","Department of the Treasury","Office of the Secretary","0","0","0","0","0","0","0.0","0.0","null","2020","1","2019","4","12","31"
"2019-12-31","Bureau","Department of the Treasury","Spec Insp Gen-Troubled Asset Rel Prog","3916","1","3916","1","0","0","100.0","100.0","null","2020","1","2019","4","12","31"
"2019-12-31","Bureau","Department of the Treasury","Tobacco Tax and Trade","1000","1","1000","1","0","0","100.0","100.0","null","2020","1","2019","4","12","31"
"2019-12-31","Bureau","Department of the Treasury","Treasury Forfeiture Fund","0","0","0","0","0","0","0.0","0.0","null","2020","1","2019","4","12","31"
"2019-12-31","Bureau","Department of the Treasury","Treasury Franchise Fund","0","0","0","0","0","0","0.0","0.0","null","2020","1","2019","4","12","31"
"2019-12-31","Bureau","Department of the Treasury","Treasury IG for Tax Admin","0","0","0","0","0","0","0.0","0.0","null","2020","1","2019","4","12","31"
"2019-12-31","Bureau","Department of the Treasury","U.S. Mint","45799","19","45799","19","0","0","100.0","100.0","null","2020","1","2019","4","12","31"
"2019-12-31","Bureau","Department of the Treasury","U.S. Treasury IG Office","749","1","0","0","749","1","0.0","0.0","null","2020","1","2019","4","12","31"
"2019-12-31","Agency","Environmental Protection Agency","null","16066763","196","16066763","196","0","0","100.0","100.0","CFO","2020","1","2019","4","12","31"
"2019-12-31","Bureau","Environmental Protection Agency","Environmental Protection Agency","16066763","196","16066763","196","0","0","100.0","100.0","null","2020","1","2019","4","12","31"
"2019-12-31","Agency","Equal Employment Opportunity Commission","null","43957","30","43957","30","0","0","100.0","100.0","Non-CFO","2020","1","2019","4","12","31"
"2019-12-31","Bureau","Equal Employment Opportunity Commission","Equal Employment Opportunity Commission","43957","30","43957","30","0","0","100.0","100.0","null","2020","1","2019","4","12","31"
"2019-12-31","Agency","Export - Import  Bank","null","0","0","0","0","0","0","0.0","0.0","Non-CFO","2020","1","2019","4","12","31"
"2019-12-31","Bureau","Export - Import  Bank","Export-Import Bank","0","0","0","0","0","0","0.0","0.0","null","2020","1","2019","4","12","31"
"2019-12-31","Agency","Farm Credit Administration","null","630","1","630","1","0","0","100.0","100.0","Non-CFO","2020","1","2019","4","12","31"
"2019-12-31","Bureau","Farm Credit Administration","Farm Credit Administration","630","1","630","1","0","0","100.0","100.0","null","2020","1","2019","4","12","31"
"2019-12-31","Bureau","Farm Credit Administration","Farm Credit System Insurance Corporation","0","0","0","0","0","0","0.0","0.0","null","2020","1","2019","4","12","31"
"2019-12-31","Agency","Federal Communications Commission","null","195037325","11482","195037325","11482","0","0","100.0","100.0","Non-CFO","2020","1","2019","4","12","31"
"2019-12-31","Bureau","Federal Communications Commission","Federal Communications Commission","195037325","11482","195037325","11482","0","0","100.0","100.0","null","2020","1","2019","4","12","31"
"2019-12-31","Agency","Federal Deposit Insurance Corporation","null","0","0","0","0","0","0","0.0","0.0","Non-CFO","2020","1","2019","4","12","31"
"2019-12-31","Bureau","Federal Deposit Insurance Corporation","Federal Deposit Insurance Corporation","0","0","0","0","0","0","0.0","0.0","null","2020","1","2019","4","12","31"
"2019-12-31","Agency","Federal Election Commission","null","693299","94","498299","93","195000","1","71.87360720266436","98.93617021276596","Non-CFO","2020","1","2019","4","12","31"
"2019-12-31","Bureau","Federal Election Commission","Federal Election Commission","693299","94","498299","93","195000","1","71.87360720266436","98.93617021276596","null","2020","1","2019","4","12","31"
"2019-12-31","Agency","Federal Labor Relations Authority","null","0","0","0","0","0","0","0.0","0.0","Non-CFO","2020","1","2019","4","12","31"
"2019-12-31","Bureau","Federal Labor Relations Authority","Federal Labor Relations Authority","0","0","0","0","0","0","0.0","0.0","null","2020","1","2019","4","12","31"
"2019-12-31","Agency","Federal Maritime Commission","null","390949","10","390455","5","494","5","99.87364080736873","50.0","Non-CFO","2020","1","2019","4","12","31"
"2019-12-31","Bureau","Federal Maritime Commission","Salaries and Expenses","390949","10","390455","5","494","5","99.87364080736873","50.0","null","2020","1","2019","4","12","31"
"2019-12-31","Agency","Federal Mediation/Conciliation Service","null","0","0","0","0","0","0","0.0","0.0","Non-CFO","2020","1","2019","4","12","31"
"2019-12-31","Bureau","Federal Mediation/Conciliation Service","Federal Mediation/Conciliation Service","0","0","0","0","0","0","0.0","0.0","null","2020","1","2019","4","12","31"
"2019-12-31","Agency","Federal Trade Commission","null","483076197","62","483076197","62","0","0","100.0","100.0","Non-CFO","2020","1","2019","4","12","31"
"2019-12-31","Bureau","Federal Trade Commission","Federal Trade Commission","483076197","62","483076197","62","0","0","100.0","100.0","null","2020","1","2019","4","12","31"
"2019-12-31","Agency","Funds Appropriated to the President","null","0","0","0","0","0","0","0.0","0.0","Non-CFO","2020","1","2019","4","12","31"
"2019-12-31","Bureau","Funds Appropriated to the President","African Development Foundation","0","0","0","0","0","0","0.0","0.0","null","2020","1","2019","4","12","31"
"2019-12-31","Bureau","Funds Appropriated to the President","Defense Security Assistance Agency","0","0","0","0","0","0","0.0","0.0","null","2020","1","2019","4","12","31"
"2019-12-31","Bureau","Funds Appropriated to the President","Executive Branch","0","0","0","0","0","0","0.0","0.0","null","2020","1","2019","4","12","31"
"2019-12-31","Bureau","Funds Appropriated to the President","Inter-American Foundation","0","0","0","0","0","0","0.0","0.0","null","2020","1","2019","4","12","31"
"2019-12-31","Bureau","Funds Appropriated to the President","Peace Corps","0","0","0","0","0","0","0.0","0.0","null","2020","1","2019","4","12","31"
"2019-12-31","Bureau","Funds Appropriated to the President","Trade and Development Agency","0","0","0","0","0","0","0.0","0.0","null","2020","1","2019","4","12","31"
"2019-12-31","Agency","General Services Administration","null","18976227","4742","13507377","4425","5468850","317","71.18051971026695","93.31505693800085","CFO","2020","1","2019","4","12","31"
"2019-12-31","Bureau","General Services Administration","General Services Administration","18976227","4742","13507377","4425","5468850","317","71.18051971026695","93.31505693800085","null","2020","1","2019","4","12","31"
"2019-12-31","Agency","Legis Branch-Library of Congress","null","0","0","0","0","0","0","0.0","0.0","Non-CFO","2020","1","2019","4","12","31"
"2019-12-31","Bureau","Legis Branch-Library of Congress","Library of Congress","0","0","0","0","0","0","0.0","0.0","null","2020","1","2019","4","12","31"
"2019-12-31","Agency","Legislative Branch - U.S. House/Senate","null","211506","212","26459","21","185047","191","12.5098105963897","9.90566037735849","Non-CFO","2020","1","2019","4","12","31"
"2019-12-31","Bureau","Legislative Branch - U.S. House/Senate","U.S. House of Representatives","211506","212","26459","21","185047","191","12.5098105963897","9.90566037735849","null","2020","1","2019","4","12","31"
"2019-12-31","Agency","Legislative Branch-CBO","null","0","0","0","0","0","0","0.0","0.0","Non-CFO","2020","1","2019","4","12","31"
"2019-12-31","Bureau","Legislative Branch-CBO","Congressional Budget Office","0","0","0","0","0","0","0.0","0.0","null","2020","1","2019","4","12","31"
"2019-12-31","Agency","Legislative Branch-GAO","null","0","0","0","0","0","0","0.0","0.0","Non-CFO","2020","1","2019","4","12","31"
"2019-12-31","Bureau","Legislative Branch-GAO","Government Accountability Office","0","0","0","0","0","0","0.0","0.0","null","2020","1","2019","4","12","31"
"2019-12-31","Agency","Legislative Branch-GPO","null","84359","27","84359","27","0","0","100.0","100.0","Non-CFO","2020","1","2019","4","12","31"
"2019-12-31","Bureau","Legislative Branch-GPO","Government Publishing Office","84359","27","84359","27","0","0","100.0","100.0","null","2020","1","2019","4","12","31"
"2019-12-31","Agency","Legislative Branch-Office of Tech.","null","0","0","0","0","0","0","0.0","0.0","Non-CFO","2020","1","2019","4","12","31"
"2019-12-31","Bureau","Legislative Branch-Office of Tech.","Medicaid & CHIP Payment & Access Comm.","0","0","0","0","0","0","0.0","0.0","null","2020","1","2019","4","12","31"
"2019-12-31","Bureau","Legislative Branch-Office of Tech.","Open World Leadership","0","0","0","0","0","0","0.0","0.0","null","2020","1","2019","4","12","31"
"2019-12-31","Agency","Merit Systems Protection Board","null","143","1","143","1","0","0","100.0","100.0","Non-CFO","2020","1","2019","4","12","31"
"2019-12-31","Bureau","Merit Systems Protection Board","Merit Systems Protection Board","143","1","143","1","0","0","100.0","100.0","null","2020","1","2019","4","12","31"
"2019-12-31","Agency","National Aeronautics and Space Administration","null","7433722","126","7433722","125","0","1","100.0","99.2063492063492","CFO","2020","1","2019","4","12","31"
"2019-12-31","Bureau","National Aeronautics and Space Administration","National Aeronautics and Space Admin","7433722","126","7433722","125","0","1","100.0","99.2063492063492","null","2020","1","2019","4","12","31"
"2019-12-31","Agency","National Archives & Records Admin","null","131637","98","129593","95","2044","3","98.44724507547271","96.93877551020408","Non-CFO","2020","1","2019","4","12","31"
"2019-12-31","Bureau","National Archives & Records Admin","Nat'l Archives & Records Administration","131637","98","129593","95","2044","3","98.44724507547271","96.93877551020408","null","2020","1","2019","4","12","31"
"2019-12-31","Agency","National Credit Union Administration","null","0","0","0","0","0","0","0.0","0.0","Non-CFO","2020","1","2019","4","12","31"
"2019-12-31","Bureau","National Credit Union Administration","National Credit Union Administration","0","0","0","0","0","0","0.0","0.0","null","2020","1","2019","4","12","31"
"2019-12-31","Agency","National Foundation  Arts & Humanities","null","0","0","0","0","0","0","0.0","0.0","Non-CFO","2020","1","2019","4","12","31"
"2019-12-31","Bureau","National Foundation  Arts & Humanities","National Endowment for the Arts","0","0","0","0","0","0","0.0","0.0","null","2020","1","2019","4","12","31"
"2019-12-31","Bureau","National Foundation  Arts & Humanities","National Endowment for the Humanities","0","0","0","0","0","0","0.0","0.0","null","2020","1","2019","4","12","31"
"2019-12-31","Agency","National Labor Relations Board","null","0","0","0","0","0","0","0.0","0.0","Non-CFO","2020","1","2019","4","12","31"
"2019-12-31","Bureau","National Labor Relations Board","National Labor Relations Board","0","0","0","0","0","0","0.0","0.0","null","2020","1","2019","4","12","31"
"2019-12-31","Agency","National Science Foundation","null","510236","93","510236","93","0","0","100.0","100.0","CFO","2020","1","2019","4","12","31"
"2019-12-31","Bureau","National Science Foundation","National Science Foundation","510236","93","510236","93","0","0","100.0","100.0","null","2020","1","2019","4","12","31"
"2019-12-31","Agency","Neighborhood Reinvestment Corporation","null","0","0","0","0","0","0","0.0","0.0","Non-CFO","2020","1","2019","4","12","31"
"2019-12-31","Bureau","Neighborhood Reinvestment Corporation","Neighborhood Reinvestment Corporation","0","0","0","0","0","0","0.0","0.0","null","2020","1","2019","4","12","31"
"2019-12-31","Agency","Nuclear Regulatory Commission","null","1769362","257","1769362","257","0","0","100.0","100.0","CFO","2020","1","2019","4","12","31"
"2019-12-31","Bureau","Nuclear Regulatory Commission","Nuclear Regulatory Commission","1769362","257","1769362","257","0","0","100.0","100.0","null","2020","1","2019","4","12","31"
"2019-12-31","Agency","Occupational Safety & Health Rev Comm","null","0","0","0","0","0","0","0.0","0.0","Non-CFO","2020","1","2019","4","12","31"
"2019-12-31","Bureau","Occupational Safety & Health Rev Comm","Occupational Safety & Health Rev Comm","0","0","0","0","0","0","0.0","0.0","null","2020","1","2019","4","12","31"
"2019-12-31","Agency","Office of Compliance","null","0","0","0","0","0","0","0.0","0.0","Non-CFO","2020","1","2019","4","12","31"
"2019-12-31","Bureau","Office of Compliance","Office of Compliance","0","0","0","0","0","0","0.0","0.0","null","2020","1","2019","4","12","31"
"2019-12-31","Agency","Office of Government Ethics","null","0","0","0","0","0","0","0.0","0.0","Non-CFO","2020","1","2019","4","12","31"
"2019-12-31","Bureau","Office of Government Ethics","Office of Government Ethics","0","0","0","0","0","0","0.0","0.0","null","2020","1","2019","4","12","31"
"2019-12-31","Agency","Office of Personnel Management","null","23589548","1493","22652270","1384","937278","109","96.02672336070195","92.69926322839919","CFO","2020","1","2019","4","12","31"
"2019-12-31","Bureau","Office of Personnel Management","Office of Personnel Management","23589548","1493","22652270","1384","937278","109","96.02672336070195","92.69926322839919","null","2020","1","2019","4","12","31"
"2019-12-31","Agency","Office of Special Counsel","null","0","0","0","0","0","0","0.0","0.0","Non-CFO","2020","1","2019","4","12","31"
"2019-12-31","Bureau","Office of Special Counsel","Office of Special Counsel","0","0","0","0","0","0","0.0","0.0","null","2020","1","2019","4","12","31"
"2019-12-31","Agency","Other Agencies","null","5545813","99","4930","2","5540883","97","0.08889589317202004","2.0202020202020203","Non-CFO","2020","1","2019","4","12","31"
"2019-12-31","Bureau","Other Agencies","Advisory Council on Hist. Preservation","0","0","0","0","0","0","0.0","0.0","null","2020","1","2019","4","12","31"
"2019-12-31","Bureau","Other Agencies","Archit.&Trans. Barriers Compliance Bd","0","0","0","0","0","0","0.0","0.0","null","2020","1","2019","4","12","31"
"2019-12-31","Bureau","Other Agencies","Architect of the Capitol","0","0","0","0","0","0","0.0","0.0","null","2020","1","2019","4","12","31"
"2019-12-31","Bureau","Other Agencies","Chemical Safety Board","0","0","0","0","0","0","0.0","0.0","null","2020","1","2019","4","12","31"
"2019-12-31","Bureau","Other Agencies","Comm. for Purchase from Blind/Handic.","0","0","0","0","0","0","0.0","0.0","null","2020","1","2019","4","12","31"
"2019-12-31","Bureau","Other Agencies","Commission On Fine Arts","0","0","0","0","0","0","0.0","0.0","null","2020","1","2019","4","12","31"
"2019-12-31","Bureau","Other Agencies","Consumer Financial Protection Bureau","5310383","65","0","0","5310383","65","0.0","0.0","null","2020","1","2019","4","12","31"
"2019-12-31","Bureau","Other Agencies","Council of Insps. Gen. of Intg. & Effy.","4050","5","0","0","4050","5","0.0","0.0","null","2020","1","2019","4","12","31"
"2019-12-31","Bureau","Other Agencies","Defense Nuclear Facilities Safety Board","0","0","0","0","0","0","0.0","0.0","null","2020","1","2019","4","12","31"
"2019-12-31","Bureau","Other Agencies","Delta Regional Authority","0","0","0","0","0","0","0.0","0.0","null","2020","1","2019","4","12","31"
"2019-12-31","Bureau","Other Agencies","Denali Commission","0","0","0","0","0","0","0.0","0.0","null","2020","1","2019","4","12","31"
"2019-12-31","Bureau","Other Agencies","District of Columbia Government","0","0","0","0","0","0","0.0","0.0","null","2020","1","2019","4","12","31"
"2019-12-31","Bureau","Other Agencies","Election Assistance Commission","0","0","0","0","0","0","0.0","0.0","null","2020","1","2019","4","12","31"
"2019-12-31","Bureau","Other Agencies","Federal Housing Finance Agency","0","0","0","0","0","0","0.0","0.0","null","2020","1","2019","4","12","31"
"2019-12-31","Bureau","Other Agencies","Federal Housing Finance Agency OIG","0","0","0","0","0","0","0.0","0.0","null","2020","1","2019","4","12","31"
"2019-12-31","Bureau","Other Agencies","Federal Mine Safety & Health Review Comm","0","0","0","0","0","0","0.0","0.0","null","2020","1","2019","4","12","31"
"2019-12-31","Bureau","Other Agencies","Gulf Coast Ecosystem Restoration Council","0","0","0","0","0","0","0.0","0.0","null","2020","1","2019","4","12","31"
"2019-12-31","Bureau","Other Agencies","James Madison Memorial Fellowship","221290","25","0","0","221290","25","0.0","0.0","null","2020","1","2019","4","12","31"
"2019-12-31","Bureau","Other Agencies","Millennium Challenge Corporation","0","0","0","0","0","0","0.0","0.0","null","2020","1","2019","4","12","31"
"2019-12-31","Bureau","Other Agencies","Morris K. Udall Scholarship","982","1","0","0","982","1","0.0","0.0","null","2020","1","2019","4","12","31"
"2019-12-31","Bureau","Other Agencies","National Capital Planning Commission","0","0","0","0","0","0","0.0","0.0","null","2020","1","2019","4","12","31"
"2019-12-31","Bureau","Other Agencies","National Council on Disability","0","0","0","0","0","0","0.0","0.0","null","2020","1","2019","4","12","31"
"2019-12-31","Bureau","Other Agencies","National Mediation Board","0","0","0","0","0","0","0.0","0.0","null","2020","1","2019","4","12","31"
"2019-12-31","Bureau","Other Agencies","National Transportation Safety Board","0","0","0","0","0","0","0.0","0.0","null","2020","1","2019","4","12","31"
"2019-12-31","Bureau","Other Agencies","Surface Transportation Board","0","0","0","0","0","0","0.0","0.0","null","2020","1","2019","4","12","31"
"2019-12-31","Bureau","Other Agencies","U.S.  Agency of Global Media","4930","2","4930","2","0","0","100.0","100.0","null","2020","1","2019","4","12","31"
"2019-12-31","Bureau","Other Agencies","U.S. Holocaust Memorial Council","0","0","0","0","0","0","0.0","0.0","null","2020","1","2019","4","12","31"
"2019-12-31","Bureau","Other Agencies","U.S. Inst. for Env. Conflict Resolution","4178","1","0","0","4178","1","0.0","0.0","null","2020","1","2019","4","12","31"
"2019-12-31","Bureau","Other Agencies","U.S. Institute of Peace","0","0","0","0","0","0","0.0","0.0","null","2020","1","2019","4","12","31"
"2019-12-31","Agency","Other Agencies/Boards/Commissions","null","393","1","0","0","393","1","0.0","0.0","Non-CFO","2020","1","2019","4","12","31"
"2019-12-31","Bureau","Other Agencies/Boards/Commissions","Medicare Payment Advisory Commission","0","0","0","0","0","0","0.0","0.0","null","2020","1","2019","4","12","31"
"2019-12-31","Bureau","Other Agencies/Boards/Commissions","U.S. Comm. on Int. Religious Freedom","393","1","0","0","393","1","0.0","0.0","null","2020","1","2019","4","12","31"
"2019-12-31","Bureau","Other Agencies/Boards/Commissions","U.S.-China Security Review Commission","0","0","0","0","0","0","0.0","0.0","null","2020","1","2019","4","12","31"
"2019-12-31","Agency","Overseas Private Investment Corp Accts","null","0","0","0","0","0","0","0.0","0.0","Non-CFO","2020","1","2019","4","12","31"
"2019-12-31","Bureau","Overseas Private Investment Corp Accts","Overseas Private Investment Corp Accts","0","0","0","0","0","0","0.0","0.0","null","2020","1","2019","4","12","31"
"2019-12-31","Agency","Pension Benefit Guaranty Corp","null","1328482","1523","1328482","1523","0","0","100.0","100.0","Non-CFO","2020","1","2019","4","12","31"
"2019-12-31","Bureau","Pension Benefit Guaranty Corp","Pension Benefit Guaranty Corporation","1328482","1523","1328482","1523","0","0","100.0","100.0","null","2020","1","2019","4","12","31"
"2019-12-31","Agency","Presidio Trust Corporation","null","1432424","85","1351737","71","80687","14","94.36710080255567","83.52941176470588","Non-CFO","2020","1","2019","4","12","31"
"2019-12-31","Bureau","Presidio Trust Corporation","Presidio Trust Corporation","1432424","85","1351737","71","80687","14","94.36710080255567","83.52941176470588","null","2020","1","2019","4","12","31"
"2019-12-31","Agency","Railroad Retirement Board","null","20495013","4346","20495013","4346","0","0","100.0","100.0","Non-CFO","2020","1","2019","4","12","31"
"2019-12-31","Bureau","Railroad Retirement Board","Railroad Retirement Board","20495013","4346","20495013","4346","0","0","100.0","100.0","null","2020","1","2019","4","12","31"
"2019-12-31","Agency","Securities & Exchange Commission","null","2331996317","1122","2331996317","1122","0","0","100.0","100.0","Non-CFO","2020","1","2019","4","12","31"
"2019-12-31","Bureau","Securities & Exchange Commission","SEC Enforcement","0","0","0","0","0","0","0.0","0.0","null","2020","1","2019","4","12","31"
"2019-12-31","Bureau","Securities & Exchange Commission","Securities and Exchange Commission","2331996317","1122","2331996317","1122","0","0","100.0","100.0","null","2020","1","2019","4","12","31"
"2019-12-31","Agency","Selective Service System","null","0","0","0","0","0","0","0.0","0.0","Non-CFO","2020","1","2019","4","12","31"
"2019-12-31","Bureau","Selective Service System","Selective Service System","0","0","0","0","0","0","0.0","0.0","null","2020","1","2019","4","12","31"
"2019-12-31","Agency","Small Business Administration","null","12275607225","121140","12264351108","121054","11256117","86","99.90830500851253","99.92900775961697","CFO","2020","1","2019","4","12","31"
"2019-12-31","Bureau","Small Business Administration","Small Business Administration","12275607225","121140","12264351108","121054","11256117","86","99.90830500851253","99.92900775961697","null","2020","1","2019","4","12","31"
"2019-12-31","Agency","Smithsonian Institution","null","1065","2","0","0","1065","2","0.0","0.0","Non-CFO","2020","1","2019","4","12","31"
"2019-12-31","Bureau","Smithsonian Institution","Administrative Conference of the US","0","0","0","0","0","0","0.0","0.0","null","2020","1","2019","4","12","31"
"2019-12-31","Bureau","Smithsonian Institution","JFK Center for the Performing Arts","1065","2","0","0","1065","2","0.0","0.0","null","2020","1","2019","4","12","31"
"2019-12-31","Bureau","Smithsonian Institution","National Gallery of Art","0","0","0","0","0","0","0.0","0.0","null","2020","1","2019","4","12","31"
"2019-12-31","Bureau","Smithsonian Institution","Smithsonian Institution","0","0","0","0","0","0","0.0","0.0","null","2020","1","2019","4","12","31"
"2019-12-31","Agency","Social Security Administration","null","5335610207","1663503","2872227966","516652","2463382241","1146851","53.831293039956506","31.058074436896117","CFO","2020","1","2019","4","12","31"
"2019-12-31","Bureau","Social Security Administration","Social Security Administration","5335610207","1663503","2872227966","516652","2463382241","1146851","53.831293039956506","31.058074436896117","null","2020","1","2019","4","12","31"
"2019-12-31","Agency","Tennessee Valley Authority","null","9694","0","0","0","9694","0","0.0","0.0","Non-CFO","2020","1","2019","4","12","31"
"2019-12-31","Bureau","Tennessee Valley Authority","Tennessee Valley Authority","9694","0","0","0","9694","0","0.0","0.0","null","2020","1","2019","4","12","31"
"2019-12-31","Agency","The Judiciary","null","1076098","330","1064456","206","11642","124","98.91812827456235","62.42424242424242","Non-CFO","2020","1","2019","4","12","31"
"2019-12-31","Bureau","The Judiciary","Administrative Office of the U.S. Courts","1076098","330","1064456","206","11642","124","98.91812827456235","62.42424242424242","null","2020","1","2019","4","12","31"
"2019-12-31","Agency","U.S. Court of Appeals / Veterans Claims","null","4164","4","4164","4","0","0","100.0","100.0","Non-CFO","2020","1","2019","4","12","31"
"2019-12-31","Bureau","U.S. Court of Appeals / Veterans Claims","U.S. Court of Appeals / Veterans Claims","4164","4","4164","4","0","0","100.0","100.0","null","2020","1","2019","4","12","31"
"2019-12-31","Agency","U.S. Postal Service","null","67785043","45315","41010197","40309","26774846","5006","60.50036288978971","88.95288535804922","Non-CFO","2020","1","2019","4","12","31"
"2019-12-31","Bureau","U.S. Postal Service","U.S. Postal Service","67785043","45315","41010197","40309","26774846","5006","60.50036288978971","88.95288535804922","null","2020","1","2019","4","12","31"
"2019-09-30","Agency","Agency for International Development","null","27856572","56","27852593","54","3979","2","99.9857161175467","96.42857142857143","CFO","2019","4","2019","3","09","30"
"2019-09-30","Bureau","Agency for International Development","Agency for International Development","27856572","56","27852593","54","3979","2","99.9857161175467","96.42857142857143","null","2019","4","2019","3","09","30"
"2019-09-30","Agency","American Battle Monuments Commission","null","0","0","0","0","0","0","0.0","0.0","Non-CFO","2019","4","2019","3","09","30"
"2019-09-30","Bureau","American Battle Monuments Commission","American Battle Monuments Commission","0","0","0","0","0","0","0.0","0.0","null","2019","4","2019","3","09","30"
"2019-09-30","Agency","Armed Forces Retirement Home","null","82250","106","81605","102","645","4","99.21580547112463","96.22641509433963","Non-CFO","2019","4","2019","3","09","30"
"2019-09-30","Bureau","Armed Forces Retirement Home","Armed Forces Retirement Home","82250","106","81605","102","645","4","99.21580547112463","96.22641509433963","null","2019","4","2019","3","09","30"
"2019-09-30","Agency","Commodity Futures Trading Commission","null","640368451","371","640368451","371","0","0","100.0","100.0","Non-CFO","2019","4","2019","3","09","30"
"2019-09-30","Bureau","Commodity Futures Trading Commission","Commodity Futures Trading Commission","640368451","371","640368451","371","0","0","100.0","100.0","null","2019","4","2019","3","09","30"
"2019-09-30","Agency","Consumer Product Safety Commission","null","479","1","479","1","0","0","100.0","100.0","Non-CFO","2019","4","2019","3","09","30"
"2019-09-30","Bureau","Consumer Product Safety Commission","Consumer Product Safety Commission","479","1","479","1","0","0","100.0","100.0","null","2019","4","2019","3","09","30"
"2019-09-30","Agency","Corp. for National and Community Service","null","3597668","227","3587386","214","10282","13","99.71420375643334","94.27312775330397","Non-CFO","2019","4","2019","3","09","30"
"2019-09-30","Bureau","Corp. for National and Community Service","Corp. for National and Community Service","3597668","227","3587386","214","10282","13","99.71420375643334","94.27312775330397","null","2019","4","2019","3","09","30"
"2019-09-30","Agency","Department of Agriculture","null","1730452043","65349","1712852427","63657","17599616","1692","98.98294690851482","97.41082495524033","CFO","2019","4","2019","3","09","30"
"2019-09-30","Bureau","Department of Agriculture","Agricultural Marketing Service","4761985","1029","4383489","475","378496","554","92.0517179285529","46.161321671525755","null","2019","4","2019","3","09","30"
"2019-09-30","Bureau","Department of Agriculture","Commodity Credit Corporation","122722407","10451","122634731","10443","87676","8","99.92855746383788","99.92345230121519","null","2019","4","2019","3","09","30"
"2019-09-30","Bureau","Department of Agriculture","Farm Service Agency","794796670","15787","794796670","15787","0","0","100.0","100.0","null","2019","4","2019","3","09","30"
"2019-09-30","Bureau","Department of Agriculture","Federal Crop Insurance Corporation","58142","409","53971","408","4171","1","92.8261841697912","99.75550122249389","null","2019","4","2019","3","09","30"
"2019-09-30","Bureau","Department of Agriculture","Food Safety and Inspection Service","1049599","1480","1049530","1479","69","1","99.9934260608099","99.93243243243244","null","2019","4","2019","3","09","30"
"2019-09-30","Bureau","Department of Agriculture","Food and Nutrition Service","6951649","27","48140","7","6903509","20","0.6924975642469866","25.925925925925927","null","2019","4","2019","3","09","30"
"2019-09-30","Bureau","Department of Agriculture","Forest Service","59054775","561","53971040","283","5083735","278","91.39149205123549","50.445632798573975","null","2019","4","2019","3","09","30"
"2019-09-30","Bureau","Department of Agriculture","Rural Development","712388027","33007","712385546","33005","2481","2","99.99965173474203","99.99394067924986","null","2019","4","2019","3","09","30"
"2019-09-30","Bureau","Department of Agriculture","U.S. Department of Agriculture","28668789","2598","23529310","1770","5139479","828","82.07291211358806","68.12933025404158","null","2019","4","2019","3","09","30"
"2019-09-30","Agency","Department of Commerce","null","19305387","1419","19305387","1419","0","0","100.0","100.0","CFO","2019","4","2019","3","09","30"
"2019-09-30","Bureau","Department of Commerce","Bureau of Industry and Security","637797","13","637797","13","0","0","100.0","100.0","null","2019","4","2019","3","09","30"
"2019-09-30","Bureau","Department of Commerce","Bureau of the Census","324374","228","324374","228","0","0","100.0","100.0","null","2019","4","2019","3","09","30"
"2019-09-30","Bureau","Department of Commerce","Economic Development Administration","5113460","9","5113460","9","0","0","100.0","100.0","null","2019","4","2019","3","09","30"
"2019-09-30","Bureau","Department of Commerce","Economic and Statistical Analysis","0","0","0","0","0","0","0.0","0.0","null","2019","4","2019","3","09","30"
"2019-09-30","Bureau","Department of Commerce","General Administration","4660","1","4660","1","0","0","100.0","100.0","null","2019","4","2019","3","09","30"
"2019-09-30","Bureau","Department of Commerce","International Trade Administration","0","0","0","0","0","0","0.0","0.0","null","2019","4","2019","3","09","30"
"2019-09-30","Bureau","Department of Commerce","Minority Business Development Agency","0","0","0","0","0","0","0.0","0.0","null","2019","4","2019","3","09","30"
"2019-09-30","Bureau","Department of Commerce","NOAA","11758017","637","11758017","637","0","0","100.0","100.0","null","2019","4","2019","3","09","30"
"2019-09-30","Bureau","Department of Commerce","Nat'l Institute of Standards& Technology","667997","3","667997","3","0","0","100.0","100.0","null","2019","4","2019","3","09","30"
"2019-09-30","Bureau","Department of Commerce","Nat'l Telecomm & Information Admin.","407580","3","407580","3","0","0","100.0","100.0","null","2019","4","2019","3","09","30"
"2019-09-30","Bureau","Department of Commerce","National Technical Information Service","0","0","0","0","0","0","0.0","0.0","null","2019","4","2019","3","09","30"
"2019-09-30","Bureau","Department of Commerce","Office of the Inspector General","0","0","0","0","0","0","0.0","0.0","null","2019","4","2019","3","09","30"
"2019-09-30","Bureau","Department of Commerce","Patent and Trademark Office","391502","525","391502","525","0","0","100.0","100.0","null","2019","4","2019","3","09","30"
"2019-09-30","Agency","Department of Defense","null","2271056249","1429077","1120634170","298695","1150422079","1130382","49.344183812859846","20.901253046546827","CFO","2019","4","2019","3","09","30"
"2019-09-30","Bureau","Department of Defense","Consolidated Report","2271056249","1429077","1120634170","298695","1150422079","1130382","49.344183812859846","20.901253046546827","null","2019","4","2019","3","09","30"
"2019-09-30","Agency","Department of Education","null","168394045917","28601259","144570588795","23554086","23823457122","5047173","85.85255375730898","82.35331878222564","CFO","2019","4","2019","3","09","30"
"2019-09-30","Bureau","Department of Education","Departmental Management","728411558","1801","721912205","1789","6499353","12","99.10773615154525","99.33370349805664","null","2019","4","2019","3","09","30"
"2019-09-30","Bureau","Department of Education","Federal Student Aid","167665634359","28599458","143848676590","23552297","23816957769","5047161","85.79496754951946","82.3522494726998","null","2019","4","2019","3","09","30"
"2019-09-30","Bureau","Department of Education","Office of Postsecondary Education","0","0","0","0","0","0","0.0","0.0","null","2019","4","2019","3","09","30"
"2019-09-30","Agency","Department of Energy","null","14460549","94","14460549","94","0","0","100.0","100.0","CFO","2019","4","2019","3","09","30"
"2019-09-30","Bureau","Department of Energy","Bonneville Power Administration","1082579","31","1082579","31","0","0","100.0","100.0","null","2019","4","2019","3","09","30"
"2019-09-30","Bureau","Department of Energy","Energy Consolidated Reports","13377970","63","13377970","63","0","0","100.0","100.0","null","2019","4","2019","3","09","30"
"2019-09-30","Agency","Department of Health & Human Services","null","9545375129","1134288","9434136992","1116587","111238137","17701","98.83463839297373","98.43946158294895","CFO","2019","4","2019","3","09","30"
"2019-09-30","Bureau","Department of Health & Human Services","Administration for Children and Families","27975600","1670","27975600","1670","0","0","100.0","100.0","null","2019","4","2019","3","09","30"
"2019-09-30","Bureau","Department of Health & Human Services","Administration for Community Living","0","0","0","0","0","0","0.0","0.0","null","2019","4","2019","3","09","30"
"2019-09-30","Bureau","Department of Health & Human Services","Centers for Disease Control","6931103","145","59961","12","6871142","133","0.8651004032114369","8.275862068965518","null","2019","4","2019","3","09","30"
"2019-09-30","Bureau","Department of Health & Human Services","Centers for Medicare & Medicaid Services","9310156514","1122619","9235685824","1112304","74470690","10315","99.20011344720128","99.08116645095086","null","2019","4","2019","3","09","30"
"2019-09-30","Bureau","Department of Health & Human Services","Food and Drug Administration","56482100","5885","35329624","1129","21152476","4756","62.55012472978165","19.184367034834324","null","2019","4","2019","3","09","30"
"2019-09-30","Bureau","Department of Health & Human Services","Health Resources and Services Admin","98587493","543","98587493","543","0","0","100.0","100.0","null","2019","4","2019","3","09","30"
"2019-09-30","Bureau","Department of Health & Human Services","Indian Health Services","25538326","2338","25176387","176","361939","2162","98.58276145429423","7.527801539777587","null","2019","4","2019","3","09","30"
"2019-09-30","Bureau","Department of Health & Human Services","National Institutes of Health","13191220","418","4809330","83","8381890","335","36.45856865399865","19.85645933014354","null","2019","4","2019","3","09","30"
"2019-09-30","Bureau","Department of Health & Human Services","Office of the Inspector General","0","0","0","0","0","0","0.0","0.0","null","2019","4","2019","3","09","30"
"2019-09-30","Bureau","Department of Health & Human Services","Office of the Secretary","8853","13","8853","13","0","0","100.0","100.0","null","2019","4","2019","3","09","30"
"2019-09-30","Bureau","Department of Health & Human Services","Program Support Center","5550136","643","5550136","643","0","0","100.0","100.0","null","2019","4","2019","3","09","30"
"2019-09-30","Bureau","Department of Health & Human Services","Substance Abuse & Mental Health Admin.","953784","14","953784","14","0","0","100.0","100.0","null","2019","4","2019","3","09","30"
"2019-09-30","Agency","Department of Homeland Security","null","364952489","61838","364952489","61838","0","0","100.0","100.0","CFO","2019","4","2019","3","09","30"
"2019-09-30","Bureau","Department of Homeland Security","Bureau of Customs & Border Protection","11830916","674","11830916","674","0","0","100.0","100.0","null","2019","4","2019","3","09","30"
"2019-09-30","Bureau","Department of Homeland Security","Citizenship and Immigration Services","993992","1226","993992","1226","0","0","100.0","100.0","null","2019","4","2019","3","09","30"
"2019-09-30","Bureau","Department of Homeland Security","Domestic Nuclear Detection Office","0","0","0","0","0","0","0.0","0.0","null","2019","4","2019","3","09","30"
"2019-09-30","Bureau","Department of Homeland Security","Emergency Preparedness & Resp","257655449","42959","257655449","42959","0","0","100.0","100.0","null","2019","4","2019","3","09","30"
"2019-09-30","Bureau","Department of Homeland Security","Federal Law Enforcement Training Ctr.","0","0","0","0","0","0","0.0","0.0","null","2019","4","2019","3","09","30"
"2019-09-30","Bureau","Department of Homeland Security","Immigration and Customs Enforcement","10008836","421","10008836","421","0","0","100.0","100.0","null","2019","4","2019","3","09","30"
"2019-09-30","Bureau","Department of Homeland Security","Info Analysis Infrastructure Prot-NPPD","0","0","0","0","0","0","0.0","0.0","null","2019","4","2019","3","09","30"
"2019-09-30","Bureau","Department of Homeland Security","Management Headquarters","159","1","159","1","0","0","100.0","100.0","null","2019","4","2019","3","09","30"
"2019-09-30","Bureau","Department of Homeland Security","Office of Biometric Identity Management","0","0","0","0","0","0","0.0","0.0","null","2019","4","2019","3","09","30"
"2019-09-30","Bureau","Department of Homeland Security","Office of Health Affairs","0","0","0","0","0","0","0.0","0.0","null","2019","4","2019","3","09","30"
"2019-09-30","Bureau","Department of Homeland Security","Office of the Inspector General DHS","97","1","97","1","0","0","100.0","100.0","null","2019","4","2019","3","09","30"
"2019-09-30","Bureau","Department of Homeland Security","Science and Technology","0","0","0","0","0","0","0.0","0.0","null","2019","4","2019","3","09","30"
"2019-09-30","Bureau","Department of Homeland Security","Transportation Safety Administration","8306901","5597","8306901","5597","0","0","100.0","100.0","null","2019","4","2019","3","09","30"
"2019-09-30","Bureau","Department of Homeland Security","U.S. Coast Guard","76156139","10959","76156139","10959","0","0","100.0","100.0","null","2019","4","2019","3","09","30"
"2019-09-30","Bureau","Department of Homeland Security","U.S. Secret Service","0","0","0","0","0","0","0.0","0.0","null","2019","4","2019","3","09","30"
"2019-09-30","Agency","Department of Housing and Urban Development","null","166640703","6384","166603243","6381","37460","3","99.97752049809823","99.953007518797","CFO","2019","4","2019","3","09","30"
"2019-09-30","Bureau","Department of Housing and Urban Development","Community Planning and Development","0","0","0","0","0","0","0.0","0.0","null","2019","4","2019","3","09","30"
"2019-09-30","Bureau","Department of Housing and Urban Development","Government National Mortgage Association","0","0","0","0","0","0","0.0","0.0","null","2019","4","2019","3","09","30"
"2019-09-30","Bureau","Department of Housing and Urban Development","Housing Programs","166640139","6383","166602679","6380","37460","3","99.97752042201549","99.95300015666615","null","2019","4","2019","3","09","30"
"2019-09-30","Bureau","Department of Housing and Urban Development","Management and Administration","0","0","0","0","0","0","0.0","0.0","null","2019","4","2019","3","09","30"
"2019-09-30","Bureau","Department of Housing and Urban Development","Policy, Development and Research","0","0","0","0","0","0","0.0","0.0","null","2019","4","2019","3","09","30"
"2019-09-30","Bureau","Department of Housing and Urban Development","Public and Indian Housing Programs","564","1","564","1","0","0","100.0","100.0","null","2019","4","2019","3","09","30"
"2019-09-30","Agency","Department of Justice","null","82788564","35906","82023399","35621","765165","285","99.07576002888514","99.20626079206818","CFO","2019","4","2019","3","09","30"
"2019-09-30","Bureau","Department of Justice","Bureau of ATF and Explosives","21553","4","21553","4","0","0","100.0","100.0","null","2019","4","2019","3","09","30"
"2019-09-30","Bureau","Department of Justice","Drug Enforcement Administration","331509","22","331509","22","0","0","100.0","100.0","null","2019","4","2019","3","09","30"
"2019-09-30","Bureau","Department of Justice","Federal Bureau of Investigation","203617","59","203617","59","0","0","100.0","100.0","null","2019","4","2019","3","09","30"
"2019-09-30","Bureau","Department of Justice","Federal Prison Industries","1043089","183","1043089","183","0","0","100.0","100.0","null","2019","4","2019","3","09","30"
"2019-09-30","Bureau","Department of Justice","Federal Prison System","757448","104","757448","104","0","0","100.0","100.0","null","2019","4","2019","3","09","30"
"2019-09-30","Bureau","Department of Justice","General Administration","0","0","0","0","0","0","0.0","0.0","null","2019","4","2019","3","09","30"
"2019-09-30","Bureau","Department of Justice","Legal Activities","80087319","35433","79322154","35148","765165","285","99.0445865718142","99.19566505799678","null","2019","4","2019","3","09","30"
"2019-09-30","Bureau","Department of Justice","Office of Justice Assistance Programs","344029","101","344029","101","0","0","100.0","100.0","null","2019","4","2019","3","09","30"
"2019-09-30","Bureau","Department of Justice","U.S. Marshals Service","0","0","0","0","0","0","0.0","0.0","null","2019","4","2019","3","09","30"
"2019-09-30","Agency","Department of Labor","null","149484221","35558","131104252","19325","18379969","16233","87.70440861447176","54.34782608695652","CFO","2019","4","2019","3","09","30"
"2019-09-30","Bureau","Department of Labor","Bureau of Labor Statistics","11381","1","11381","1","0","0","100.0","100.0","null","2019","4","2019","3","09","30"
"2019-09-30","Bureau","Department of Labor","Departmental Management","0","0","0","0","0","0","0.0","0.0","null","2019","4","2019","3","09","30"
"2019-09-30","Bureau","Department of Labor","Employee Benefit Security Administration","17227545","401","17227545","401","0","0","100.0","100.0","null","2019","4","2019","3","09","30"
"2019-09-30","Bureau","Department of Labor","Employment Standards Administration","76286933","18284","61416982","3828","14869951","14456","80.50786626852596","20.93633778166703","null","2019","4","2019","3","09","30"
"2019-09-30","Bureau","Department of Labor","Employment and Training Administration","3167034","4","3167034","4","0","0","100.0","100.0","null","2019","4","2019","3","09","30"
"2019-09-30","Bureau","Department of Labor","Mine Safety and Health Administration","41648883","16015","38815299","14313","2833584","1702","93.19649460947127","89.37246331564158","null","2019","4","2019","3","09","30"
"2019-09-30","Bureau","Department of Labor","Occupational Safety and Health Admin","11142445","853","10466011","778","676434","75","93.9292139202841","91.20750293083236","null","2019","4","2019","3","09","30"
"2019-09-30","Agency","Department of State","null","17679785","24180","17278172","24135","401613","45","97.72840563389204","99.81389578163771","CFO","2019","4","2019","3","09","30"
"2019-09-30","Bureau","Department of State","Civil Monetary Penalties","0","0","0","0","0","0","0.0","0.0","null","2019","4","2019","3","09","30"
"2019-09-30","Bureau","Department of State","Department of State","14978097","6760","14576484","6715","401613","45","97.3186647142157","99.33431952662721","null","2019","4","2019","3","09","30"
"2019-09-30","Bureau","Department of State","International Commissions","0","0","0","0","0","0","0.0","0.0","null","2019","4","2019","3","09","30"
"2019-09-30","Bureau","Department of State","Passport NSF","2701688","17420","2701688","17420","0","0","100.0","100.0","null","2019","4","2019","3","09","30"
"2019-09-30","Agency","Department of Transportation","null","56763844","6744","56710750","6727","53094","17","99.90646510831789","99.74792408066429","CFO","2019","4","2019","3","09","30"
"2019-09-30","Bureau","Department of Transportation","Federal Aviation Administration","2263237","364","2212765","349","50472","15","97.76991980954712","95.87912087912088","null","2019","4","2019","3","09","30"
"2019-09-30","Bureau","Department of Transportation","Federal Highway Administration","8119","7","8119","7","0","0","100.0","100.0","null","2019","4","2019","3","09","30"
"2019-09-30","Bureau","Department of Transportation","Federal Motor Carrier Safety Admin","52168121","6299","52165499","6297","2622","2","99.99497394203637","99.96824892840134","null","2019","4","2019","3","09","30"
"2019-09-30","Bureau","Department of Transportation","Federal Railroad Administration","168424","17","168424","17","0","0","100.0","100.0","null","2019","4","2019","3","09","30"
"2019-09-30","Bureau","Department of Transportation","Federal Transit Administration","784404","2","784404","2","0","0","100.0","100.0","null","2019","4","2019","3","09","30"
"2019-09-30","Bureau","Department of Transportation","Maritime Administration","4564","5","4564","5","0","0","100.0","100.0","null","2019","4","2019","3","09","30"
"2019-09-30","Bureau","Department of Transportation","National Highway Traffic Safety Admin.","25954","4","25954","4","0","0","100.0","100.0","null","2019","4","2019","3","09","30"
"2019-09-30","Bureau","Department of Transportation","Office of the Inspector General","205","1","205","1","0","0","100.0","100.0","null","2019","4","2019","3","09","30"
"2019-09-30","Bureau","Department of Transportation","Office of the Secretary","998611","18","998611","18","0","0","100.0","100.0","null","2019","4","2019","3","09","30"
"2019-09-30","Bureau","Department of Transportation","Pipeline Hazardous Material Safety Admin","334298","22","334298","22","0","0","100.0","100.0","null","2019","4","2019","3","09","30"
"2019-09-30","Bureau","Department of Transportation","Research Innovative Technology Admin","3564","4","3564","4","0","0","100.0","100.0","null","2019","4","2019","3","09","30"
"2019-09-30","Bureau","Department of Transportation","St. Lawrence Seaway Development Corp.","4343","1","4343","1","0","0","100.0","100.0","null","2019","4","2019","3","09","30"
"2019-09-30","Bureau","Department of Transportation","Surface Transportation Board","0","0","0","0","0","0","0.0","0.0","null","2019","4","2019","3","09","30"
"2019-09-30","Agency","Department of Veterans Affairs","null","1175350477","8850936","1070934319","8739730","104416158","111206","91.11616832227652","98.7435679119135","CFO","2019","4","2019","3","09","30"
"2019-09-30","Bureau","Department of Veterans Affairs","Administration and Cemeteries","1234666","761","6884","8","1227782","753","0.5575596963065315","1.0512483574244416","null","2019","4","2019","3","09","30"
"2019-09-30","Bureau","Department of Veterans Affairs","Housing Credit Assistance","9994453","132","432112","29","9562341","103","4.323518255576368","21.96969696969697","null","2019","4","2019","3","09","30"
"2019-09-30","Bureau","Department of Veterans Affairs","Life Insurance","574539","104","574539","104","0","0","100.0","100.0","null","2019","4","2019","3","09","30"
"2019-09-30","Bureau","Department of Veterans Affairs","Medical and Construction","630794881","8732437","538456927","8623776","92337954","108661","85.36165134161892","98.75566236550003","null","2019","4","2019","3","09","30"
"2019-09-30","Bureau","Department of Veterans Affairs","Veterans Benefits","532751938","117502","531463857","115813","1288081","1689","99.75822124555087","98.56257765825262","null","2019","4","2019","3","09","30"
"2019-09-30","Agency","Department of the Interior","null","45537539","33336","45534593","33315","2946","21","99.9935306121835","99.93700503959683","CFO","2019","4","2019","3","09","30"
"2019-09-30","Bureau","Department of the Interior","Bureau of Indian Affairs","15307079","30158","15304133","30137","2946","21","99.98075400277219","99.93036673519464","null","2019","4","2019","3","09","30"
"2019-09-30","Bureau","Department of the Interior","Bureau of Land Management","17794985","282","17794985","282","0","0","100.0","100.0","null","2019","4","2019","3","09","30"
"2019-09-30","Bureau","Department of the Interior","Bureau of Ocean Energy Mgmt., Reg & Enf","0","0","0","0","0","0","0.0","0.0","null","2019","4","2019","3","09","30"
"2019-09-30","Bureau","Department of the Interior","Bureau of Reclamation","113731","91","113731","91","0","0","100.0","100.0","null","2019","4","2019","3","09","30"
"2019-09-30","Bureau","Department of the Interior","Bureau of Safety and Environmental Enf.","14571","5","14571","5","0","0","100.0","100.0","null","2019","4","2019","3","09","30"
"2019-09-30","Bureau","Department of the Interior","Fish and Wildlife Service","605036","95","605036","95","0","0","100.0","100.0","null","2019","4","2019","3","09","30"
"2019-09-30","Bureau","Department of the Interior","Geological Survey","287271","145","287271","145","0","0","100.0","100.0","null","2019","4","2019","3","09","30"
"2019-09-30","Bureau","Department of the Interior","National Park Service","6739443","1973","6739443","1973","0","0","100.0","100.0","null","2019","4","2019","3","09","30"
"2019-09-30","Bureau","Department of the Interior","Office of Natural Resources Revenue","2482484","330","2482484","330","0","0","100.0","100.0","null","2019","4","2019","3","09","30"
"2019-09-30","Bureau","Department of the Interior","Office of Surface Mining","2164202","240","2164202","240","0","0","100.0","100.0","null","2019","4","2019","3","09","30"
"2019-09-30","Bureau","Department of the Interior","Office of the Secretary","28737","17","28737","17","0","0","100.0","100.0","null","2019","4","2019","3","09","30"
"2019-09-30","Agency","Department of the Treasury","null","55223485","6140","49371409","5759","5852076","381","89.4029216011992","93.79478827361564","CFO","2019","4","2019","3","09","30"
"2019-09-30","Bureau","Department of the Treasury","Bureau of Engraving and Printing","84528","1","84528","1","0","0","100.0","100.0","null","2019","4","2019","3","09","30"
"2019-09-30","Bureau","Department of the Treasury","Bureau of the Fiscal Service","13413599","4526","13413599","4526","0","0","100.0","100.0","null","2019","4","2019","3","09","30"
"2019-09-30","Bureau","Department of the Treasury","Community Dev Financial Inst Fund","4031760","7","4031760","7","0","0","100.0","100.0","null","2019","4","2019","3","09","30"
"2019-09-30","Bureau","Department of the Treasury","Comptroller of the Currency","1123344","22","1123344","22","0","0","100.0","100.0","null","2019","4","2019","3","09","30"
"2019-09-30","Bureau","Department of the Treasury","D.C. Pension Program","334437","18","334437","18","0","0","100.0","100.0","null","2019","4","2019","3","09","30"
"2019-09-30","Bureau","Department of the Treasury","Departmental Offices","34391594","1417","28540182","1037","5851412","380","82.98592382778187","73.18278052223006","null","2019","4","2019","3","09","30"
"2019-09-30","Bureau","Department of the Treasury","Financial Crimes Enforcement Network","1544945","3","1544945","3","0","0","100.0","100.0","null","2019","4","2019","3","09","30"
"2019-09-30","Bureau","Department of the Treasury","Interest on Tax/Deposit of Earnings","0","0","0","0","0","0","0.0","0.0","null","2019","4","2019","3","09","30"
"2019-09-30","Bureau","Department of the Treasury","Internal Revenue Service","247319","124","247319","124","0","0","100.0","100.0","null","2019","4","2019","3","09","30"
"2019-09-30","Bureau","Department of the Treasury","International Monetary Funds","0","0","0","0","0","0","0.0","0.0","null","2019","4","2019","3","09","30"
"2019-09-30","Bureau","Department of the Treasury","Office of Financial Research","0","0","0","0","0","0","0.0","0.0","null","2019","4","2019","3","09","30"
"2019-09-30","Bureau","Department of the Treasury","Office of Sec International Affairs","0","0","0","0","0","0","0.0","0.0","null","2019","4","2019","3","09","30"
"2019-09-30","Bureau","Department of the Treasury","Office of the Secretary","0","0","0","0","0","0","0.0","0.0","null","2019","4","2019","3","09","30"
"2019-09-30","Bureau","Department of the Treasury","Spec Insp Gen-Troubled Asset Rel Prog","3916","1","3916","1","0","0","100.0","100.0","null","2019","4","2019","3","09","30"
"2019-09-30","Bureau","Department of the Treasury","Tobacco Tax and Trade","1000","1","1000","1","0","0","100.0","100.0","null","2019","4","2019","3","09","30"
"2019-09-30","Bureau","Department of the Treasury","Treasury Forfeiture Fund","0","0","0","0","0","0","0.0","0.0","null","2019","4","2019","3","09","30"
"2019-09-30","Bureau","Department of the Treasury","Treasury Franchise Fund","0","0","0","0","0","0","0.0","0.0","null","2019","4","2019","3","09","30"
"2019-09-30","Bureau","Department of the Treasury","Treasury IG for Tax Admin","0","0","0","0","0","0","0.0","0.0","null","2019","4","2019","3","09","30"
"2019-09-30","Bureau","Department of the Treasury","U.S. Mint","46379","19","46379","19","0","0","100.0","100.0","null","2019","4","2019","3","09","30"
"2019-09-30","Bureau","Department of the Treasury","U.S. Treasury IG Office","664","1","0","0","664","1","0.0","0.0","null","2019","4","2019","3","09","30"
"2019-09-30","Agency","Environmental Protection Agency","null","16581414","207","16581414","207","0","0","100.0","100.0","CFO","2019","4","2019","3","09","30"
"2019-09-30","Bureau","Environmental Protection Agency","Environmental Protection Agency","16581414","207","16581414","207","0","0","100.0","100.0","null","2019","4","2019","3","09","30"
"2019-09-30","Agency","Equal Employment Opportunity Commission","null","49948","28","49948","28","0","0","100.0","100.0","Non-CFO","2019","4","2019","3","09","30"
"2019-09-30","Bureau","Equal Employment Opportunity Commission","Equal Employment Opportunity Commission","49948","28","49948","28","0","0","100.0","100.0","null","2019","4","2019","3","09","30"
"2019-09-30","Agency","Export - Import  Bank","null","0","0","0","0","0","0","0.0","0.0","Non-CFO","2019","4","2019","3","09","30"
"2019-09-30","Bureau","Export - Import  Bank","Export-Import Bank","0","0","0","0","0","0","0.0","0.0","null","2019","4","2019","3","09","30"
"2019-09-30","Agency","Farm Credit Administration","null","630","1","630","1","0","0","100.0","100.0","Non-CFO","2019","4","2019","3","09","30"
"2019-09-30","Bureau","Farm Credit Administration","Farm Credit Administration","630","1","630","1","0","0","100.0","100.0","null","2019","4","2019","3","09","30"
"2019-09-30","Bureau","Farm Credit Administration","Farm Credit System Insurance Corporation","0","0","0","0","0","0","0.0","0.0","null","2019","4","2019","3","09","30"
"2019-09-30","Agency","Federal Communications Commission","null","202593636","10908","202593636","10908","0","0","100.0","100.0","Non-CFO","2019","4","2019","3","09","30"
"2019-09-30","Bureau","Federal Communications Commission","Federal Communications Commission","202593636","10908","202593636","10908","0","0","100.0","100.0","null","2019","4","2019","3","09","30"
"2019-09-30","Agency","Federal Deposit Insurance Corporation","null","0","0","0","0","0","0","0.0","0.0","Non-CFO","2019","4","2019","3","09","30"
"2019-09-30","Bureau","Federal Deposit Insurance Corporation","Federal Deposit Insurance Corporation","0","0","0","0","0","0","0.0","0.0","null","2019","4","2019","3","09","30"
"2019-09-30","Agency","Federal Election Commission","null","580453","90","550011","81","30442","9","94.75547546485245","90.0","Non-CFO","2019","4","2019","3","09","30"
"2019-09-30","Bureau","Federal Election Commission","Federal Election Commission","580453","90","550011","81","30442","9","94.75547546485245","90.0","null","2019","4","2019","3","09","30"
"2019-09-30","Agency","Federal Labor Relations Authority","null","0","0","0","0","0","0","0.0","0.0","Non-CFO","2019","4","2019","3","09","30"
"2019-09-30","Bureau","Federal Labor Relations Authority","Federal Labor Relations Authority","0","0","0","0","0","0","0.0","0.0","null","2019","4","2019","3","09","30"
"2019-09-30","Agency","Federal Maritime Commission","null","472591","16","470829","6","1762","10","99.62716175297456","37.5","Non-CFO","2019","4","2019","3","09","30"
"2019-09-30","Bureau","Federal Maritime Commission","Salaries and Expenses","472591","16","470829","6","1762","10","99.62716175297456","37.5","null","2019","4","2019","3","09","30"
"2019-09-30","Agency","Federal Mediation/Conciliation Service","null","0","0","0","0","0","0","0.0","0.0","Non-CFO","2019","4","2019","3","09","30"
"2019-09-30","Bureau","Federal Mediation/Conciliation Service","Federal Mediation/Conciliation Service","0","0","0","0","0","0","0.0","0.0","null","2019","4","2019","3","09","30"
"2019-09-30","Agency","Federal Trade Commission","null","483084528","66","483084528","66","0","0","100.0","100.0","Non-CFO","2019","4","2019","3","09","30"
"2019-09-30","Bureau","Federal Trade Commission","Federal Trade Commission","483084528","66","483084528","66","0","0","100.0","100.0","null","2019","4","2019","3","09","30"
"2019-09-30","Agency","Funds Appropriated to the President","null","0","0","0","0","0","0","0.0","0.0","Non-CFO","2019","4","2019","3","09","30"
"2019-09-30","Bureau","Funds Appropriated to the President","African Development Foundation","0","0","0","0","0","0","0.0","0.0","null","2019","4","2019","3","09","30"
"2019-09-30","Bureau","Funds Appropriated to the President","Defense Security Assistance Agency","0","0","0","0","0","0","0.0","0.0","null","2019","4","2019","3","09","30"
"2019-09-30","Bureau","Funds Appropriated to the President","Executive Branch","0","0","0","0","0","0","0.0","0.0","null","2019","4","2019","3","09","30"
"2019-09-30","Bureau","Funds Appropriated to the President","Inter-American Foundation","0","0","0","0","0","0","0.0","0.0","null","2019","4","2019","3","09","30"
"2019-09-30","Bureau","Funds Appropriated to the President","Peace Corps","0","0","0","0","0","0","0.0","0.0","null","2019","4","2019","3","09","30"
"2019-09-30","Bureau","Funds Appropriated to the President","Trade and Development Agency","0","0","0","0","0","0","0.0","0.0","null","2019","4","2019","3","09","30"
"2019-09-30","Agency","General Services Administration","null","20470627","5171","15246092","4855","5224535","316","74.47789459502144","93.88899632566235","CFO","2019","4","2019","3","09","30"
"2019-09-30","Bureau","General Services Administration","General Services Administration","20470627","5171","15246092","4855","5224535","316","74.47789459502144","93.88899632566235","null","2019","4","2019","3","09","30"
"2019-09-30","Agency","Legis Branch-Library of Congress","null","51186","10","0","0","51186","10","0.0","0.0","Non-CFO","2019","4","2019","3","09","30"
"2019-09-30","Bureau","Legis Branch-Library of Congress","Library of Congress","51186","10","0","0","51186","10","0.0","0.0","null","2019","4","2019","3","09","30"
"2019-09-30","Agency","Legislative Branch - U.S. House/Senate","null","217127","244","25624","68","191503","176","11.801388127685641","27.868852459016395","Non-CFO","2019","4","2019","3","09","30"
"2019-09-30","Bureau","Legislative Branch - U.S. House/Senate","U.S. House of Representatives","217127","244","25624","68","191503","176","11.801388127685641","27.868852459016395","null","2019","4","2019","3","09","30"
"2019-09-30","Agency","Legislative Branch-CBO","null","0","0","0","0","0","0","0.0","0.0","Non-CFO","2019","4","2019","3","09","30"
"2019-09-30","Bureau","Legislative Branch-CBO","Congressional Budget Office","0","0","0","0","0","0","0.0","0.0","null","2019","4","2019","3","09","30"
"2019-09-30","Agency","Legislative Branch-GAO","null","32845","19","30649","14","2196","5","93.31405084487746","73.6842105263158","Non-CFO","2019","4","2019","3","09","30"
"2019-09-30","Bureau","Legislative Branch-GAO","Government Accountability Office","32845","19","30649","14","2196","5","93.31405084487746","73.6842105263158","null","2019","4","2019","3","09","30"
"2019-09-30","Agency","Legislative Branch-GPO","null","84359","27","0","0","84359","27","0.0","0.0","Non-CFO","2019","4","2019","3","09","30"
"2019-09-30","Bureau","Legislative Branch-GPO","Government Publishing Office","84359","27","0","0","84359","27","0.0","0.0","null","2019","4","2019","3","09","30"
"2019-09-30","Agency","Legislative Branch-Office of Tech.","null","0","0","0","0","0","0","0.0","0.0","Non-CFO","2019","4","2019","3","09","30"
"2019-09-30","Bureau","Legislative Branch-Office of Tech.","Medicaid & CHIP Payment & Access Comm.","0","0","0","0","0","0","0.0","0.0","null","2019","4","2019","3","09","30"
"2019-09-30","Bureau","Legislative Branch-Office of Tech.","Open World Leadership","0","0","0","0","0","0","0.0","0.0","null","2019","4","2019","3","09","30"
"2019-09-30","Agency","Merit Systems Protection Board","null","141","1","141","1","0","0","100.0","100.0","Non-CFO","2019","4","2019","3","09","30"
"2019-09-30","Bureau","Merit Systems Protection Board","Merit Systems Protection Board","141","1","141","1","0","0","100.0","100.0","null","2019","4","2019","3","09","30"
"2019-09-30","Agency","National Aeronautics and Space Administration","null","972942","124","972570","121","372","3","99.96176544953347","97.58064516129032","CFO","2019","4","2019","3","09","30"
"2019-09-30","Bureau","National Aeronautics and Space Administration","National Aeronautics and Space Admin","972942","124","972570","121","372","3","99.96176544953347","97.58064516129032","null","2019","4","2019","3","09","30"
"2019-09-30","Agency","National Archives & Records Admin","null","147771","98","145978","97","1793","1","98.7866360787976","98.9795918367347","Non-CFO","2019","4","2019","3","09","30"
"2019-09-30","Bureau","National Archives & Records Admin","Nat'l Archives & Records Administration","147771","98","145978","97","1793","1","98.7866360787976","98.9795918367347","null","2019","4","2019","3","09","30"
"2019-09-30","Agency","National Credit Union Administration","null","0","0","0","0","0","0","0.0","0.0","Non-CFO","2019","4","2019","3","09","30"
"2019-09-30","Bureau","National Credit Union Administration","National Credit Union Administration","0","0","0","0","0","0","0.0","0.0","null","2019","4","2019","3","09","30"
"2019-09-30","Agency","National Foundation  Arts & Humanities","null","0","0","0","0","0","0","0.0","0.0","Non-CFO","2019","4","2019","3","09","30"
"2019-09-30","Bureau","National Foundation  Arts & Humanities","National Endowment for the Arts","0","0","0","0","0","0","0.0","0.0","null","2019","4","2019","3","09","30"
"2019-09-30","Bureau","National Foundation  Arts & Humanities","National Endowment for the Humanities","0","0","0","0","0","0","0.0","0.0","null","2019","4","2019","3","09","30"
"2019-09-30","Agency","National Labor Relations Board","null","0","0","0","0","0","0","0.0","0.0","Non-CFO","2019","4","2019","3","09","30"
"2019-09-30","Bureau","National Labor Relations Board","National Labor Relations Board","0","0","0","0","0","0","0.0","0.0","null","2019","4","2019","3","09","30"
"2019-09-30","Agency","National Science Foundation","null","614909","94","614909","94","0","0","100.0","100.0","CFO","2019","4","2019","3","09","30"
"2019-09-30","Bureau","National Science Foundation","National Science Foundation","614909","94","614909","94","0","0","100.0","100.0","null","2019","4","2019","3","09","30"
"2019-09-30","Agency","Neighborhood Reinvestment Corporation","null","0","0","0","0","0","0","0.0","0.0","Non-CFO","2019","4","2019","3","09","30"
"2019-09-30","Bureau","Neighborhood Reinvestment Corporation","Neighborhood Reinvestment Corporation","0","0","0","0","0","0","0.0","0.0","null","2019","4","2019","3","09","30"
"2019-09-30","Agency","Nuclear Regulatory Commission","null","1518502","237","1458186","230","60316","7","96.02792752330916","97.0464135021097","CFO","2019","4","2019","3","09","30"
"2019-09-30","Bureau","Nuclear Regulatory Commission","Nuclear Regulatory Commission","1518502","237","1458186","230","60316","7","96.02792752330916","97.0464135021097","null","2019","4","2019","3","09","30"
"2019-09-30","Agency","Occupational Safety & Health Rev Comm","null","0","0","0","0","0","0","0.0","0.0","Non-CFO","2019","4","2019","3","09","30"
"2019-09-30","Bureau","Occupational Safety & Health Rev Comm","Occupational Safety & Health Rev Comm","0","0","0","0","0","0","0.0","0.0","null","2019","4","2019","3","09","30"
"2019-09-30","Agency","Office of Compliance","null","0","0","0","0","0","0","0.0","0.0","Non-CFO","2019","4","2019","3","09","30"
"2019-09-30","Bureau","Office of Compliance","Office of Compliance","0","0","0","0","0","0","0.0","0.0","null","2019","4","2019","3","09","30"
"2019-09-30","Agency","Office of Government Ethics","null","0","0","0","0","0","0","0.0","0.0","Non-CFO","2019","4","2019","3","09","30"
"2019-09-30","Bureau","Office of Government Ethics","Office of Government Ethics","0","0","0","0","0","0","0.0","0.0","null","2019","4","2019","3","09","30"
"2019-09-30","Agency","Office of Personnel Management","null","19391930","1249","15053885","849","4338045","400","77.62963768949248","67.97437950360288","CFO","2019","4","2019","3","09","30"
"2019-09-30","Bureau","Office of Personnel Management","Office of Personnel Management","19391930","1249","15053885","849","4338045","400","77.62963768949248","67.97437950360288","null","2019","4","2019","3","09","30"
"2019-09-30","Agency","Office of Special Counsel","null","0","0","0","0","0","0","0.0","0.0","Non-CFO","2019","4","2019","3","09","30"
"2019-09-30","Bureau","Office of Special Counsel","Office of Special Counsel","0","0","0","0","0","0","0.0","0.0","null","2019","4","2019","3","09","30"
"2019-09-30","Agency","Other Agencies","null","673606","161","4930","2","668676","159","0.731881841907584","1.2422360248447204","Non-CFO","2019","4","2019","3","09","30"
"2019-09-30","Bureau","Other Agencies","Advisory Council on Hist. Preservation","0","0","0","0","0","0","0.0","0.0","null","2019","4","2019","3","09","30"
"2019-09-30","Bureau","Other Agencies","Archit.&Trans. Barriers Compliance Bd","0","0","0","0","0","0","0.0","0.0","null","2019","4","2019","3","09","30"
"2019-09-30","Bureau","Other Agencies","Architect of the Capitol","124433","60","0","0","124433","60","0.0","0.0","null","2019","4","2019","3","09","30"
"2019-09-30","Bureau","Other Agencies","Chemical Safety Board","0","0","0","0","0","0","0.0","0.0","null","2019","4","2019","3","09","30"
"2019-09-30","Bureau","Other Agencies","Comm. for Purchase from Blind/Handic.","0","0","0","0","0","0","0.0","0.0","null","2019","4","2019","3","09","30"
"2019-09-30","Bureau","Other Agencies","Commission On Fine Arts","0","0","0","0","0","0","0.0","0.0","null","2019","4","2019","3","09","30"
"2019-09-30","Bureau","Other Agencies","Consumer Financial Protection Bureau","307534","63","0","0","307534","63","0.0","0.0","null","2019","4","2019","3","09","30"
"2019-09-30","Bureau","Other Agencies","Council of Insps. Gen. of Intg. & Effy.","3050","4","0","0","3050","4","0.0","0.0","null","2019","4","2019","3","09","30"
"2019-09-30","Bureau","Other Agencies","Defense Nuclear Facilities Safety Board","0","0","0","0","0","0","0.0","0.0","null","2019","4","2019","3","09","30"
"2019-09-30","Bureau","Other Agencies","Delta Regional Authority","0","0","0","0","0","0","0.0","0.0","null","2019","4","2019","3","09","30"
"2019-09-30","Bureau","Other Agencies","Denali Commission","0","0","0","0","0","0","0.0","0.0","null","2019","4","2019","3","09","30"
"2019-09-30","Bureau","Other Agencies","District of Columbia Government","0","0","0","0","0","0","0.0","0.0","null","2019","4","2019","3","09","30"
"2019-09-30","Bureau","Other Agencies","Election Assistance Commission","0","0","0","0","0","0","0.0","0.0","null","2019","4","2019","3","09","30"
"2019-09-30","Bureau","Other Agencies","Federal Housing Finance Agency","0","0","0","0","0","0","0.0","0.0","null","2019","4","2019","3","09","30"
"2019-09-30","Bureau","Other Agencies","Federal Housing Finance Agency OIG","0","0","0","0","0","0","0.0","0.0","null","2019","4","2019","3","09","30"
"2019-09-30","Bureau","Other Agencies","Federal Mine Safety & Health Review Comm","0","0","0","0","0","0","0.0","0.0","null","2019","4","2019","3","09","30"
"2019-09-30","Bureau","Other Agencies","Gulf Coast Ecosystem Restoration Council","0","0","0","0","0","0","0.0","0.0","null","2019","4","2019","3","09","30"
"2019-09-30","Bureau","Other Agencies","James Madison Memorial Fellowship","228745","23","0","0","228745","23","0.0","0.0","null","2019","4","2019","3","09","30"
"2019-09-30","Bureau","Other Agencies","Millennium Challenge Corporation","0","0","0","0","0","0","0.0","0.0","null","2019","4","2019","3","09","30"
"2019-09-30","Bureau","Other Agencies","Morris K. Udall Scholarship","982","1","0","0","982","1","0.0","0.0","null","2019","4","2019","3","09","30"
"2019-09-30","Bureau","Other Agencies","National Capital Planning Commission","0","0","0","0","0","0","0.0","0.0","null","2019","4","2019","3","09","30"
"2019-09-30","Bureau","Other Agencies","National Council on Disability","387","1","0","0","387","1","0.0","0.0","null","2019","4","2019","3","09","30"
"2019-09-30","Bureau","Other Agencies","National Mediation Board","0","0","0","0","0","0","0.0","0.0","null","2019","4","2019","3","09","30"
"2019-09-30","Bureau","Other Agencies","National Transportation Safety Board","0","0","0","0","0","0","0.0","0.0","null","2019","4","2019","3","09","30"
"2019-09-30","Bureau","Other Agencies","Surface Transportation Board","0","0","0","0","0","0","0.0","0.0","null","2019","4","2019","3","09","30"
"2019-09-30","Bureau","Other Agencies","U.S.  Agency of Global Media","4930","2","4930","2","0","0","100.0","100.0","null","2019","4","2019","3","09","30"
"2019-09-30","Bureau","Other Agencies","U.S. Holocaust Memorial Council","0","0","0","0","0","0","0.0","0.0","null","2019","4","2019","3","09","30"
"2019-09-30","Bureau","Other Agencies","U.S. Inst. for Env. Conflict Resolution","3545","7","0","0","3545","7","0.0","0.0","null","2019","4","2019","3","09","30"
"2019-09-30","Bureau","Other Agencies","U.S. Institute of Peace","0","0","0","0","0","0","0.0","0.0","null","2019","4","2019","3","09","30"
"2019-09-30","Agency","Other Agencies/Boards/Commissions","null","393","1","0","0","393","1","0.0","0.0","Non-CFO","2019","4","2019","3","09","30"
"2019-09-30","Bureau","Other Agencies/Boards/Commissions","Medicare Payment Advisory Commission","0","0","0","0","0","0","0.0","0.0","null","2019","4","2019","3","09","30"
"2019-09-30","Bureau","Other Agencies/Boards/Commissions","U.S. Comm. on Int. Religious Freedom","393","1","0","0","393","1","0.0","0.0","null","2019","4","2019","3","09","30"
"2019-09-30","Bureau","Other Agencies/Boards/Commissions","U.S.-China Security Review Commission","0","0","0","0","0","0","0.0","0.0","null","2019","4","2019","3","09","30"
"2019-09-30","Agency","Overseas Private Investment Corp Accts","null","0","0","0","0","0","0","0.0","0.0","Non-CFO","2019","4","2019","3","09","30"
"2019-09-30","Bureau","Overseas Private Investment Corp Accts","Overseas Private Investment Corp Accts","0","0","0","0","0","0","0.0","0.0","null","2019","4","2019","3","09","30"
"2019-09-30","Agency","Pension Benefit Guaranty Corp","null","2659827","1558","2659827","1558","0","0","100.0","100.0","Non-CFO","2019","4","2019","3","09","30"
"2019-09-30","Bureau","Pension Benefit Guaranty Corp","Pension Benefit Guaranty Corporation","2659827","1558","2659827","1558","0","0","100.0","100.0","null","2019","4","2019","3","09","30"
"2019-09-30","Agency","Presidio Trust Corporation","null","1425032","84","1352112","76","72920","8","94.88292192736725","90.47619047619048","Non-CFO","2019","4","2019","3","09","30"
"2019-09-30","Bureau","Presidio Trust Corporation","Presidio Trust Corporation","1425032","84","1352112","76","72920","8","94.88292192736725","90.47619047619048","null","2019","4","2019","3","09","30"
"2019-09-30","Agency","Railroad Retirement Board","null","20115604","4273","20115604","4273","0","0","100.0","100.0","Non-CFO","2019","4","2019","3","09","30"
"2019-09-30","Bureau","Railroad Retirement Board","Railroad Retirement Board","20115604","4273","20115604","4273","0","0","100.0","100.0","null","2019","4","2019","3","09","30"
"2019-09-30","Agency","Securities & Exchange Commission","null","2017561197","857","2017561197","857","0","0","100.0","100.0","Non-CFO","2019","4","2019","3","09","30"
"2019-09-30","Bureau","Securities & Exchange Commission","SEC Enforcement","0","0","0","0","0","0","0.0","0.0","null","2019","4","2019","3","09","30"
"2019-09-30","Bureau","Securities & Exchange Commission","Securities and Exchange Commission","2017561197","857","2017561197","857","0","0","100.0","100.0","null","2019","4","2019","3","09","30"
"2019-09-30","Agency","Selective Service System","null","0","0","0","0","0","0","0.0","0.0","Non-CFO","2019","4","2019","3","09","30"
"2019-09-30","Bureau","Selective Service System","Selective Service System","0","0","0","0","0","0","0.0","0.0","null","2019","4","2019","3","09","30"
"2019-09-30","Agency","Small Business Administration","null","12400989380","121126","12387465620","121032","13523760","94","99.89094612062316","99.92239486154914","CFO","2019","4","2019","3","09","30"
"2019-09-30","Bureau","Small Business Administration","Small Business Administration","12400989380","121126","12387465620","121032","13523760","94","99.89094612062316","99.92239486154914","null","2019","4","2019","3","09","30"
"2019-09-30","Agency","Smithsonian Institution","null","0","0","0","0","0","0","0.0","0.0","Non-CFO","2019","4","2019","3","09","30"
"2019-09-30","Bureau","Smithsonian Institution","Administrative Conference of the US","0","0","0","0","0","0","0.0","0.0","null","2019","4","2019","3","09","30"
"2019-09-30","Bureau","Smithsonian Institution","JFK Center for the Performing Arts","0","0","0","0","0","0","0.0","0.0","null","2019","4","2019","3","09","30"
"2019-09-30","Bureau","Smithsonian Institution","National Gallery of Art","0","0","0","0","0","0","0.0","0.0","null","2019","4","2019","3","09","30"
"2019-09-30","Bureau","Smithsonian Institution","Smithsonian Institution","0","0","0","0","0","0","0.0","0.0","null","2019","4","2019","3","09","30"
"2019-09-30","Agency","Social Security Administration","null","5077368752","1583831","2714485060","486602","2362883692","1097229","53.46243679722398","30.723101138947275","CFO","2019","4","2019","3","09","30"
"2019-09-30","Bureau","Social Security Administration","Social Security Administration","5077368752","1583831","2714485060","486602","2362883692","1097229","53.46243679722398","30.723101138947275","null","2019","4","2019","3","09","30"
"2019-09-30","Agency","Tennessee Valley Authority","null","0","0","0","0","0","0","0.0","0.0","Non-CFO","2019","4","2019","3","09","30"
"2019-09-30","Bureau","Tennessee Valley Authority","Tennessee Valley Authority","0","0","0","0","0","0","0.0","0.0","null","2019","4","2019","3","09","30"
"2019-09-30","Agency","The Judiciary","null","1080120","325","1065659","211","14461","114","98.66116727770988","64.92307692307692","Non-CFO","2019","4","2019","3","09","30"
"2019-09-30","Bureau","The Judiciary","Administrative Office of the U.S. Courts","1080120","325","1065659","211","14461","114","98.66116727770988","64.92307692307692","null","2019","4","2019","3","09","30"
"2019-09-30","Agency","U.S. Court of Appeals / Veterans Claims","null","4018","5","4018","5","0","0","100.0","100.0","Non-CFO","2019","4","2019","3","09","30"
"2019-09-30","Bureau","U.S. Court of Appeals / Veterans Claims","U.S. Court of Appeals / Veterans Claims","4018","5","4018","5","0","0","100.0","100.0","null","2019","4","2019","3","09","30"
"2019-09-30","Agency","U.S. Postal Service","null","67122823","42211","36631134","34181","30491689","8030","54.57329171033226","80.97652270735117","Non-CFO","2019","4","2019","3","09","30"
"2019-09-30","Bureau","U.S. Postal Service","U.S. Postal Service","67122823","42211","36631134","34181","30491689","8030","54.57329171033226","80.97652270735117","null","2019","4","2019","3","09","30"